------------------------------------------------------------------------------------------------------------------------------------------------------
------------------------------------------------------------------------------------------------------------------------------------------------------
------------------------------------------------------------------------------------------------------------------------------------------------------
S-----SSSS------------------------------------------------------------------------------------------SSSSSSSSSSSSSSSSSSSS------------------------------
S-----------------------------------------------------------------------------------------------------------------------------------------------------
S------------------------------------------------------oooo-----------------------------oo------------------------------------------------------------
S-----------------SC-----------------------------------%%%%-----------------SSSSoo---------SSS!--------------------------------SSS--------------------
S-------------------------------------------------SSSS--||---o---o---o-------------------------------------------------------------------------y------
S-------------------------------------------------------||--%%%-%%%-%%-----------------------------------------------------------------------#SS--o---
S-------------------------------------------------------||---|---|---|-------K---SSS--------------------------------------------K-----------##--------
S-------------TT---2SS----------------------------------||---|---|---|-----SSSSS---------S----C------------TT-T----------------SSS----------##--SC----
S-------------TT-----K---TT-----------K---------------U-||---|---|---|T---------------------------------#--TT-T----------------------TT-----##--------
S-------------TT---------TT---TTTT----------------------||---|---|---|T--------------------------------##--TT-T----TT----TT----------TT-----##---SSS--
S-------------TT---------TT---TTTT-------------y--------||---|---|-r-|T------------------------g-g--kk-##--TT-T--g-TT----TT----------TT-----##--------
XXXXXXXXXXXXXXXXXXXXXXXXXXXXXXXXXXXXXXXXXXXXXXXXXX----%%%%%-%%%%%%%%%%XXXXXXXXXX----------XXXXXXXXXXXXXXX--XX-XXXXXXXXXXXXXXXXXXXXXXXXXXXXXXXX------XX
XXXXXXXXXXXXXXXXXXXXXXXXXXXXXXXXXXXXXXXXXXXXXXXXXX-----|||---|||||||||XXXXXXXXXX----------XXXXXXXXXXXXXXX--XX-XXXXXXXXXXXXXXXXXXXXXXXXXXXXXXXX------XX
