------------------------------------------------------------------------------------------------------------------------------------------------------
------------------------------------------------------------------------------------------------------------------------------------------------------
------------------------------------------------------------------------------------------------------------------------------------------------------
--------------------------------------------------------------------------------------------------------------SS-------S------------------------------
------------------------------------------------------------------------------------------------------------------------------------------------------
----------------------------------------ooooo---------------------------------------------------------------------------------------------------------
--------------------S----------------------------------------------------------------------SSS!-----------2------------S----------!S------------------
---------------------------TT-------------------SS----------------------------------------------------------------------------------------------------
---------------------------TT------------SSSS------------B---------------------g-----------------------------------SSS--------------------------------
---------------------------XX----------------------------b------------------------o-----------------o-------------------SS-?Q-------------------------
-----SSS--Q------------TT------------------------------SS#CS-----------------S@S-------TT-----C-----------2------------S----------S------#--#---------
-----------------------TT-------------tt-----------------------------------------------TT----------------------##-----------------------##--##--------
-----------------------TT-------------tt----%%%%%----------K---------------------------TT----------------------##--------------y-------###--###------#
-------------------#k--TT-------------tt-----|||------------gg-------g-----------------TT------g-g------y--y---##----------SSSSS------####--####----##
XXXXXXXXXXXXX--XXXXXXXXXXXXXXXXXXXXXXXXX%%---|||--XXXXXXXXXXXXXXXXXXXX-XXXXXXXXXXXXXXXXXXXXXXXXXXXXXXXXXXXXXXX-XX------X-------XX-XXXXXXXXXXXXXXXXXXXX
XXXXXXXXXXXXX--XXXXXXXXXXXXXXXXXXXXXXXXX|----|||--XXXXXXXXXXXXXXXXXXXX-XXXXXXXXXXXXXXXXXXXXXXXXXXXXXXXXXXXXXXX-XX------X-------XX-XXXXXXXXXXXXXXXXXXXX
