------------------------------------------------------------------------------------------------------------------------------------------------------
------------------------------------------------------------------------------------------------------------------------------------------------------
------------------------------------------------------------------------------------------------------------------------------------------------------
------------------------------SSSSSSSSSS--------------------------------------------------SSSSSSSSSS--------------------------------------------------
------------------------------SSSSSSSSSS--------------------------------------------------------------------------------------------------------------
----------------------ooor----SSSSSSSSSS--------------------------------------------------------------------------------------------------------------
---------------------%%%%%----SSSSSSSSSS------------------------------------SSSS-----1----------------------------------SS--------SS------------------
----------------------|||-----------------------------------------------------------------------------------------------------------------------------
----------------------|||--------------------------------------------o--------------------------------------------------------------------------------
----------------------|||----------------------------------------y-----------K---------------------------------------------TT-------------------------
-----SSS--------%%%%%%%%%%%---SSSSSSSSSS-------------------------##--------SSSSS---QQQQ------------------------------------TT-----SS------------------
-----------------||-||||||----SSSSSSSSSS------------K-----------###---T-------------------------------------------------t--TT-----K---#----B----------
-----------------||-||||||--o-SSSSSSSSSS-----------------------####---T-----------------------------------*-------------t--TT---------#----b-------F--
-----------------||-||||||-%%%SSSSSSSSSS-------------------g--#####---T-------------yy----------g-g-gg----*----k----kkk-t--TT---------#----B-------#--
XXXXXXXXXXX--%%%%||%||||||--|-XXXXXXXXXXX-XX-XX-XXXXXXXXXXXXXXXXXXX---XXXXXXXXXXXXXXXXXXXXXXXXXXXXXXXXXXXXXXX-XXXXXXXXXXXXXXXXXXXXXXXXXXXXXXXXXXXXXXXX
XXXXXXXXXXX---||-||-||||||--|-XXXXXXXXXXX-XX-XX-XXXXXXXXXXXXXXXXXXX---XXXXXXXXXXXXXXXXXXXXXXXXXXXXXXXXXXXXXXX-XXXXXXXXXXXXXXXXXXXXXXXXXXXXXXXXXXXXXXXX
