------------------------------------------------------------------------------------------------------------------------------------------------------
------------------------------------------------------------------------------------------------------------------------------------------------------
------------------------------------------------------------------------------------------------------------------------------------------------------
-----------------------oo-------------------------SSSSSSSSSS------------------------------------------------------------------------------------------
------------------------------------------------------SS--SS------------------------------------------------------------------------------------------
------------------------------------------------------SS--SS------------------------------------------------------------------------------------------
----------------------SSSS--------------------------SS------------SSoo-------------o--o---SSS------%---------R-----------SSS----S!-----------------SSS
--------------------------------o----ooo------------SS---------------------------------------------------r--------------------------------------------
----------------------------------------------------SS-------------------------g--------------------%%%%%%%-------------------------------------------
----------------------------------------------------SS----oo-----------------------SSSS-------------||||||--------------------------------------------
-------------------%------%%%%--------%%------------SSSS--SS%%%%%%-----------S@S------------%%%-----||||||-----------------------S----------------#---
---------------------------|||---------|-----K---B----SS-----||||----------------------------|------||||||----------------------------------------#---
---------------------------|||---------|---------b----SS-----||||---------------%%%----------|------||||||---------B------------------------------#---
-M-----------%%%%----------|||-%%%%%%%-|---------B-----------||||---------------||-----------|------||||||--oo-----b--------gg-g-gk----------ggg--#---
XXXXXXXXXXX---||----%%%----|||--|||||--|XXXXXXXXXXXXXXXXXXXX-||||------XXXXXXXXX||-----------|------||||||--%%XXXXXXXXXXXXXXXXXXXXXX---XXXXXXXXXXXXXXX
XXXXXXXXXXX---||----||-----|||--|||||--|XXXXXXXXXXXXXXXXXXXX-||||------XXXXXXXXX||-----------|------||||||---|XXXXXXXXXXXXXXXXXXXXXX---XXXXXXXXXXXXXXX
