------------------------------------------------------------------------------------------------------------------------------------------------------
------------------------------------------------------------------------------------------------------------------------------------------------------
------------------------------------------------------------------------------------------------------------------------------------------------------
--------------------SSSSSSSSSS--------------------------------------------------SSSSSSSSSL------------------------------SSSSSSSSSS--------------------
--------------------SSSSSSSSSS-----------g------------------------------------------------------------------------------------------------------------
--------------------SSSSSSSSSS----------%%---------------------------R--------------------------------oo----------------------------------------k-----
--------------------SSSSSSSSSS----------|-------------------------------------------oooooo--------------------?SSS-----------------------------SQS--SQ
----------------------------------------|----oo-------------------------------------------------------------------------------------------------------
----------------------------------------|----------------B--------------------------SSSSSS------------------------------------------------------------
----------------------------------------|----------------b---------------1----------SSSSSS------------------------------------------------------------
----------------!-----SSSSSS?---QQQQ----|--------------SS#CS-----%%%--T---------------------------------------SSSSS----------------------------SQS--S?
----------------------SSSSS----------K-B|-------------------------|---T----TT---------------------------------------------SS---------TT---------------
----------------------SSSSS------------b|------------------K------|---T----TT-------------------------------tt------------SS---------TT---------------
-M-------------------------ooo---------b|-------------------------|---T---kTT----------------------g--ggg---tt--K---------SS---------TT------k------gg
XXXXXXXXXXXXXXXXXXXX-XXXXXXXXXXXXXXXXXXX|----%%%%-XXXXXXXXXX%%%%%-|---XXXXXXXXXX---XXXXXXX-XXXXXXXXXXXXXXXXXXXXXXXXXXXXX--XX--XXXXXXXXXXXXXXXXXXXXXXXX
XXXXXXXXXXXXXXXXXXXX-XXXXXXXXXXXXXXXXXXX|-----||--XXXXXXXXXX-|||--|---XXXXXXXXXX---XXXXXXX-XXXXXXXXXXXXXXXXXXXXXXXXXXXXX--XX--XXXXXXXXXXXXXXXXXXXXXXXX
