------------------------------------------------------------------------------------------------------------------------------------------------------
------------------------------------------------------------------------------------------------------------------------------------------------------
------------------------------------------------------------------------------------------------------------------------------------------------------
----------------------------------------SSSSSSSSSS-----------------SSS----------------------------------------------------------------------SSSSSSSSSS
----------------------------------------SSSSSSSS------------------------------------------------------------------------------------------------------
----------------------------------------SSSCSSSS--------------------------------K---------------------------------------------------------------------
----------------------------------------SSSSSSSS----------------CSS--------g----SS----1----------------------@-----oo---SS----------------------------
-----------------------------------------------------------------------%%%%%%-------------------------------------------------------------------------
------------------------------------------------------------SS--2-------||||---------------------------------------------------------g#---------------
-------------------------------------------ggg-----------------2-2------||||---------------o-------------------------------TT-------g##---------------
---------Q----------SS------------------SSSSSSSS------S-----------2-----||||----SS---------------TT-SU----!--!-%%%%--%%%---TT-------###-------TT------
---------------------K---TT-----------K-SSSSSSSS--TT--------------------||||----------TT---------TT-------------||----||t--TT------####-------TT------
-------------------------TT---TTTT------SSSSSSSS--TT--------------------||||----------TT---------TT-------------||----||t--TT-----#####-------TT------
-M--------k---ggg--------TT---TTTT------SSSSSSSS--TT------k-------------||||----------TT---------TT-------k---o-||----||t--TT-----#####-------TT------
XXXXXXXXXXXXXXXXXXXXXXXXXXXXXXXXXXXXXXXXXXXXXXXXXXXXXXXXXXXX---XXXXXXX--||||----XXXXXXXXXXXXXXXXXXXXXXXXXXXXXX%-||----||XXXXXXXXXXXXXXX--XXXXXXX--XXXX
XXXXXXXXXXXXXXXXXXXXXXXXXXXXXXXXXXXXXXXXXXXXXXXXXXXXXXXXXXXX---XXXXXXX--||||----XXXXXXXXXXXXXXXXXXXXXXXXXXXXXX--||----||XXXXXXXXXXXXXXX--XXXXXXX--XXXX
