------------------------------------------------------------------------------------------------------------------------------------------------------
------------------------------------------------------------------------------------------------------------------------------------------------------
------------------------------------------------------------------------------------------------------------------------------------------------------
------------------------------SSSSSSSSSS--------------------------------------------------SSSSSSSSSS--------------------SSS-----SS----------SSSSSSSSSS
------------------------------SSSSSSSSSS----?---------------------------------------------------------------------------------------------------------
------------------------------SSSSSSSSSS--------------------------------------------------------------------------------------------------------------
------------------------------SSSSSSSSSS---------------------------------------------SUS------------------2--------oo---US---------SSSS---------------
----------------------------------------------r-------------------------------------------------------------------------------------------------------
------------------------------------------%%%%%%----------------------o-----------------------------------------------------SSS-----------------------
-------------------------------------------||||----------o------------------------------------------o----------------------------------SSSS-----------
---------Q--------------------SSSSSSSSSS%%-||||ooo-------------------T--------------#####-----------------2----%%%%--%%%SSS-------------------TT------
-----------------K------------SSSSSSSSSS|--||||--r-------------------T--------#-----#-----t---------------------||----||----------------------TT------
------------B-----------------SSSSSSSSSS|%%%%%%%%%-------------------T-------##----K#-----t---------------------||----||----------------------TT------
------------b------------ggg--SSSSSSSSSS|-||||||||--k---------ggg----T--------------#-----t-------------y--y--o-||----||----------------------TT------
XXXXXXXXXXXXXXXXXXXXXXXXXXXXXXXXXXXXXXXX|-||||||||-XXXXXXXXXXXXXXXXXXXXXXXXXXXXXXXXXXXX---XXXXXXXXXXXXXXXXXXXX%-||----||XXX------X---------XXXXX--XXXX
XXXXXXXXXXXXXXXXXXXXXXXXXXXXXXXXXXXXXXXX|-||||||||-XXXXXXXXXXXXXXXXXXXXXXXXXXXXXXXXXXXX---XXXXXXXXXXXXXXXXXXXX--||----||XXX------X---------XXXXX--XXXX
