------------------------------------------------------------------------------------------------------------------------------------------------------
------------------------------------------------------------------------------------------------------------------------------------------------------
------------------------------------------------------------------------------------------------------------------------------------------------------
----------------------------------------------------------------------SSSSSSSSSS----------------------------------------------------------------------
----------------------------------------------------------------------------SSSS----------------------------------------------------------------------
--------------------------------------oo---------------------------------g--SSSS--g---------oo--------------------------------------------------------
------------------Q-S--------------SSSS------------------Q-Q------------SS------SSSSSSSS--------------------------------------------------------------
---------------------------TT-------------------------------------------SS----------------------------------------------------------------------------
---------------------------TT-------------------------------------------SS-------------------------%--------------------------------------------------
---------------------------XX-----------------------------------1-------SC--g-g------------------------------------------------SSS--------------------
------------------?----TT-----%--------------------------Q-Q------------SS--SSSS----------SS----------%%%%%%----!-----S-%-------------------#---------
--------------TT-------TT---------------T-----TT-------------------------------------------------------||||---------------------------------##--------
--------------TT-------TT---------------T-----TT---------------------------------------------%%%%------||||---------------------------------###------#
-M------------TT----k--TT---------------T-----TT----------------------------------------------||-------||||----------------------r----------####----##
XXXXXXXXXXXXXXXXXXXXXXXXXXXXXX--%%%%--%%XXXX--XXXXXXXXXXXXXXXXXXXXXXX-XXXXXXXXXXXXXXXX---X----||----%%-||||-%%XXXXXXXXXX----XXXXXXXXXXXXXXXXXXXXXXXXXX
XXXXXXXXXXXXXXXXXXXXXXXXXXXXXX---||----|XXXX--XXXXXXXXXXXXXXXXXXXXXXX-XXXXXXXXXXXXXXXX---X----||----|--||||--|XXXXXXXXXX----XXXXXXXXXXXXXXXXXXXXXXXXXX
