------------------------------------------------------------------------------------------------------------------------------------------------------
------------------------------------------------------------------------------------------------------------------------------------------------------
------------------------------------------------------------------------------------------------------------------------------------------------------
-----------------------oo-----SSSSSSSSSS--------------------SSSSSSSSSS--------------------------------------------------------------------------------
------------------------------SSSSSSSSSS--------------------SSSS--SSSS--------------------------------------------------------------------------------
------------------------------SSSSSSSSSS--------------------SSSS--SSSS----------------------oo--------------------------------------------------------
----------------------SSSS----SSSSSSSSSS----------------------SS---S------SSCSS-------------------------------------------------------------SSS-------
--------------------------------------------------------------SS---S--------------------------------------TT------------------------------------------
--------------------------------------------------------------SS---S--------------TT---------------%------TT------------------------------------------
------------------------------------------------------------ooSS---SoU------------TT----------------------TT------------SS-?Q--------------------SSSSS
---------Q------%%%%------%%%%SSSSSSSSSS-----------------tt-SSSS---SSS--QQQQ--QQ--TT------S--------------SXXS-----------------------------------------
-----------------||--------|||SSSSSSSSSS-----------------tt-----------------------TT-----T---------------------#---------------------TT---------------
-----------------||--------|||SSSSSSSSSS-----------------tt---------------------T-TT-----T---%%%%---TT---------#---------------y-----TT-----SSS-------
-M---------------||--------|||SSSSSSSSSS-------y-----g-g-tt-k--g-g--------------T-TT---k-T----||----TT---------#----ggg----SSSSS-----TT------------r--
XXXXXXXXXXX--%%%%||%%%%----|||XXXXXXXXXXXXXXXXXXXXXXXXXXXXXXXXXXXXXXXXXXXXXXXXXXXXXXXXXXXX----||----XXXXXXXXXX-XXXXXXXXX-------XX-XXXXXXXXXX-----XXXXX
XXXXXXXXXXX---||-||-||-----|||XXXXXXXXXXXXXXXXXXXXXXXXXXXXXXXXXXXXXXXXXXXXXXXXXXXXXXXXXXXX----||----XXXXXXXXXX-XXXXXXXXX-------XX-XXXXXXXXXX-----XXXXX
