------------------------------------------------------------------------------------------------------------------------------------------------------
------------------------------------------------------------------------------------------------------------------------------------------------------
------------------------------------------------------------------------------------------------------------------------------------------------------
--------------------------------oo------------------------------------SSSSSSSSSS----------------------------------------------------------------------
-------------------------------------g-g----------?-------------------------SSSS----------------------------------------------------------------------
-----------------------------------%%%%%-----------------------------R---g--SSSS----------------------------------------------------------------------
------------------Q-S---------------||||--------------------------------SS-----------1---------------------------------------------------##-----------
---------------------------TT-------||||----------SS--------------------SS---------------------------------------------------------------##-----------
---------------------------TT-------||||--------------------------------SS-------------------------------------------------------------####-----------
---------------------------XX-%%%%%-||||--------------------------------SC--g-g----------------oooo------------------------------------####-----------
-----SSS----------?----TT------|||--||||-------------------------%%%----SS--SSSS---QQQQ-------------------------!-----S--------------######-----------
--------------TT-------TT------|||--||||T-----TT-------SSS--------|------------------------------------------------------------------######-----------
--------------TT-------TT------|||--||||T-----TT------------------|---------------------------------------*--------------------------######--------F--
--------------TT----k--TT------|||--||||T-----TT------------------|-----------------yy--------------gg----*---------------kkk--------######--------#--
XXXXXXXXXXXXXXXXXXXXXXXXXXXXXX-|||--||||XXXX--XXXX----------%%%%%-|---XXXXXXXXXXXXXXXXXXXX%%%%%%%-%%XXXXXXXXX-XXXXXXXXXXXXXXXXXXXXXXXXXXXXXXXXXXXXXXXX
XXXXXXXXXXXXXXXXXXXXXXXXXXXXXX-|||--||||XXXX--XXXX-----------|||--|---XXXXXXXXXXXXXXXXXXXX||||||---|XXXXXXXXX-XXXXXXXXXXXXXXXXXXXXXXXXXXXXXXXXXXXXXXXX
