------------------------------------------------------------------------------------------------------------------------------------------------------
------------------------------------------------------------------------------------------------------------------------------------------------------
------------------------------------------------------------------------------------------------------------------------------------------------------
S-----SSSS--------------------------------------------------------------------------------SSSSSSSSSS--------------------------------------------------
S-----------------------------------------------------------------------------------------------------------------------------------------------------
S-----------------------------------------------------------------------------------------------------------------------------------------------k-----
S--------------------LSSS------------------------------------------------------------SSSS--------------------@-----oo-----oo---%%%-------------SQS--SQ
S------------------------------------------------------------o---o---o----------------------------------------------------SS----||--------------------
S----------------g---------------------------------------B--%%%-%%%-%%----------------------------------------------------------||--------------------
S----------------#---------------------------------------b---|---|---|---1------------------------------------------------------||--------------------
S---------S-----##---2-----#-----------T---------------SS#CS-|---|---|T---------Q-------------------SU----!--!-%%%%--%%%-----SS-||---------#---SQS--S?
S--------------###---------#-----------TT-----TT-------------|---|---|T----TT-----------------------------------||----||--------||--------##----------
S-------------####---------##----------TT-----TT-----------K-|---|---|T----TT-----------------------------------||----||--------||-------###----------
S--M---------#####----kk---##---gg-----TT-----TT-------------|---|-r-|T---kTT----ggg------------g-g-------k---o-||----||--------||---y--####-k------gg
XXXXXXXXXXXXXXXXXXXXXXXXXXXXXXXXXXXXXXXXXXXX--XXXXXXXXXXXXXX%%%%%%%%%%XXXXXXXXXXXXXXX----XXXXXXXXXXXXXXXXXXXXX%-||----||%%-----%%%XXXXXXXXXXXXXXXXXXXX
XXXXXXXXXXXXXXXXXXXXXXXXXXXXXXXXXXXXXXXXXXXX--XXXXXXXXXXXXXX-|||||||||XXXXXXXXXXXXXXX----XXXXXXXXXXXXXXXXXXXXX--||----|||-------||XXXXXXXXXXXXXXXXXXXX
