------------------------------------------------------------------------------------------------------------------------------------------------------
------------------------------------------------------------------------------------------------------------------------------------------------------
------------------------------------------------------------------------------------------------------------------------------------------------------
------------------------------SSSSSSSSSS----------SSSSSSSSSS----------------------------------------SSSSSSSSSS----------------------------------------
------------------------------SSSSSSSSSS--------------SS--SS------------------------------------------------------------------------------------------
----------------------ooor----SSSSSSSSSS--------------SS--SS----------------------g-------------------------------------------------------------------
---------------------%%%%%----SSSSSSSSSS------------SS--------------------SS----SSSSSSSS--------------------------------SSS---------------------------
----------------------|||---------------------------SS-------o---o---o--------------------------------------------------------------------------------
----------------------|||---------------------------SS------%%%-%%%-%%--------------------------------------------------------------------------------
----------------------|||---------------------------SS----oo-|---|---|---------------------o----------------------------------------------------------
----------------%%%%%%%%%%%---SSSSSSSSSS------------SSSS--SS-|---|---|SS-----SS------------------TT--------TT---!-----S--------------------#----------
-----------------||-||||||----SSSSSSSSSS--------------SS-----|---|---|---------------------------TT-----#--TT-----------------------------##----------
-----------------||-||||||--o-SSSSSSSSSS--------------SS-----|---|---|---------------------------TT----##--TT-----------------TT---------###-------F--
-M---------------||-||||||-%%%SSSSSSSSSS---------------------|---|-r-|---------------------------TT-kk-##--TT-----------------TT-----y--####-------#--
XXXXXXXXXXX--%%%%||%||||||--|-XXXXXXXXXXX-XX-XX-XXXXXXXXXXXX%%%%%%%%%%----------XXXXXX---XXXXXXXXXXXXXXXX--XX-XXXXXXXXXX----XXXXXXXXXXXXXXXXXXXXXXXXXX
XXXXXXXXXXX---||-||-||||||--|-XXXXXXXXXXX-XX-XX-XXXXXXXXXXXX-|||||||||----------XXXXXX---XXXXXXXXXXXXXXXX--XX-XXXXXXXXXX----XXXXXXXXXXXXXXXXXXXXXXXXXX
