------------------------------------------------------------------------------------------------------------------------------------------------------
------------------------------------------------------------------------------------------------------------------------------------------------------
------------------------------------------------------------------------------------------------------------------------------------------------------
------------------------------------------------------------SSSSSSSSSS--------------------------------------------------------------------------------
------------------------------------------------------------SSSS--SSSS--------------------------------------------------------------------------------
------------------------------------------------------------SSSS--SSSS------------------oo--oo--------------------------------------------------k-----
-----------------------------U--------------------------------SS---S------------oo---------------------------R-----oo--------------------------SQS--SQ
--------------------------------------------------------------SS---S-------------------------------------r--------------------------------------------
---------------------------------------------------------B----SS---S-------------------------------%%%%%%%%-------------------------------------------
------------Q--?-----------------------------------------b--ooSS---SoU-----------SS-----------------||||||--------------SS-?Q-------------------------
--------SU---------S--------##----------------tt-------SS#CSSSSS---SSS-------------------SS---------||||||-----%%%%--%%%-----------------------SQS--S?
-----------------------y-#####----------------tt----------------------------------------------------||||||------||----||------------------------------
--------------------y-######------------------tt-----------K---------------------------------%%%%---||||||------||----||-------y----------------------
--M---------------K-######--------k-k----g----tt------------k--g-g----------------------------||----||||||--ooo-||----||---SSSSS-------------k------gg
XXXXXXXXXXXXXXXXXXXXXXXX------XXXXXXXXX-XXXXXXXXXXXXXXXXXXXXXXXXXXXXXXX----XXXXX--------------||----||||||--%%%-||----||-------XX-XXXXXXXXXXXXXXXXXXXX
XXXXXXXXXXXXXXXXXXXXXXXX------XXXXXXXXX-XXXXXXXXXXXXXXXXXXXXXXXXXXXXXXX----XXXXX--------------||----||||||---|--||----||-------XX-XXXXXXXXXXXXXXXXXXXX
