------------------------------------------------------------------------------------------------------------------------------------------------------
------------------------------------------------------------------------------------------------------------------------------------------------------
------------------------------------------------------------------------------------------------------------------------------------------------------
--------------------------------------------------SSSSSSS---------------------------------------------------------------------------------------------
------------------------------------------------------------------------------------------------------------------------------------------------------
---------------------------------------------------------------------R--------------------------------------------------------------------------------
--------------------S-----------------------------QQ---------------------------------1--------------------2--------oo------------------US-------------
---------------------------TT---o----ooo----------------------------------------------------------------------------------------oo--------------------
---------------------------TT------------------------------S----------o-------------------------------------------------------------------------------
---------------------------XX-------------------------------------------------------------------g---o--------------------------------SS---------------
-------------------%---TT-------------%%----------QQ--QQQ--------%%%---------------QQQQ---------TT--------2----%%%%--%%%-----TT------------S--#LSS----
-----------------------TT--------------|T-----TT------------------|-----------#-----------------TT--------------||----||-----TT---------------#-------
-----------------------TT--------------|T-----TT------------------|----------##-----------------TT--------------||----||-----TT---TT----------#-------
-M-----------%%%%---k--TT------%%%%%%%-|T-----TT------------------|-----------------yy----------TT------y--y--o-||----||-y---TT---TT--------kk#-------
XXXXXXXXXXX---||----XXXXXXXXXX--|||||--|XXXX--XXXXXXXXXXX---%%%%%-|---XXXXXXXXXXXXXXXXXXXXXXXXXXXXX-XXXXXXXXXX%-||----||XXXXXXXXXXXXXXXX-X-XXXXXXXX---
XXXXXXXXXXX---||----XXXXXXXXXX--|||||--|XXXX--XXXXXXXXXXX----|||--|---XXXXXXXXXXXXXXXXXXXXXXXXXXXXX-XXXXXXXXXX--||----||XXXXXXXXXXXXXXXX-X-XXXXXXXX---
