------------------------------------------------------------------------------------------------------------------------------------------------------
------------------------------------------------------------------------------------------------------------------------------------------------------
------------------------------------------------------------------------------------------------------------------------------------------------------
----------------------------------------SSSSSSSSSS----------SSSSSSSSSSSSSSSSSSSS----------------------------------------------------------------------
------------------------------------------------------------SSSS--SSSS--------------------------------------------------------------------------------
----------------------ooor----------------------------------SSSS--SSSS--------------------------------------------------------------------------------
---------------------%%%%%---------------oooo-----------------SS---S---------------USS----SSS------%----SSQSSS----------------------------------------
----------------------|||-------------------------------------SS---S----------TT---------------------------------SSS--------------oo------------------
----------------------|||----------------SSSS-U---------------SS---S----------TT----------------------------------------------------------------------
------------Q--?------|||---------------oS--SoS----------o--ooSS---SoU--------TT--------------------------K-------------------------------------------
---------Q---------S%%%%%%%-------------SS--SSS-------------SSSS---SSS------SCTT--#---------%%%---------SSSSSS-----------------------------Q----------
--------------------||||||----------------------------------------------TT----TT--#----------|-----------------------------------------------------#--
--------------------||||||--o-------------------------------------------TT----TT--##---------|-------------------------------------------------K---#--
------------------K-||||||-%%%----k-k-----kk--------k-------k--g-g------TT---kTT--##--gg-----|---------------------------k----ggg------------------#--
XXXXXXXXXXXXXXXXXXXX||||||--|-XXXXXXXXX-XXXXXXXXXX-XXXXXXXXXXXXXXXXXXXXXXXXXXXXX--XXXXXXXX---|------XXXXXXXXXX%%%%----%%XXXXXXXXXXXXXXXXXXXXXXXXX--XXX
XXXXXXXXXXXXXXXXXXXX||||||--|-XXXXXXXXX-XXXXXXXXXX-XXXXXXXXXXXXXXXXXXXXXXXXXXXXX--XXXXXXXX---|------XXXXXXXXXX|||------|XXXXXXXXXXXXXXXXXXXXXXXXX--XXX
