------------------------------------------------------------------------------------------------------------------------------------------------------
------------------------------------------------------------------------------------------------------------------------------------------------------
------------------------------------------------------------------------------------------------------------------------------------------------------
----------SSSSSSSSSS---oo-----------------------------------SSSSSSSSSS--------------------------------------------------------------------------------
------------------------------------------------------------SSSS--SSSS--------------------------------------------------------------------------------
-------------------------------------------------------oooo-SSSS--SSSS------------g---------oo--------------------------------------------------------
----------------------SSSS-----------------------------%%%%---SS---S-------1----SSSSSSSS----------------SSQSSS----------------------------------------
--------------------------------------------------SSSS--||----SS---S----------------------------------------------------------------------------------
--------------------------------------------------------||----SS---S-------------------------------%-------------------y-------------g#---------------
--------------------------------------------------------||--ooSS---SoU-----ggg----------------------------K------------X------------g##---------------
--------------------------%%%%--------------------------||--SSSS---SSS#########-----------SS------------SSSSSS--------XX------------###---------------
---------------------------|||--------K---------------U-||--------------------#--------------------------------------XXX-----------####---------------
---------------------------|||TTTT----------------------||--------------------#--------------%%%%-------------------XXXX----------#####------------F--
-M-------------------------|||TTTT----------y-y---------||--k--g-g------------#---------------||-------------------XXXXX--kkk-----#####------------#--
XXXXXXXXXXX--XX--X--%%%----|||XXXXXXXXXXXXXXXXXXXX----%%%%%-XXXXXXXXXX--------X-XXXXXX---X----||----XXXXXXXXXXXXXXXXXXXXXXXXXXXXXXXXXXX--XXXXXXXXXXXXX
XXXXXXXXXXX--XX--X--||-----|||XXXXXXXXXXXXXXXXXXXX-----|||--XXXXXXXXXX--------X-XXXXXX---X----||----XXXXXXXXXXXXXXXXXXXXXXXXXXXXXXXXXXX--XXXXXXXXXXXXX
