------------------------------------------------------------------------------------------------------------------------------------------------------
------------------------------------------------------------------------------------------------------------------------------------------------------
------------------------------------------------------------------------------------------------------------------------------------------------------
--------------------------------------------------------------------------------------------------------------SSSSSSSSSS----------SSSSSSSS------U-----
------------------------------------------------------------------------------------------------------------------------------------------------------
-------------------------------------------------------oooo-------------------------------------------------------------------------------------------
-------------------------------------------------------%%%%-------------SSSSS-------y-----------------------------------------------------------------
--------------------------------o----ooo----------------||------------------------#SSS--------------oo--------------------------------------------SS--
--------------------------------------------------------||-----------------------##-------------------------------------------------------------------
--------------------------------------------------SSS---||----------------------###1-------------------------------------------SSS------------SS------
--------------------------------------%%----------------||-------------------2--###-------------TT-----------TT---------%--------------g##-----------#
-----------------K---------------------|T-----TT------U-||-----------T-----TT---###--SSS--------TT-----------TT------------------------###----------##
------------B--------------------------|T-----TT--------||---B-------Tt----TT--T###-------------TT-----------TT----TT----------------g####---------###
-M----------b------------------%%%%%%%-|T-----TT--------||---b-------Tt----TT--T###---------k---TT--------y--TT--g-TT------------r---#####--------####
XXXXXXXXXXXXXXXXXXXXXXXXX--XXX--|||||--|XXXX--XXXX----%%%%%-XXXXXX--XXXXXXXXXXXXXXXXXX---XXXXXXXXXXXXXXXXXXXXXXXXXXXXXXX----XXXXXXXXXXXXXX--XXXXX-XXXX
XXXXXXXXXXXXXXXXXXXXXXXXX--XXX--|||||--|XXXX--XXXX-----|||--XXXXXX--XXXXXXXXXXXXXXXXXX---XXXXXXXXXXXXXXXXXXXXXXXXXXXXXXX----XXXXXXXXXXXXXX--XXXXX-XXXX
