------------------------------------------------------------------------------------------------------------------------------------------------------
------------------------------------------------------------------------------------------------------------------------------------------------------
------------------------------------------------------------------------------------------------------------------------------------------------------
------------------------------------------------------------------------------------------------------------------------------------------------------
-----------------------------------------------------------------------------------------------------------------------------------------------------o
---------------------------------------------------------------------R--------------------------------------------------------------------------------
---------------------------------------------------------Q-Q--------------SSCSS------SUS---------------------------oo---------------------------------
----------------------------------------------------------------------------------------------------oo------------------------------------------SSS---
--------------------------------------------------------------------------------------------------------------------------------------------oo--------
------------------------------------------------------------------------------------------------g-----------------------SS-?Q-------------------------
-------------------%-------------------------------------Q-Q-----%%%----QQQQ--QQ----#####-------TT-----------T-%%%%--%%%--------------------SS--------
------------------------------------------------------------------|-----------------#-----------TT-----------T--||----||------------------------------
------------------------------------------------------------------|----------------K#-----------TT-----------T--||----||-------y----------------------
-M-----------%%%%--------ggg------k-k----------ggg----------------|-----------------#-----------TT--------y--To-||----||---SSSSS--k-------------------
XXXXXXXXXXX---||----XXXXXXXXXXXXXXXXXXX--XXXXXXXXXXXXXXXXXXX%%%%%-|---XXXXXXXXXXXXXXXXX---XXXXXXXXX-XXXXXXXXXX%-||----||-------XX-XX---XXXXX----------
XXXXXXXXXXX---||----XXXXXXXXXXXXXXXXXXX--XXXXXXXXXXXXXXXXXXX-|||--|---XXXXXXXXXXXXXXXXX---XXXXXXXXX-XXXXXXXXXX--||----||-------XX-XX---XXXXX----------
