------------------------------------------------------------------------------------------------------------------------------------------------------
------------------------------------------------------------------------------------------------------------------------------------------------------
------------------------------------------------------------------------------------------------------------------------------------------------------
----------SSSSSSSSSSSSSSSSSSSS-------------------------------------SSSSSSSSSSSSS----------------------------------------SSS-----SS--------------------
--------------------SSSSSSSSSS----------------------------------------------SSSS----------------------------------------------------------------------
--------------------SSSSSSSSSS----------%%-------------------------------g--SSSS----------------------------------------------------------------------
--------------------SSSSSSSSSSS---------|-----------------------CSS-----SS--------------------------------2-------------US----------------------------
----------------------------------------|----oo-------------------------SS----------------------------------------------------------------------------
----------------------------------------|-------------------SS--2-------SS--------TT-----------------------------------y----SSS-----------------------
----------------------------------------|----------------------2-2------SC--g-g---TT-----------oooo-o------------------X------------------------------
--------SU------------SSSSSS?-##--SSC---|----------------tt-------2-----SS--SSSS--TT----------------------2-----------XXSSS---------------------------
----------------------SSSSS-------------|----------------tt-----------------------TT-----T---------------------------XXX------------------------------
----------------------SSSSS-------------|----------------tt---------------------T-TT-----T--------------------------XXXX---------------------------F--
--M------------------------ooo----------|------------g-g-tt---------------------T-TT---k-T--------------y--y-------XXXXX---------------------------#--
XXXXXXXXXXX--XX--X---XXXXXXXXXXX--XXXXXX|----%%%%-XXXXXXXXXX---XXXXXXXXXXXXXXXXXXXXXXXXXXX%%%%%%%-%%XXXXXXXXXXXXXXXXXXXXXXX------XXXXXXXXXXXXXXXXXXXXX
XXXXXXXXXXX--XX--X---XXXXXXXXXXX--XXXXXX|-----||--XXXXXXXXXX---XXXXXXXXXXXXXXXXXXXXXXXXXXX||||||---|XXXXXXXXXXXXXXXXXXXXXXX------XXXXXXXXXXXXXXXXXXXXX
