------------------------------------------------------------------------------------------------------------------------------------------------------
------------------------------------------------------------------------------------------------------------------------------------------------------
------------------------------------------------------------------------------------------------------------------------------------------------------
------------------------------------------------------------------------------------------SSSSSSSSSSSSSSSSSSSSSSSSSSSSSS------------------------------
------------------------------------------------------------------------------------------------------------------------------------------------------
----------------------------------------------------------------------------------------oo------------------------------------------------------------
-----------------------------U--------------------Q-----------------------SS----oo-------------------------------------------------------##-SSS-------
-------------------------------------------------------------o---o---o-------------------------------------------------------------------##-----------
-----------------%%%----------------------------------------%%%-%%%-%%-------------------------------------------------------SSS-------####-----------
------------------||-----------------------------------------|---|---|-----------SS----------------------------------------------------####------SSSSS
------------------||--------##--QQQQ--------------Q----------|---|---|SS-----SS----------S-----------------TT-T---------r------------######-----------
-------------%%%%%||---y-#####-------K-B---------------------|---|---|--------------------t-------------#--TT-T---------%%%%%%-------######-----------
--------------|||-||y-######-----------b---------------------|---|---|--------------------t------------##--TT-T----TT---|||||--------######-SSS-------
-M------------|||-||######-------------b-------------gg----k-|---|-r-|--------------------t---------kk-##--TT-T--g-TT---|||||--------######--------r--
XXXXXXXXXXX---|||-||XXXX------XXXXXXXXXXX-XX-XX-XXXXXXXXXXXX%%%%%%%%%%--------------------XXXXXXXXXXXXXXX--XX-XXXXXXXXXX|||||-----XXXXXXXXXX-----XXXXX
XXXXXXXXXXX---|||-||XXXX------XXXXXXXXXXX-XX-XX-XXXXXXXXXXXX-|||||||||--------------------XXXXXXXXXXXXXXX--XX-XXXXXXXXXX|||||-----XXXXXXXXXX-----XXXXX
