------------------------------------------------------------------------------------------------------------------------------------------------------
------------------------------------------------------------------------------------------------------------------------------------------------------
------------------------------------------------------------------------------------------------------------------------------------------------------
------------------------------SSSSSSSSSSSSSSSSSSSS------------------------------ooo-------------------------------------------------------------------
------------------------------SSSSSSSSSSSSSSSSSS--------------------------------%%%-------------------------------------------------------------------
------------------------------SSSSSSSSSSSSSCSSSS--------------g------------------|--------------------------------------------------------------------
-----------------------------USSSSSSSSSSSSSSSSSS--------------SSSSS-------SSCSS--|-----------------------------------------------------US-------------
---------------------------------------------------------------------------------|------------------oo-----------------------------------------y------
---------------------------------------------------------------------------------|-----------------------------------------------------------#SS--o---
-------------------------------------------ggg-----------------------------------|---%%%%---------oo---------------------------SSS---SS-----##--------
-------------------%--------##SSSSSSSSSSSSSSSSSS---------tt-------------QQQQ--QQ-|----||---------------------T--!-----S-%------------------S##--SC----
-----------------------y-#####SSSSSSSSSSSSSSSSSS---------tt---------------------%%%%%%||-------TT------------T------------------------------##--------
--------------------y-######--SSSSSSSSSSSSSSSSSS---------tt---TT-----t-----------||||-||-------TT------------T--------------------TT--------##---SSS--
-------------%%%%---######----SSSSSSSSSSSSSSSSSS-----g-g-tt---TT-----t-----------||||-||----y--TT---------y--T-------------------rTT--------##--------
XXXXXXXXXXX---||----XXXX------XXXXXXXXXXXXXXXXXXXXXXXXXXXXXXXXXXXXXXXXXXXXXXXXXX-||||-||%%XXXXXXXXXXXXXXXXXXXXXXXXXXXXXX----XXXXXXXXXXXX-X-XXX------XX
XXXXXXXXXXX---||----XXXX------XXXXXXXXXXXXXXXXXXXXXXXXXXXXXXXXXXXXXXXXXXXXXXXXXX-||||-||-|XXXXXXXXXXXXXXXXXXXXXXXXXXXXXX----XXXXXXXXXXXX-X-XXX------XX
