------------------------------------------------------------------------------------------------------------------------------------------------------
------------------------------------------------------------------------------------------------------------------------------------------------------
------------------------------------------------------------------------------------------------------------------------------------------------------
------------------------------------------------------------------------------------------------------------------------------------------------------
------------------------------------------------------------------------------------------------------------------------------------------------------
-------------------------------------------------------oooo-------------------------------------------------------------------------------------------
----------------------------------------------QQQQ-----%%%%--------------------------1--------------------2----------------------------------QQQQ-----
--------------------------------------------------SSSS--||----------------------------------------oo------------oooo----------------------------------
-----------------g--------------------------------------||------------o-------------------------------------------------------------------------------
-----------------#------------------------------k-------||------1-----------------------------------o------------------------------------------y------
----------S-----##----------------------T-----?QQQ------||-------------------------QQQQ-------------------2---T----------------------------#Q?SSQQQ---
---------------###----------------------T-------------U-||--------------------#-----------------#-------------T---------------------------##----------
--------------####----------------------T---------------||-------------------##-----------------#-------------T--------------------------###----------
-M-----------#####----------------k-k---T---------------||--------------------------yy----------#-------y--y--T---y-------kkk--------y--####----------
XXXXXXXXXXXXXXXXXXXXXXXXX--XXXXXXXXXXXX-XXXXXXXXXX----%%%%%-XXXXXXXXX-XXXXXXXXXXXXXXXXXXXXXXXXXXXXXXXXXXXXXXXXXXXXXXXXXXXXXXXXXXXXXXXXXXXXXXXX--XXXXXX
XXXXXXXXXXXXXXXXXXXXXXXXX--XXXXXXXXXXXX-XXXXXXXXXX-----|||--XXXXXXXXX-XXXXXXXXXXXXXXXXXXXXXXXXXXXXXXXXXXXXXXXXXXXXXXXXXXXXXXXXXXXXXXXXXXXXXXXX--XXXXXX
