------------------------------------------------------------------------------------------------------------------------------------------------------
------------------------------------------------------------------------------------------------------------------------------------------------------
------------------------------------------------------------------------------------------------------------------------------------------------------
--------------------------------oo------------------------------------SSSSSSSSSS----------------------------------------------------------------------
-------------------------------------g-g------------------------------------SSSS----------------------------------------------------------------------
-----------------------------------%%%%%ooooo----------------------------g--SSSS--------------------oo------------------------------------------------
------------------------------------||||-----------------Q-Q------------SS-----------1-----SSS!-----%%%-----------------SSS-------!S------------------
------------------------------------||||--------SS----------------------SS--------------------------||--o----R---------------------------------y------
-----------------g------------------||||-SSSS---------------------------SS--------------------------||-%%%-----------------------------------#SS--o---
-----------------#------------%%%%%-||||------------------------1-------SC--g-g---------------------||--|-----------------------------------##--------
----------S-----##--SS---------|||--||||-----------------Q-Q------------SS--SSSS---QQQQ-------C-----||--|-------------------------S------#--##--SC----
---------------###---K---TT----|||--||||------------------------------------------------------------||-o|------#------------------------##--##--------
--------------####-------TT----|||--||||----%%%%%---------------------------------------------------||%%%%%----#--------------TT-------###--##---SSS--
-M-----------#####-------TT----|||--||||-----|||------------------------------------yy---------g-g--||-|||-----#----ggg-------TT------####--##--------
XXXXXXXXXXXXXXXXXXXXXXXXXXXXXX-|||--||||%%---|||--XXXXXXXXXXXXXXXXXXX-XXXXXXXXXXXXXXXXXXXXXXXXXXXXXX||-|||-----XXXXXXXXX----XXXXXXXXXXXXXXXXXX------XX
XXXXXXXXXXXXXXXXXXXXXXXXXXXXXX-|||--|||||----|||--XXXXXXXXXXXXXXXXXXX-XXXXXXXXXXXXXXXXXXXXXXXXXXXXXX||-|||-----XXXXXXXXX----XXXXXXXXXXXXXXXXXX------XX
