------------------------------------------------------------------------------------------------------------------------------------------------------
------------------------------------------------------------------------------------------------------------------------------------------------------
------------------------------------------------------------------------------------------------------------------------------------------------------
--------------------------------------------------------------------------------ooo-------------------------------------SSSSSSSSSS--------------------
--------------------------------------------------------------------------------%%%------------------------------------------------------------------o
---------------------------------------------------------------------------------|------------------oo------------------------------------------------
------------------Q---------------------------QQQQ-------Q-Q---------------------|------------------%%%------------oo---------------------------------
---------------------------------------------------------------------------------|------------------||--o----R----------------------------------SSS---
---------------------------------------------------------------------------------|------------------||-%%%----------------------------------oo--------
------------------------------------------------k---------------1----------------|---%%%%-----------||--|---------------------------------------------
------------------?---------------------T-----?QQQ-------Q-Q---------------------|----||------------||--|------%%%%--%%%--------------------SS--------
--------------TT-----------------------TT---------------------------------------%%%%%%||------------||-o|-------||----||--SS---------TT---------------
--------------TT-----------------------TT----------------------------------------||||-||------------||%%%%%-----||----||--SS---------TT---------------
---M----------TT---------------------kkTT----------------------------------------||||-||-----------g||-|||----o-||----||--SS---------TT---------------
XXXXXXXXXXXXXXXXXXXXXXXXX--XXXXXXXXXXXXXXXXXXXXXXXXXXXXXXXXXXXXXXXXXX-X----XXXXX-||||-||%%-XXXXXXXXX||-|||----%-||----||--XX--XXXXXXXXXXXXXX----------
XXXXXXXXXXXXXXXXXXXXXXXXX--XXXXXXXXXXXXXXXXXXXXXXXXXXXXXXXXXXXXXXXXXX-X----XXXXX-||||-||-|-XXXXXXXXX||-|||------||----||--XX--XXXXXXXXXXXXXX----------
