------------------------------------------------------------------------------------------------------------------------------------------------------
------------------------------------------------------------------------------------------------------------------------------------------------------
------------------------------------------------------------------------------------------------------------------------------------------------------
--------------------------------oo------SSSSSSSSSS----------------------------------------------------------------------------------------------------
---------------------------------------gSSSSSSSS------------------------------------------------------------------------------------------------------
-----------------------------------%%%%%SSSCSSSS------------------------------------------------------------------------------------------------------
----------------------!-------------||||SSSSSSSS--Q--------------------------------USS----------------------------------------------------------------
------------------------------------||||-------------------------------------------------------------------------SSS----------------------------------
------------------------------------||||--------------------------------------------------------------------------------------------------------------
------------Q--?--------------%%%%%-||||---ggg------------------1------------------------------oooo---------------------------------------------------
-------------------SS@S!S------|||--||||SSSSSSSS--Q-------------------------------#---------------------------------------------------------#---------
-------------------------------|||--||||SSSSSSSS----------------------------------#--------------------------------------------------TT-----##--------
----------------------------tt-|||--||||SSSSSSSS----------------------------------##----------------------*--------------------------TT-----###------#
------------------K--g------tt-|||--||||SSSSSSSS-----gg----k----------gg----------##--gg------------gg----*---------------kkk--------TT-----####----##
XXXXXXXXXXXXXXXXXXXXXXXXXXXXXX-|||--||||XXXXXXXXXXXXXXXXXXXXXXXXXXXXX-XXXXXXXXXX--XXXXXXXX%%%%%%%-%%XXXXXXXXX-%%%%----%%XXXXXXXXXXXXXXXXXXXXXXXXXXXXXX
XXXXXXXXXXXXXXXXXXXXXXXXXXXXXX-|||--||||XXXXXXXXXXXXXXXXXXXXXXXXXXXXX-XXXXXXXXXX--XXXXXXXX||||||---|XXXXXXXXX-|||------|XXXXXXXXXXXXXXXXXXXXXXXXXXXXXX
