------------------------------------------------------------------------------------------------------------------------------------------------------
------------------------------------------------------------------------------------------------------------------------------------------------------
------------------------------------------------------------------------------------------------------------------------------------------------------
----------------------------------------SSSSSSSSSS----------SSSSSSSSSS----------ooo-------------------------------------------------------------------
------------------------------------------------------------SSSS--SSSS----------%%%------------------------------------------------------------------o
-------------------------------------------------------oooo-SSSS--SSSS-----------|--------------------------------------------------------------------
------------------SC---------------------oooo----------%%%%---SS---S-------g-----|----------------------------?SSS--------oo---%%%!S------------------
--------------------------------------------------SSSS--||----SS---S---%%%%%%----|----------------------------------------SS----||--------------SSS---
-----------------------------------------SSSS-U---------||----SS---S----||||-----|----------------------------------------------||----------oo--------
----------------------------------------oS--SoS---------||--ooSS---SoU--||||-----|---%%%%---------oo----------------------------||--------------------
--------------TT---2--------TT----------SS--SSS---------||--SSSS---SSS--||||-----|----||----------------------SSSSS----------SS-||S------#--SS--------
--------------TT------------TT---------T--------------U-||--------------||||----%%%%%%||-------TT-------------------------------||------##------------
--------------TT------------TT---------T----------------||--------------||||-----||||-||-------TT---------*---------------------||-----###------------
-M------------TT--------ggg-TT-------kkT--kk------------||--k--g-g------||||-----||||-||----y--TT---gg----*-----K---------------||----####------------
XXXXXXXXXXXXXXXXXXXXXXXXXXXXXXXXXXXXXXXXXXXXXXXXXX----%%%%%-XXXXXXXXXX--||||-----||||-||%%XXXXXXXXXXXXXXXXXXX-XXXXXXXXXX%%-----%%%XXXXXXXXXX----------
XXXXXXXXXXXXXXXXXXXXXXXXXXXXXXXXXXXXXXXXXXXXXXXXXX-----|||--XXXXXXXXXX--||||-----||||-||-|XXXXXXXXXXXXXXXXXXX-XXXXXXXXXX|-------||XXXXXXXXXX----------
