------------------------------------------------------------------------------------------------------------------------------------------------------
------------------------------------------------------------------------------------------------------------------------------------------------------
------------------------------------------------------------------------------------------------------------------------------------------------------
--------------------------------------------------------------------------------ooo-------------------------------------------------------------------
-----------------------------------------g--------------------------------------%%%-------------------------------------------------------------------
----------------------------------------%%---------------------------R-----------|--------------------------------------------------------------------
----------------------------------------|-----------------------------------SSSS-|--------------------------------------------------------------------
--------------------------------o----ooo|----oo----------------------------------|------------------------TT----------------------oo------------------
----------------------------------------|----------------B-----------------------|------------------------TT------------------SSS---------------------
----------------------------------------|----------------b-------------------K---|---%%%%-------g---------TT------------------------------------------
-----SSS-----------%SS----------------%%|--------------SS#CS-----%%%-------SSSSS-|----||--------TT-------SXXS---!-----S-%------------------Q----------
---------------------K---TT------------||-------------------------|---T---------%%%%%%||--------TT----------------------------------------------------
-------------------------TT------------||------------------K------|---T----------||||-||--------TT--TT---------------------------------------------F--
-------------%%%%--------TT----%%%%%%%-||-------------------------|---T----------||||-||--------TT--TT---------------------------r-----------------#--
XXXXXXXXXXX---||----XXXXXXXXXX--|||||--||----%%%%-XXXXXXXXXX%%%%%-|---XXXXXXXXXX-||||-||%%XXXXXXXXX-XXXXXXXXXXXXXXXXXXXX----XXXXXXXXXXXXXXXXXXXXXXXXXX
XXXXXXXXXXX---||----XXXXXXXXXX--|||||--||-----||--XXXXXXXXXX-|||--|---XXXXXXXXXX-||||-||-|XXXXXXXXX-XXXXXXXXXXXXXXXXXXXX----XXXXXXXXXXXXXXXXXXXXXXXXXX
