------------------------------------------------------------------------------------------------------------------------------------------------------
------------------------------------------------------------------------------------------------------------------------------------------------------
------------------------------------------------------------------------------------------------------------------------------------------------------
--------------------SSSSSSSSSS----------------------------------------SSSSSSSSSS----------------------------------------------------------------------
--------------------SSSSSSSSSS------------------------------------------------------------------------------------------------------------------------
--------------------SSSSSSSSSS----------%%---------------------------R------------------oo------------------------------------------------------------
--------------------SSSSSSSSSS----------|---------------------------------------oo--------SSS------%----------------------SSC-------------------------
----------------------------------------|----oo-------------------------------TT--------------------------------oooo---------------------------y------
-----------------g----------------------|-------------------------------------TT-------------------------------------------------------------#SS--o---
-----------------#----------------------|-------------------------------------TT-SSS--------------------------------------SSS---------------##--------
----------S-----##----SSSSSS?-----------|--------------ooo-------%%%--------SCTT---------S--%%%---------------T-----------------------------##--SC----
---------------###----SSSSS------------T|-------------------------|-----TT----TT-------------|--------------g-T-----------------------------##--------
--------------####----SSSSS------------T|-------------------------|-----TT----TT-------------|--------------TTT-----------------------------##---SSS--
-M-----------#####---------ooo-------kkT|-------------------------|-----TT---kTT-------------|--------------TTT---y--------------#----------##--------
XXXXXXXXXXXXXXXXXXXX-XXXXXXXXXXXXXXXXXXX|----%%%%---XXXXXXXX%%%%%-|---XXXXXXXXXX-------------|--------XXXXXXXXXXXXXXXXXXX----XXXXXXXXXXXXXXXXX------XX
XXXXXXXXXXXXXXXXXXXX-XXXXXXXXXXXXXXXXXXX|-----||----XXXXXXXX-|||--|---XXXXXXXXXX-------------|--------XXXXXXXXXXXXXXXXXXX----XXXXXXXXXXXXXXXXX------XX
