------------------------------------------------------------------------------------------------------------------------------------------------------
------------------------------------------------------------------------------------------------------------------------------------------------------
------------------------------------------------------------------------------------------------------------------------------------------------------
--------------------------------oo------SSSSSSSSSS----------------------------------------------------------------------SSSSSSSSSS--------------------
---------------------------------------g--------------------------------------------------------------------------------------------------------------
-----------------------------------%%%%%------------------------------------------------------------oo------------------------------------------------
-----------------------------U------||||-oooo------------------------------1-------o--o----SSS!-----%%%----------------------------SSSS------------SSS
------------------------------------||||------------------------------------------------------------||--o----R----------------------------------------
------------------------------------||||-SSSS-U-----------------------------------------------------||-%%%-------------y------------------------------
------------------------------%%%%%-||||oS--SoS----------o-----------------ggg-----SSSS-------------||--|--------------X---------------SSSS-----------
--------SU---------%--------##-|||--||||SS--SSS-----------------------#########---------------C-----||--|-------------XX--------------------------#---
-----------------------y-#####-|||--||||-----------------------------T--------#---------------------||-o|------------XXX--SS----------------------#---
--------------------y-######---|||--||||---------------------B-------T--------#-%%%-----------------||%%%%%---------XXXX--SS----------------------#---
--M----------%%%%---######-----|||--||||--kk--------k--------b-------T--------#-||-------------g-g--||-|||---------XXXXX--SS-----------------ggg--#---
XXXXXXXXXXX---||----XXXX-------|||--||||XXXXXXXXXX-XXXXXXXXXXXXXXX--XX--------X-||--------XXXXXXXXXX||-|||----XXXXXXXXXX--XX--XXXX---------XXXXXXXXXXX
XXXXXXXXXXX---||----XXXX-------|||--||||XXXXXXXXXX-XXXXXXXXXXXXXXX--XX--------X-||--------XXXXXXXXXX||-|||----XXXXXXXXXX--XX--XXXX---------XXXXXXXXXXX
