------------------------------------------------------------------------------------------------------------------------------------------------------
------------------------------------------------------------------------------------------------------------------------------------------------------
------------------------------------------------------------------------------------------------------------------------------------------------------
-----------------------oo--------------------------oo-----------------------------------------------SSSSSSSSSS----------SSSSSSSSSS--------------------
--------------------------------------------------%%%%-------------------o----------------------------------------------------------------------------
---------------------------------------------------||-------------------%%%-------------oo--oo--------------------------------------------------------
----------------------SSSS--------------------QQQQ-||--------------------|--o---oo---------------------------------oo--------------------##-----------
---------------------------------------------------||--SSS---------------|--SSSS---------------------------------------------------------##-----------
---------------------------------------------------||-----------------%--|-------------------------%-----------------------------------####-----------
------------------------------------------------k--||--------------------|-------SSS---------------------------------------------------####-----------
--------------------------%%%%----------T-----?QQQ-||--------------------|---------------SSS-----------------T-%%%%--%%%-------------######---#LSS----
---------------------------|||--------K-T----------||----------------T---|-----------------------------TT----T--||----||--SS---------######---#-------
---------------------------|||TTTT------T---------%||--------B-------T---|-----%-------------%%%%------TT----T--||----||--SS---------######---#-------
-M--------k---ggg----------|||TTTT------T----------||--------b-------T---|--------------------||----g--TT----To-||----||--SS---------######-kk#-------
XXXXXXXXXXXXXXXXXXXX%%%----|||XXXXXXXXXXXXXXXXXXXX-||-------XXXXXX--XX%%%%%%------------------||----XXXXXXXXXX%-||----||--XX--XXXXXXXXXXXXXXXXXXXXX---
XXXXXXXXXXXXXXXXXXXX||-----|||XXXXXXXXXXXXXXXXXXXX-||-------XXXXXX--XX|||||-------------------||----XXXXXXXXXX--||----||--XX--XXXXXXXXXXXXXXXXXXXXX---
