------------------------------------------------------------------------------------------------------------------------------------------------------
------------------------------------------------------------------------------------------------------------------------------------------------------
------------------------------------------------------------------------------------------------------------------------------------------------------
------------------------------------------------------------------------------------------------------------------------------------------------------
------------------------------------------------------------------------------------------------------------------------------------------------------
---------------------------------------------------------------------R------------------oo------------------------------------------------------------
--------------------S---------S-------------------------------------------------oo---------------------------@------------oo---%%%%----------------SSS
---------------------------TT-----------------------------------------------------------------------------------oooo------SS----||--------------------
---------------------------TT---------------------------------------------------------------------------------------------------||------SSS-----------
---------------------------XX----------------------------------------------------SS------------oooo-----------------------------||--------------------
-------------------%---TT-----##--SSC------------------ooo-------%%%---------------------S----------SU----!--!T--------------SS-||%%%%%-----------#---
-----------------------TT-----------------------------------------|-------------------------------------------T-----------------||-|||------------#---
-----------------------TT-----------------------------------------|-------------------------------------------T-----------------||-|||------------#---
-M-----------%%%%---k--TT----------------------y------------------|---------------------------------------k---T---y-------------||-|||-------ggg--#---
XXXXXXXXXXX---||----XXXXXXXXXXXX--XXXXXXXXXXXXXXXX--XXXXXXXX%%%%%-|---X----XXXXX----------%%%%%%%-%%XXXXXXXXXXXXXXXXXXXX%%-----%%%%|||------XXXXXXXXXX
XXXXXXXXXXX---||----XXXXXXXXXXXX--XXXXXXXXXXXXXXXX--XXXXXXXX-|||--|---X----XXXXX----------||||||---|XXXXXXXXXXXXXXXXXXXX|-------||-|||------XXXXXXXXXX
