------------------------------------------------------------------------------------------------------------------------------------------------------
------------------------------------------------------------------------------------------------------------------------------------------------------
------------------------------------------------------------------------------------------------------------------------------------------------------
-----------------------oo---------------SSSSSSSSSS-----------------SSSSSSSSSSSSS----------------------------------------------------------------------
----------------------------------------------------------------------------SSSS----------------------------------------------------------------------
-------------------------------------------------------oooo--------------g--SSSS--------oo------------------------------------------------------------
----------------------SSSS----S----------oooo----------%%%%-----CSS-----SS------oo---------------------------R-------------------------US---SS--------
--------------------------------------------------SSSS--||--------------SS------------------------oo-r------------------------------------------------
-----------------------------------------SSSS-U---------||--SS--2-------SS--------------------------%%%%%%%-------------------------------------------
----------------------------------------oS--SoS---------||-----2-2------SC--g-g--SS-----------------||||||---------------------------SS---------------
----------Q---------------%%%%##--SSC---SS--SSS---------||--------2-----SS--SSSS---------S----------||||||------!-----S--------------------SSS--------
---------------------------|||------------------------U-||--------------------------------------#---||||||----------------------------------------#-TT
---------------------------|||--------------------------||--------------------------------------#---||||||------------------------TT-------------##-TT
-M-----------------#-------|||------------kk------------||--------------------------------------#---||||||--oo------------kkk-----TT------------###-TT
XXXXXXXXXXXXX--XXXXX%%%----|||XX--XXXXXXXXXXXXXXXX----%%%%%----XXXXXXXXXXXXXXXXX----------XXXXXXXXXX||||||--%%XXXXXXXXXXXXXXXXXXXXXXXXXX-X-XXXXXXXX-XX
XXXXXXXXXXXXX--XXXXX||-----|||XX--XXXXXXXXXXXXXXXX-----|||-----XXXXXXXXXXXXXXXXX----------XXXXXXXXXX||||||---|XXXXXXXXXXXXXXXXXXXXXXXXXX-X-XXXXXXXX-XX
