------------------------------------------------------------------------------------------------------------------------------------------------------
------------------------------------------------------------------------------------------------------------------------------------------------------
------------------------------------------------------------------------------------------------------------------------------------------------------
------------------------------------------------------------------------------------------------------------------------------------------------U-----
------------------------------------------------------------------------------------------------------------------------------------------------------
-----------------------SSS----------------------------------------------------------------------------------------------------------------------------
--------------------------------------------------Q-----------------------SS--------y------------------------@----------SS----------------------------
---------------------g------------------------------------------------------------#SSS------------------------------------------------------------SS--
--------------------%%%----------------------------------------------------------##-------------------------------------------------------------------
--------------------||----SSS---------------------------------------------------###1-------o-------------------------------TT-----------------SS------
-----SSS-----------%||-----------------T----------Q-------------------SS-----SS-###--------------TT-SU----!--!-------------TT------------------------#
--------------------||-----------------T-----------------------------T----------###--SSS---------TT---------------------t--TT-----------------------##
--------------------||-----------------T---------------------B-------T----------###--------------TT---------------------t--TT----------------------###
-------------%%%%---||----oo----gg-----T----y-y------gg----k-b-------T----------###--------------TT-------k----k----kkk-t--TT---------------------####
XXXXXXXXXXX---||----||---%%%--XXXXXXXXXXXXXXXXXXXXXXXXXXXXXXXXXXXX--XX----------XXXXXX---XXXXXXXXXXXXXXXXXXXXXXXXXXXXXXXXXXXXXXXXXXXXXXXXXXXXXXXX-XXXX
XXXXXXXXXXX---||----||----|---XXXXXXXXXXXXXXXXXXXXXXXXXXXXXXXXXXXX--XX----------XXXXXX---XXXXXXXXXXXXXXXXXXXXXXXXXXXXXXXXXXXXXXXXXXXXXXXXXXXXXXXX-XXXX
