------------------------------------------------------------------------------------------------------------------------------------------------------
------------------------------------------------------------------------------------------------------------------------------------------------------
------------------------------------------------------------------------------------------------------------------------------------------------------
----------SSSSSSSSSS------------oo----------------SSSSSSS-------------SSSSSSSSSS----------------------------------------------------------------------
---------------------------------------g--------------------------------------------------------------------------------------------------------------
-----------------------------------%%%%%--------------------------------------------------------------------------------------------------------------
--------------------USS-------------||||------QQQQQQ--------------------------------y------------------------@-----------SSS----S!-------##-----------
------------------------------------||||--------------------------------------TT--#SSS---------------------------SSS---------------------##-----------
------------------------------------||||-------------------S---------o--------TT-##----------------------------------------------------####-----------
------------------------------%%%%%-||||--------k----------------y------------TT###1---------------------------------------------------####-----------
---------Q---------------------|||--||||T-----?QQQQQ--QQQ--------##---------SCTT###-------------TT--SU----!--!-------------------S---######-----------
---------------------B---------|||--||||T-----------------------###-----TT----TT###--SSS--------TT-----------------------------------######-----------
---------------------b-------B-|||--||||T----------------------####-----TT----TT###-------------TT-----------------------------------######--------F--
---------------------B-------b-|||--||||T---------------------#####-----TT---kTT###---------k---TT--------k-----------------gg-g-g---######--------#--
XXXXXXXXXXX--XX--X--XXXXXXXXXX-|||--||||XXXXXXXXXXXXXXXXX---XXXXXXX---XXXXXXXXXXXXXXXX---XXXXXXXXXXXXXXXXXXXXX%%%%----%%XXXXXXXXXXXXXXXXXXXXXXXXXXXXXX
XXXXXXXXXXX--XX--X--XXXXXXXXXX-|||--||||XXXXXXXXXXXXXXXXX---XXXXXXX---XXXXXXXXXXXXXXXX---XXXXXXXXXXXXXXXXXXXXX|||------|XXXXXXXXXXXXXXXXXXXXXXXXXXXXXX
