------------------------------------------------------------------------------------------------------------------------------------------------------
------------------------------------------------------------------------------------------------------------------------------------------------------
------------------------------------------------------------------------------------------------------------------------------------------------------
S-----SSSS-------------oo---------------SSSSSSSSSS--------------------------------------------------SSSSSSSSSS----------------------------------------
S------------------------------------------------------------------------o----------------------------------------------------------------------------
S-----------------------------------------------------------------------%%%-------g-------------------------------------------------------------------
S-----------------SC--SSSS---------------oooo----------------------------|--o---SSSSSSSS----------------------------------oo---%%%----------SS--------
S-------------------------------o----ooo---------------------------------|--SSSS--------------------------------oooo------SS----||--------------------
S----------------------------------------SSSS-U-----------------------%--|------------------------------------------------------||--------------------
S---------------------------------------oS--SoS----------o---------------|------------------------------------------------------||--------------------
S-------------TT---2------%%%%--------%%SS--SSS--------------------------|----------------------TT-----------TT--------------SS-||----------SS--------
S-------------TT-----------|||---------|---------------------------------|----------------------TT-----TT----TT-----------------||----------------#-TT
S-------------TT-----------|||---------|---------------------------------|-----%----------------TT-----TT----TT-----------------||---------------##-TT
S-------------TT-----------|||-%%%%%%%-|--kk--------k-------gg-------g---|------------------k---TT--g--TT----TT---y-------------||k-------------###-TT
XXXXXXXXXXXXXXXXXXXX%%%----|||--|||||--|XXXXXXXXXX-XXXXXXXXXXXXXXXXXXX%%%%%%----XXXXXX---XXXXXXXXXXXXXXXXXXXXXXXXXXXXXXX%%-----%%%XX---XXXXXXXXXXXX-XX
XXXXXXXXXXXXXXXXXXXX||-----|||--|||||--|XXXXXXXXXX-XXXXXXXXXXXXXXXXXXX|||||-----XXXXXX---XXXXXXXXXXXXXXXXXXXXXXXXXXXXXXX|-------||XX---XXXXXXXXXXXX-XX
