------------------------------------------------------------------------------------------------------------------------------------------------------
------------------------------------------------------------------------------------------------------------------------------------------------------
------------------------------------------------------------------------------------------------------------------------------------------------------
----------SSSSSSSSSS------------oo---------------------------------SSS--------------------------------------------------------------------------------
-------------------------------------g-g-g-----------------------------------------------------------------------------------------------------------o
-----------------------------------%%%%%%%------------------------------------------------------------------------------------------------------------
----------------------!-------------|||||---------Q-------------CSS------------------SSSS-----------------2-------------SS----------------------------
------------------------------------|||||----oo-----------------------------------------------------------------------------------oo------------SSS---
------------------------------------|||||-------------------SS--2--------------g------------------------------------------------------------oo--------
------------------------------%%%%%-|||||----------------------2-2--------------------------------ooo----------------------TT-------------------------
----------@QQQQ-----S@S!S------|||--|||||---------Q---------------2----------S@SQ-------------------------2----------------TT--------------QSS--------
-------------------------------|||--|||||------------------------------------------------------TT--------------#--------t--TT-------------------------
-----------------g-#--------tt-|||--|||||------------------------------------------------------TT--------------#--------t--TT-------------------------
-M--------------g#-#-g------tt-|||--|||||------------gg----k---------------------ggg--------y--TT-------y--y---#----ggg-t--TT-------------------------
XXXXXXXXXXXXXXXXXXXXXXXXXXXXXX-|||--|||||----%%%%-XXXXXXXXXX---XXXXXXX-XXXXXXXXXXXXXX----XXXXXXXXXXXXXXXXXXXXX-XXXXXXXXXXXXXXXXXXXXXXXXXXXXX----------
XXXXXXXXXXXXXXXXXXXXXXXXXXXXXX-|||--|||||-----||--XXXXXXXXXX---XXXXXXX-XXXXXXXXXXXXXX----XXXXXXXXXXXXXXXXXXXXX-XXXXXXXXXXXXXXXXXXXXXXXXXXXXX----------
