------------------------------------------------------------------------------------------------------------------------------------------------------
------------------------------------------------------------------------------------------------------------------------------------------------------
------------------------------------------------------------------------------------------------------------------------------------------------------
---------------------------------------------------oo---------------------------------------------------------------------------------------SSSSSSSSSS
--------------------------------------------------%%%%------------------------------------------------------------------------------------------------
-----------------------SSS-------------------------||-------------------------------------------------oo----------------------------------------------
---------------------------------------------------||-------------------SSSSS--------SUS-------------------------------------------------##-----------
---------------------g-----------------------------||--SSS-------------------------------------------------------------------------------##-----------
--------------------%%%----------------------------||-------------------------------------------------------------------------SSS------####-----------
--------------------||----SSS----------------------||-------------------------------------------g--------------------------------------####-----------
---------QQ---------||-----------------------------||------------------------2------#####-------TT----------------------%------------######---TT------
--------------------||-----------------------------||----------------------TT-------#-----------TT-----------------------------------######---TT------
--------------------||----------------------------%||-----------------t----TT--T---K#-----------TT----------tt-----B-----------------######---TT------
-M-----------------#||----oo------k-k----------ggg-||--------y--------t----TT--T----#-----------TT----ggg---tt-----b-------------r---######---TT------
XXXXXXXXXXXXX--XXXXX||---%%%--XXXXXXXXX--XXXXXXXXX-||-------XXXXXXXXXXXXXXXXXXXXXXXXXXX---XXXXXXXXX-XXXXXXXXXXXXXXXXXXXX----XXXXXXXXXXXXXXXXXXXX--XXXX
XXXXXXXXXXXXX--XXXXX||----|---XXXXXXXXX--XXXXXXXXX-||-------XXXXXXXXXXXXXXXXXXXXXXXXXXX---XXXXXXXXX-XXXXXXXXXXXXXXXXXXXX----XXXXXXXXXXXXXXXXXXXX--XXXX
