------------------------------------------------------------------------------------------------------------------------------------------------------
------------------------------------------------------------------------------------------------------------------------------------------------------
------------------------------------------------------------------------------------------------------------------------------------------------------
------------------------------------------------------------SSSSSSSSSS----------SSSSSSSSSS------------------------------------------------------------
------------------------------------------------------------SSSS--SSSS--------------------------------------------------------------------------------
------------------------------------------------------------SSSS--SSSS--------------------------------------------------------------------------k-----
------------------SC----------S-------------------------------SS---S------SSCSS-----------SSS------%---------R---------------------------------SQS--SQ
--------------------------------------------------------------SS---S-------------------------------------r--------------------------------------------
--------------------------------------------------------------SS---S--------------------------------%%%%%%%-------------------------------------------
------------------------------------------------------------ooSS---SoU-----------------S------------||||||---------------------SSS--------------------
--------------TT---2----------##--SSC-----------------------SSSS---SSS--QQQQ--QQSU----------%%%-----||||||------!-----S-%----------------------SQS--S?
--------------TT------------------------------------K-------------------------------TT---t---|------||||||--------------------------------------------
--------------TT--------------------------------------------------------------------TT---t---|------||||||--------------------------------------------
-M------------TT-------------------------------------------gk--g-g-----------------kTT--kt---|------||||||--oo-------------------rk----------k------gg
XXXXXXXXXXXXXXXXXXXXXXXXX--XXXXX--XXXXXXX-XX-XX-XXXXXXXXXXXXXXXXXXXXXXXXXXXXXXXXXXXXXXXXXX---|------||||||--%%XXXXXXXXXX----XXXXXXXX---XXXXXXXXXXXXXXX
XXXXXXXXXXXXXXXXXXXXXXXXX--XXXXX--XXXXXXX-XX-XX-XXXXXXXXXXXXXXXXXXXXXXXXXXXXXXXXXXXXXXXXXX---|------||||||---|XXXXXXXXXX----XXXXXXXX---XXXXXXXXXXXXXXX
