------------------------------------------------------------------------------------------------------------------------------------------------------
------------------------------------------------------------------------------------------------------------------------------------------------------
------------------------------------------------------------------------------------------------------------------------------------------------------
--------------------------------------------------------------------------------------------------------------SS-------S------------------------------
------------------------------------------------------------------------------------------------------------------------------------------------------
-------------------------------------------------------oooo-------------------------------------------------------------------------------------------
-----------------------------U-------------------------%%%%---------------SSCSS----------------------------------------S------------------------------
--------------------------------------------------------||------------------------------------------------------------------------oo------------------
--------------------------------------------------------||------------------------TT-------------------------------SSS--------SSS---------------------
--------------------------------------------------SSS---||------------------------TT------------------------------------------------------------------
----------Q-----------------##--------------------------||--------------QQQQ--QQ--TT-------------tt--------------------S%------------------Q--#LSS----
-----------------------y-#####--------K-T-----TT------U-||------------------------TT-----TT------tt------------##-----------------------------#-------
--------------------y-######--TTTT------T-----TT--------||----------------------T-TT-----TT------tt-------*----##-----------------------------#-------
-M-----------------#######----TTTT------T-----TT--------||---y------------------T-TT---k-TT------tt-gg----*----##----------------r----------kk#-------
XXXXXXXXXXXXX--XXXXXXXXX------XXXXXXXXXXXXXX--XXXX----%%%%%-XXXXXXXXXXXXXXXXXXXXXXXXXXXXXXXXXXXXXXXXXXXXXXXXX--XX------X----XXXXXXXXXXXXXXXXXXXXXXX---
XXXXXXXXXXXXX--XXXXXXXXX------XXXXXXXXXXXXXX--XXXX-----|||--XXXXXXXXXXXXXXXXXXXXXXXXXXXXXXXXXXXXXXXXXXXXXXXXX--XX------X----XXXXXXXXXXXXXXXXXXXXXXX---
