------------------------------------------------------------------------------------------------------------------------------------------------------
------------------------------------------------------------------------------------------------------------------------------------------------------
------------------------------------------------------------------------------------------------------------------------------------------------------
--------------------------------oo----------------------------------------------SSSSSSSSSL------------------------------------------------------------
---------------------------------------g----?---------------------------------------------------------------------------------------------------------
-----------------------------------%%%%%--------------------------------------------------------------------------------------------------------k-----
----------------------!-------------||||--------------------------------------------oooooo-------------------R---------------------------------SQS--SQ
------------------------------------||||------r------------------------------------------------------r------------------------------------------------
-----------------g------------------||||--%%%%%%---------TT----------o--------------SSSSSS----------%%%%%%%-------------------SSS---------------------
-----------------#------------%%%%%-||||---||||----TT----TT------y------------------SSSSSS----------||||||--------------------------------------------
--------SUS-----##--S@S!S------|||--||||%%-||||ooo-TT----XX------##-----------------------------TT--||||||------------r-%----------------------SQS--S?
---------------###-------------|||--|||||--||||--r-TT-----------###-----------------------------TT--||||||--------%%%%%%-------------TT---------------
--------------####----------tt-|||--|||||%%%%%%%%%-TT----------####-----------------------------TT--||||||---------|||||-------------TT---------------
--M----------#####---g------tt-|||--|||||-||||||||-TT---------#####-------------------------k---TT--||||||--oo-----|||||---------r---TT------k------gg
XXXXXXXXXXXXXXXXXXXXXXXXXXXXXX-|||--|||||-||||||||XXXXXXXXXXXXXXXXX---X----XXXXX---XXXXXXXXXXXXXXXXX||||||--%%-%%%-|||||----XXXXXXXXXXXXXXXXXXXXXXXXXX
XXXXXXXXXXXXXXXXXXXXXXXXXXXXXX-|||--|||||-||||||||XXXXXXXXXXXXXXXXX---X----XXXXX---XXXXXXXXXXXXXXXXX||||||---|--|--|||||----XXXXXXXXXXXXXXXXXXXXXXXXXX
