------------------------------------------------------------------------------------------------------------------------------------------------------
------------------------------------------------------------------------------------------------------------------------------------------------------
------------------------------------------------------------------------------------------------------------------------------------------------------
----------SSSSSSSSSSSSSSSSSSSS--------------------------------------------------------------------------------SSSSSSSSSS------------------------------
--------------------SSSSSSSSSS------------------------------------------------------------------------------------------------------------------------
--------------------SSSSSSSSSS------------------------------------------------------------------------------------------------------------------------
--------------------SSSSSSSSSS----------------------------------------------SSSS------------------------------------------------------------SS--------
--------------------------------o----ooo------------------------------------------------------------------TT--------------------oo--------------------
---------------------------------------------------------B------------------------------------------------TT------------------------------------------
---------------------------------------------------------b-------------------K----o------------oooo-------TT------------------------------------------
----------@QQQQ-------SSSSSS?---------%%---------------SS#CS---------------SSSSS-------TT----------------SXXS-T--------------TT-------------SS--------
----------------------SSSSS------------|T-----TT----------------------T----------------TT---------------------T--------------TT-------------------#-TT
-----------------g-#--SSSSS------------|T-----TT-----------K----------T----------------TT-----------TT--------T----TT--------TT------------------##-TT
-M--------------g#-#-------ooo-%%%%%%%-|T-----TT------------gg-------gT----------------TT-----------TT--------T--g-TT----y---TT-----------------###-TT
XXXXXXXXXXXXXXXXXXXX-XXXXXXXXX--|||||--|XXXX--XXXXXXXXXXXXXXXXXXXXXXXXXXXXXXXXXXXXXXXXXXXX%%%%%%%-%%XXXXXXXXXXXXXXXXXXXXXXXXXXXXXXXXXXXXXXXXXXXXXXX-XX
XXXXXXXXXXXXXXXXXXXX-XXXXXXXXX--|||||--|XXXX--XXXXXXXXXXXXXXXXXXXXXXXXXXXXXXXXXXXXXXXXXXXX||||||---|XXXXXXXXXXXXXXXXXXXXXXXXXXXXXXXXXXXXXXXXXXXXXXX-XX
