------------------------------------------------------------------------------------------------------------------------------------------------------
------------------------------------------------------------------------------------------------------------------------------------------------------
------------------------------------------------------------------------------------------------------------------------------------------------------
S-----SSSS--------------------------------------------------------------------------------------------------------------------------------------------
S-----------------------------------------------------------------------------------------------------------------------------------------------------
S-----------------------------------------------------------------------------------------------------oo----------------------------------------------
S--------------------------------------------------------------------------1---------1--------------------------------------------!S------------------
S-------------------------------------------------------------------------------------------------oo--------------------------------------------------
S----------------%%%-------------------------------------TT-------------------------------------------------------------------------------------------
S-----------------||-------------------------------TT----TT----------------ggg------------------------------------------------------------------------
S-----------------||SS-------------------TT---SU---TT----XX-----------#########----QQQQ-------------------------!-----S-----------S------#------------
S------------%%%%%||-K---TT-----------tt-TT--------TT-------------------------#-----------------#---------------------------------------##------------
S-------------|||-||-----TT-----------tt-TT--------TT-------------------------#-----------------#-----------tt-------------------------###---------F--
S-------------|||-||-----TT-----------tt-TT------k-TT--------y----------------#-----yy----------#-----ggg---tt------------kkk---------####---------#--
XXXXXXXXXXX---|||-||XXXXXXXXXXXXXXXXXXXXXXXXXXXXXXXXXXXXXXXXXXXXXXXXXX--------X-XXXXXXXXXXXXXXXXXXXXXXXXXXXXXXXXXXXXXXXXXXXXXXXXXXXXXXXXXXXXXXXXXXXXXX
XXXXXXXXXXX---|||-||XXXXXXXXXXXXXXXXXXXXXXXXXXXXXXXXXXXXXXXXXXXXXXXXXX--------X-XXXXXXXXXXXXXXXXXXXXXXXXXXXXXXXXXXXXXXXXXXXXXXXXXXXXXXXXXXXXXXXXXXXXXX
