------------------------------------------------------------------------------------------------------------------------------------------------------
------------------------------------------------------------------------------------------------------------------------------------------------------
------------------------------------------------------------------------------------------------------------------------------------------------------
------------------------------------------------------------------------------------------------------------------------------------------------------
------------------------------------------------------------------------------------------------------------------------------------------------------
----------------------------------------------------------------------------------g---------oo--------------------------------------------------------
--------------------S------------------------------------Q-Q--------------------SSSSSSSS----------------------?SSS----------------!S------------------
---------------------------TT-------------------------------------------------------------------------------------------------------------------------
-----------------%%%-------TT-----------------------------------------o----------------------------%--------------------------------------------------
------------------||-------XX-------------------------------------------------------------------------------------------------------------------------
---------Q--------||---TT--------------------------------Q-Q------------------------------S-------------------SSSSS---------------S------#--#---------
-------------%%%%%||---TT-------------tt--------------------------------------#-----------------------TT--------------------------------##--##--------
--------------|||-||---TT-------------tt-------------------------------------##--------------%%%%-----TT----TT-------------------------###--###------#
-M------------|||-||k--TT-------------tt-------y------------gg-------g------------------------||------TT-k--TT--K---------kkk---------####--####----##
XXXXXXXXXXX---|||-||XXXXXXXXXXXXXXXXXXXXXXXXXXXXXXXXXXXXXXXXXXXXXXXXXXXXXXXXXXXXXXXXXX---X----||----XXXXXXXXXXXXXXXXXXXXXXXXXXXXXXXXXXXXXXXXXXXXXXXXXX
XXXXXXXXXXX---|||-||XXXXXXXXXXXXXXXXXXXXXXXXXXXXXXXXXXXXXXXXXXXXXXXXXXXXXXXXXXXXXXXXXX---X----||----XXXXXXXXXXXXXXXXXXXXXXXXXXXXXXXXXXXXXXXXXXXXXXXXXX
