------------------------------------------------------------------------------------------------------------------------------------------------------
------------------------------------------------------------------------------------------------------------------------------------------------------
------------------------------------------------------------------------------------------------------------------------------------------------------
----------------------------------------SSSSSSSSSS------------------------------------------------------------SSSSSSSSSS------------------------------
----------------------------------------SSSSSSSS--?---------------------------------------------------------------------------------------------------
----------------------------------------SSSCSSSS------------------------------------------------------------------------------------------------------
--------------------USS-----------------SSSSSSSS--------------------------SS--------y-----------------------------------------------------------------
--------------------------------------------------SS------------------------------#SSS--------------------------------------------oo------------------
-----------------%%%-------------------------------------------------------------##-------------------------------------------------------------------
------------------||-----------------------ggg------------------1---------------###1-----------oooo---------------------------------------------------
------------------||------------QQQQ----SSSSSSSS----------------------SS-----SS-###-------------------%%%%%%--T----------------------------Q#---------
-------------%%%%%||-B---------------K-BSSSSSSSS-------SSS----------------------###--SSS---------------||||---T-----------------------------##--------
--------------|||-||-b-------B---------bSSSSSSSS--------------------------------###--------------------||||---T----TT-----------------------###------#
-M------------|||-||-B-------b---------bSSSSSSSS--------------------------------###--------------------||||---T--g-TT----k----ggg-----------####----##
XXXXXXXXXXX---|||-||XXXXXXXXXXXXXXXXXXXXXXXXXXXXXX----------XXXXXXXXX-----------XXXXXX---X%%%%%%%-%%%%-||||-%%XXXXXXXXXXXXXXXXXXXXXXXXXXXXXXXXXXXXXXXX
XXXXXXXXXXX---|||-||XXXXXXXXXXXXXXXXXXXXXXXXXXXXXX----------XXXXXXXXX-----------XXXXXX---X||||||---||--||||--|XXXXXXXXXXXXXXXXXXXXXXXXXXXXXXXXXXXXXXXX
