------------------------------------------------------------------------------------------------------------------------------------------------------
------------------------------------------------------------------------------------------------------------------------------------------------------
------------------------------------------------------------------------------------------------------------------------------------------------------
----------SSSSSSSSSS----------------------------------------------------------------------------------------------------------------------------------
------------------------------------------------------------------------------------------------------------------------------------------------------
---------------------------------------------------------------------R--------------------------------------------------------------------------------
-----------------------------U-----------------------------------------------------USS------------------SSQSSS----------------------------------------
------------------------------------------------------------------------------------------------------------------------------------------------------
----------------------------------------------------------------------o-------------------------------------------------------------------------------
-----------------------------------------------------------------------------------------------oooo-------K-------------SS-?Q-------------------------
----------------------------##------------------------S----------%%%--------------#---------------------SSSSSS--------r-------------------------------
-----------------------y-#####--------ttT-----TT--TT--------------|-----------#---#-------------------------------%%%%%%------------------------------
--------------------y-######----------ttT-----TT--TT--------------|----------##---##-------------------------------|||||-------y-------------------F--
---M----------------######------------ttT-----TT--TT------k-------|---------------##--gg---------------------------|||||---SSSSS--k----------------#--
XXXXXXXXXXX--XX--X--XXXX------XXXXXXXXXXXXXX--XXXXXXXXXXXXXX%%%%%-|---XXXXXXXXXX--XXXXXXXX%%%%%%%-%%XXXXXXXXXX-%%%-|||||-------XX-XX---XXXXXXXXXXXXXXX
XXXXXXXXXXX--XX--X--XXXX------XXXXXXXXXXXXXX--XXXXXXXXXXXXXX-|||--|---XXXXXXXXXX--XXXXXXXX||||||---|XXXXXXXXXX--|--|||||-------XX-XX---XXXXXXXXXXXXXXX
