------------------------------------------------------------------------------------------------------------------------------------------------------
------------------------------------------------------------------------------------------------------------------------------------------------------
------------------------------------------------------------------------------------------------------------------------------------------------------
----------------------------------------SSSSSSSSSS------------------------------ooo-------SSSSSSSSSS--------------------------------------------------
--------------------------------------------------?-----------------------------%%%-------------------------------------------------------------------
----------------------ooor-------------------------------------------------------|--------------------------------------------------------------------
---------------------%%%%%---------------oooo---------------------SSoo-----------|----------------------SSQSSS--------------------SS--------SS--------
----------------------|||-------------------------SS-----------------------------|------------------------------oooo----------------------------------
----------------------|||----------------SSSS-U----------------------------------|--------------------------------------------------------------------
----------------------|||---------------oS--SoS----------------------------------|---%%%%-----------------K-------------------------------------------
--------------------%%%%%%%-------------SS--SSS-------------%%%%%%---------------|----||----------------SSSSSST-------------------SS--------SS--------
--------------------||||||------------K----------------SSS---||||---------------%%%%%%||----------------------T-------------------K---#----B------#-TT
--------------------||||||--o-TTTT---------------------------||||----------------||||-||----------------------T-----------------------#----b-----##-TT
-M------------k-ggg-||||||-%%%TTTT--------kk-----------------||||-----gg---------||||-||--------g-g-----------T---y-------kkk---------#----B----###-TT
XXXXXXXXXXXXXXXXXXXX||||||--|-XXXXXXXXXXXXXXXXXXXX-----------||||-----XXXXXXXXXX-||||-||%%XXXXXXXXXXXXXXXXXXXXXXXXXXXXXXXXXXXXXXXXXXXXXXXXXXXXXXXXX-XX
XXXXXXXXXXXXXXXXXXXX||||||--|-XXXXXXXXXXXXXXXXXXXX-----------||||-----XXXXXXXXXX-||||-||-|XXXXXXXXXXXXXXXXXXXXXXXXXXXXXXXXXXXXXXXXXXXXXXXXXXXXXXXXX-XX
