------------------------------------------------------------------------------------------------------------------------------------------------------
------------------------------------------------------------------------------------------------------------------------------------------------------
------------------------------------------------------------------------------------------------------------------------------------------------------
--------------------------------------------------SSSSSSS---------------------------------------------------------------------------------------U-----
------------------------------------------------------------------------------------------------------------------------------------------------------
------------------------------------------------------------------------------------------------------------------------------------------------------
------------------SCUSS-----------------------QQQQQQ--------------------SSSSS--------------SSS!------------------------------------------##-----------
----------------------------------------------------------------------------------------------------------TT--------------------oo-------##-------SS--
-----------------------------------------------------------S----------------------------------------------TT---------------------------####-----------
------------------------------------------------k---------------------------------o-----------------------TT---------------------------####---SS------
--------------TT---2-----------TT-------T-----?QQQQQ--QQQ--------------------2---------TT-----C----------SXXS---------r------TT------######----------#
--------------TT-----B---------TT-------T----------------------------------TT----------TT-------------------------%%%%%%-----TT------######---------##
--------------TT-----b-------B-TT-------T-----------------------------t----TT--T-------TT-----------TT-------------|||||-----TT------######--------###
-M------------TT-----B-------bgTT-------T--------------------y--------t----TT--T-------TT------g-g--TT-------------|||||-y---TT------######-------####
XXXXXXXXXXXXXXXXXXXXXXXXXXXXXXXXXXXXXX--XXXXXXXXXXXXXXXXX---XXXXXXXXXXXXXXXXXXXXXXXXXXXXXXXXXXXXXXXXXXXXXXXXXX-%%%-|||||XXXXXXXXXXXXXXXXXXXXXXXXX-XXXX
XXXXXXXXXXXXXXXXXXXXXXXXXXXXXXXXXXXXXX--XXXXXXXXXXXXXXXXX---XXXXXXXXXXXXXXXXXXXXXXXXXXXXXXXXXXXXXXXXXXXXXXXXXX--|--|||||XXXXXXXXXXXXXXXXXXXXXXXXX-XXXX
