------------------------------------------------------------------------------------------------------------------------------------------------------
------------------------------------------------------------------------------------------------------------------------------------------------------
------------------------------------------------------------------------------------------------------------------------------------------------------
S-----SSSS----------------------------------------------------------------------SSSSSSSSSL------------------------------SSS-----SS--------------------
S-----------------------------------------------------------------------------------------------------------------------------------------------------
S----------------------SSS----------------------------------------------------------------------------------------------------------------------------
S--------------------------------------------------------Q-Q---------------g--------oooooo--------------SSQSSS----------US--------%-------------------
S--------------------g----------o----ooo-------------------------------%%%%%%------------------------------------------------------------------y------
S-------------------%%%-------------------------------------------------||||--------SSSSSS----------------------------------SSS---------SSS--#SS--o---
S-------------------||----SSS-------------------------------------------||||--------SSSSSS----------------K---------------------------------##--------
S------------------%||----------------%%------tt---------Q-Q------------||||---------------------tt-----SSSSSS----------SSS-------%%%%%-----##--SC----
S-------------------||-----------------|------tt------------------------||||--------------T------tt--------------------------------|||------##--------
S-------------------||-----------------|------tt------------------------||||--------------T------tt--------------------------------|||------##---SSS--
S--M---------%%%%---||----oo---%%%%%%%-|-g----tt-------------y----------||||--------------T------tt------------k----kkk------------|||------##--------
XXXXXXXXXXX---||----||---%%%----|||||--|XXXXXXXXXXXXXXXXXXXXXXXXXXXXXX--||||-------XXXXXXXXXXXXXXXXXXXXXXXXXXXXXXXXXXXXXXXX------X%|||------XX------XX
XXXXXXXXXXX---||----||----|-----|||||--|XXXXXXXXXXXXXXXXXXXXXXXXXXXXXX--||||-------XXXXXXXXXXXXXXXXXXXXXXXXXXXXXXXXXXXXXXXX------X-|||------XX------XX
