------------------------------------------------------------------------------------------------------------------------------------------------------
------------------------------------------------------------------------------------------------------------------------------------------------------
------------------------------------------------------------------------------------------------------------------------------------------------------
--------------------------------------------------------------------------------------------------------------SS-------SSSSSSSSSSSSSSSSSSS------------
------------------------------------------------------------------------------------------------------------------------------------------------------
---------------------------------------------------------------------R------------------oo------------------------------------------------------------
--------------------S---------S-------------------Q-----------------------SS----oo-------------------------------------S------------------------------
---------------------------TT---------------------------------------------------------------------oo--------------------------------------------------
---------------------------TT--------------------------------------------------------------------------------------SSS--------------------------------
---------------------------XX----------------------------------------------------SSS------------------------------------------------------------------
-------------------%---TT-----##--SSC-------------Q--------------%%%--SS-----SS----------S-----------------------------S---------------g##----#LSS----
-----------------------TT-----------------------------------------|-----------------------------#-----TT-------##---------SS-----------###----#-------
-----------------------TT-----------------------------------------|-----------------------------#-----TT----TT-##---------SS---------g####----#-------
-M-----------%%%%---k--TT-------------------y-y------gg----k------|-----------------------------#-----TT-k--TT-##---------SS---------#####--kk#-------
XXXXXXXXXXX---||----XXXXXXXXXXXX--XXXXXXXXXXXXXXXXXXXXXXXXXX%%%%%-|-----------------------XXXXXXXXXXXXXXXXXXXX-XX------X--XX--XXXXXXXXXXXX--XXXXXXX---
XXXXXXXXXXX---||----XXXXXXXXXXXX--XXXXXXXXXXXXXXXXXXXXXXXXXX-|||--|-----------------------XXXXXXXXXXXXXXXXXXXX-XX------X--XX--XXXXXXXXXXXX--XXXXXXX---
