------------------------------------------------------------------------------------------------------------------------------------------------------
------------------------------------------------------------------------------------------------------------------------------------------------------
------------------------------------------------------------------------------------------------------------------------------------------------------
----------------------------------------------------------------------SSSSSSSSSS----------------------------------------SSSSSSSSSSSSSSSSSS------------
--------------------------------------------?---------------------------------------------------------------------------------------------------------
---------------------------------------------------------------------R--------------------------------------------------------------------------------
--------------------USS---------------------------Q----------------------------------1------------------SSQSSS----------------------------------------
----------------------------------------------r-------------------------------TT---------------------------------SSS----------------------------------
-----------------%%%----------------------%%%%%%------------------------------TT----------------------------------------------------------------------
------------------||-----------------------||||-------------------------------TT----------------g---------K-------------------------------------------
------------------||-----------TT-------%%-||||oooQ--------------%%%--------SCTT---QQQQ---------TT------SSSSSS-------------------------g##----#LSS----
-------------%%%%%||-B---------TT-------|--||||--r----------------|-----TT----TT----------------TT------------------------SS-----------###----#-------
--------------|||-||-b-------B-TT-------|%%%%%%%%%----------------|-----TT----TT----------------TT------------------------SS---------g####----#-------
-M------------|||-||-B-------bgTT-------|-||||||||---gg----k------|-----TT---kTT----yy----------TT------------------------SS---------#####--kk#-------
XXXXXXXXXXX---|||-||XXXXXXXXXXXXXXXXXX--|-||||||||XXXXXXXXXX%%%%%-|---XXXXXXXXXXXXXXXXXXXXXXXXXXXXX-XXXXXXXXXX%%%%----%%--XX--XXXXXXXXXXXX--XXXXXXX---
XXXXXXXXXXX---|||-||XXXXXXXXXXXXXXXXXX--|-||||||||XXXXXXXXXX-|||--|---XXXXXXXXXXXXXXXXXXXXXXXXXXXXX-XXXXXXXXXX|||------|--XX--XXXXXXXXXXXX--XXXXXXX---
