------------------------------------------------------------------------------------------------------------------------------------------------------
------------------------------------------------------------------------------------------------------------------------------------------------------
------------------------------------------------------------------------------------------------------------------------------------------------------
----------SSSSSSSSSS---oo------------------------------------------SSS--------------------------------------------------------------------------------
------------------------------------------------------------------------------------------------------------------------------------------------------
----------------------------------------------------------------------------------g-------------------------------------------------------------------
----------------------SSSS--------------------QQQQQ-------------CSS-------SSCSS-SSSSSSSS------------------2-----------US-----------SSSS---------------
--------------------------------------------------------------------------------------------------oo--------------------------------------------------
------------------------------------------------------------SS--2-------------------------------------------------------------------------------------
------------------------------------------------k--------------2-2----------------------------------o---------------E---SS-?Q----------SSSS-----------
--------------------------%%%%-TT-------T-----?QQQQ---------------2-----QQQQ--QQ--------------------------2--------TT---------------------------------
---------------------------|||-TT-------T-------------------------------------------------------#------------------TT--t------------------------------
---------------------------|||-TT-------T-------------------------------------------------------#------------------TT--t-------y-------------------F--
-M-------------------------|||gTT-------T------------gg----k------------------------------------#-------y--y----g--TT--t---SSSSS-------------------#--
XXXXXXXXXXX--XX--X--%%%----|||XXXXXXXX--XXXXXXXXXXXXXXXXXXXX---XXXXXXXXXXXXXXXXXXXXXXX---XXXXXXXXXXXXXXXXXXXXXXXXXXXXXXX-------XX----------XXXXXXXXXXX
XXXXXXXXXXX--XX--X--||-----|||XXXXXXXX--XXXXXXXXXXXXXXXXXXXX---XXXXXXXXXXXXXXXXXXXXXXX---XXXXXXXXXXXXXXXXXXXXXXXXXXXXXXX-------XX----------XXXXXXXXXXX
