------------------------------------------------------------------------------------------------------------------------------------------------------
------------------------------------------------------------------------------------------------------------------------------------------------------
------------------------------------------------------------------------------------------------------------------------------------------------------
S-----SSSS----------------------oo--------------------------------------------------------------------------------------------------------------------
S--------------------------------------g--------------------------------------------------------------------------------------------------------------
S----------------------------------%%%%%ooooo---------------------------------------------------------------------------------------------------------
S---------------------!-------------||||---------------------------------------------SSSS---------------------------------SSC------------##--------SSS
S-----------------------------------||||--------SS---------------------------------------------------------------------------------------##-----------
S-----------------------------------||||-SSSS------------------------------------------------------------------------------------------####-----------
S-----------------------------%%%%%-||||-----------------o---------------1------------------------------------------------SSS----------####-----------
S------------------%S@S!S------|||--||||------------------------------T---------Q---------------TT-----------------------------------######-------#---
S------------------------------|||--||||------------------------------T----TT-------------------TT----------g--#---------------------######-------#---
S---------------------------tt-|||--||||----%%%%%---------------------T----TT-------------------TT----------TT-#---------------------######-------#---
S------------%%%%----g------tt-|||--||||-----|||----k--------y--------T---kTT----ggg--------k---TT----------TT-#----ggg----------#---######--ggg--#---
XXXXXXXXXXX---||----XXXXXXXXXX-|||--||||%%---|||---XXXXXXXXXXXXXXXXXXXXXXXXXXXXXXXXXX----XXXXXXXXXXX--XXXXXXXX-XXXXXXXXXX----XXXXXXXXXXXXXXXXXXXXXXXXX
XXXXXXXXXXX---||----XXXXXXXXXX-|||--|||||----|||---XXXXXXXXXXXXXXXXXXXXXXXXXXXXXXXXXX----XXXXXXXXXXX--XXXXXXXX-XXXXXXXXXX----XXXXXXXXXXXXXXXXXXXXXXXXX
