------------------------------------------------------------------------------------------------------------------------------------------------------
------------------------------------------------------------------------------------------------------------------------------------------------------
------------------------------------------------------------------------------------------------------------------------------------------------------
----------SSSSSSSSSS------------------------------------------------------------SSSSSSSSSS------------------------------SSS-----SS--------------------
------------------------------------------------------------------------------------------------------------------------------------------------------
--------------------------------------------------------------------------------------------oo---------------------k----------------------------------
--------------------------------------------------------------------------------------------------------------S---SSSSSSUS----------------------------
-------------------------------------------------------------o---o---o------------------------------oo----------------------------oo-----------y------
---------------------------------------------------------B--%%%-%%%-%%-----------------------------%------------------------SSS--------------#SS--o---
-----------------------------------oo--------------------b---|---|---|-----------------S----------------------------------------------------##--------
-----SSS--------------------------o--o---TT---SU-------SS#CS-|---|---|----------SU--------S------------------T----------SSS----------------Q##--SC----
-----------------------------------------TT------------------|---|---|--------------TT---t-------------------T------------------------------##--------
-----------------------------------------TT----------------K-|---|---|--------------TT---t---%%%%------------TTT----------------------------##---SSS--
-----------------------------------------TT------k-----------|---|-r-|-------------kTT--kt----||----------y--TTT----------------------------##--------
XXXXXXXXXXX--XX--X--XXXXX--XXXXXXXXXXXXXXXXXXXXXXXXXXXXXXXXX%%%%%%%%%%X----XXXXXXXXXXXXXXX----||----XXXXXXXXXXXXXXXXXX--XXX------XXXXXXXXXXXXX------XX
XXXXXXXXXXX--XX--X--XXXXX--XXXXXXXXXXXXXXXXXXXXXXXXXXXXXXXXX-|||||||||X----XXXXXXXXXXXXXXX----||----XXXXXXXXXXXXXXXXXX--XXX------XXXXXXXXXXXXX------XX
