------------------------------------------------------------------------------------------------------------------------------------------------------
------------------------------------------------------------------------------------------------------------------------------------------------------
------------------------------------------------------------------------------------------------------------------------------------------------------
------------------------------------------------------------------------------------------------------------------------------------------------------
------------------------------------------------------------------------------------------------------------------------------------------------------
--------------------------------------ooooooo---------------------------------------------------------------------------------------------------------
----------------------!------------SSSS-----------------------USSS------------------------SSS------%----------------------SSC------SSSS---------------
------------------------------------------------SS--------------------------------------------------------TT------------------------------------------
-----------------------------------------SSSS-------------------------------------TT----------------------TT------------------------------------------
-------------------------------------------------------------------------1--------TT----------------------TT--------------SSS----------SSSS-----------
---------Q---------%S@S!S-----%------------------------ooo---S-----TT-T-----------TT--------%%%----------SXXS---!-----S-------------------------------
-------------------------------------------------------------------TT-T----TT-----TT-----T---|--------------------------------------------------------
----------------------------tt--------------%%%%%------------------TT-T----TT---T-TT-----T---|------TT---------------------------------------------F--
-------------%%%%----g------tt---------------|||-------------ggg---TT-T---kTT---T-TT---k-T---|------TT---------------------------#-----------------#--
XXXXXXXXXXX---||----XXXXXXXXXX--%%%%--%%%%---|||----XXXXXXXXXXXXXXXXXXXXXXXXXXXXXXXXXXXXXX---|------XXXXXXXXXXXXXXXXXXXXX----XXXXX---------XXXXXXXXXXX
XXXXXXXXXXX---||----XXXXXXXXXX---||----||----|||----XXXXXXXXXXXXXXXXXXXXXXXXXXXXXXXXXXXXXX---|------XXXXXXXXXXXXXXXXXXXXX----XXXXX---------XXXXXXXXXXX
