------------------------------------------------------------------------------------------------------------------------------------------------------
------------------------------------------------------------------------------------------------------------------------------------------------------
------------------------------------------------------------------------------------------------------------------------------------------------------
------------------------------SSSSSSSSSS------------------------------------------------------------------------------------------SSSSSSSS------------
------------------------------SSSSSSSSSS--------------------------------------------------------------------------------------------------------------
------------------------------SSSSSSSSSS%%-------------oooo-------------------------------------------------------------------------------------------
------------------------------SSSSSSSSSS|--------------%%%%---------------SS---------SUS----------------------?SSS------SS----------------------------
----------------------------------------|----oo---------||-------------------------------------------------------------------------------------y------
----------------------------------------|---------------||-----------------------------------------------------------------------------------#SS--o---
----------------------------------------|---------SSS---||-------------------------------------oooo------------------------TT---------------##--------
------------------------------SSSSSSSSSS|---------------||-----------TSS-----SS-----#####---------------------SSSSS--------TT----------g##--##--SC----
-----------------K------------SSSSSSSSSS|-------------U-||-----------T--------------#-----------------------g-----------t--TT----------###--##--------
------------B-----------------SSSSSSSSSS|---------------||-----------T-------------K#-----------------------TT----------t--TT--------g####--##---SSS--
-M----------b------------ggg--SSSSSSSSSS|---------------||----ggg----T--------------#-----------------------TT--K-------t--TT--------#####--##--------
XXXXXXXXXXXXXXXXXXXXXXXXXXXXXXXXXXXXXXXX|----%%%%-----%%%%%-XXXXXXXXXX----------XXXXXXX---%%%%%%%-%%--XXXXXXXXXXXXXXXXXXXXXXXXXXXXXXXXXXXX--XX------XX
XXXXXXXXXXXXXXXXXXXXXXXXXXXXXXXXXXXXXXXX|-----||-------|||--XXXXXXXXXX----------XXXXXXX---||||||---|--XXXXXXXXXXXXXXXXXXXXXXXXXXXXXXXXXXXX--XX------XX
