------------------------------------------------------------------------------------------------------------------------------------------------------
------------------------------------------------------------------------------------------------------------------------------------------------------
------------------------------------------------------------------------------------------------------------------------------------------------------
------------------------------------------------------------SSSSSSSSSS--------------------SSSSSSSSSS--------------------------------------------------
------------------------------------------------------------SSSS--SSSS--------------------------------------------------------------------------------
-------------------------------------------------------oooo-SSSS--SSSS--------------------------------------------------------------------------------
-------------------------------------------------------%%%%---SS---S---------------o--o---------------------------------------------------------------
--------------------------------o----ooo----------------||----SS---S--------------------------------oo-----------SSS----------------------------------
--------------------------------------------------------||----SS---S----------------------------------------------------------------------------------
------------Q--?----------------------------------SSS---||--ooSS---SoU-------------SSSS---------------------------------SS-?Q-------------------------
---------Q---------S--------TT--------%%----------------||--SSSS---SSS---------------------------------------T--------------------------------#LSS----
----------------------------TT---------|--------------U-||--------------------------------t------------------T--------------------------------#-------
----------------------------TT---------|----------------||----------------------%%%-------t------------------T-----------------y--------------#-------
------------------K-----ggg-TT-%%%%%%%-|----y-y---------||--k--g-g----gg--------||--------t---------------y--T-------------SSSSS------------kk#-------
XXXXXXXXXXXXXXXXXXXXXXXXXXXXXX--|||||--|XXXXXXXXXX----%%%%%-XXXXXXXXXXXXXXXXXXXX||--------XXXXXXXXXXXXXXXXXXXX%%%%----%%-------XX-XXXXXXXXXXXXXXXXX---
XXXXXXXXXXXXXXXXXXXXXXXXXXXXXX--|||||--|XXXXXXXXXX-----|||--XXXXXXXXXXXXXXXXXXXX||--------XXXXXXXXXXXXXXXXXXXX|||------|-------XX-XXXXXXXXXXXXXXXXX---
