------------------------------------------------------------------------------------------------------------------------------------------------------
------------------------------------------------------------------------------------------------------------------------------------------------------
------------------------------------------------------------------------------------------------------------------------------------------------------
----------SSSSSSSSSS------------------------------------------------------------------------------------------SSSSSSSSSS------------------------------
--------------------------------------------------?---------------------------------------------------------------------------------------------------
----------------------ooor----------------------------------------------------------------------------------------------------------------------------
---------------------%%%%%-----------------------------------------------------------1-----SSS!-----------------------------------!S---------------SSS
----------------------|||-------------------------SS--------------------------------------------------------------------------------------------------
----------------------|||---------------------------------------------o-------------------------------------------------------------------------------
----------------------|||----------oo------------------------------------------------------------------------------------------SSS--------------------
--------------------%%%%%%%-------o--o---------------------------------------------QQQQ-------C-------%%%%%%--T---------%---------S------#--------#---
--------------------||||||--------------T-----TT-------SSS-----------T--------#------------------------||||---T-------------------------##--------#---
--------------------||||||--o-----------T-----TT-------------B-------T-------##------------------------||||---T----TT------------------###--------#---
--------------------||||||-%%%----------T-----TT-------------b-------T--------------yy---------g-g-----||||---T--g-TT------------r----####---ggg--#---
XXXXXXXXXXX--XX--X--||||||--|-XXXXXXXXXXXXXX--XXXX----------XXXXXX--XXXXXXXXXXXXXXXXXXXXXXXXXXXXXXXX%%-||||-%%XXXXXXXXXX----XXXXXXXXXXXXXXXXXXXXXXXXXX
XXXXXXXXXXX--XX--X--||||||--|-XXXXXXXXXXXXXX--XXXX----------XXXXXX--XXXXXXXXXXXXXXXXXXXXXXXXXXXXXXXX|--||||--|XXXXXXXXXX----XXXXXXXXXXXXXXXXXXXXXXXXXX
