------------------------------------------------------------------------------------------------------------------------------------------------------
------------------------------------------------------------------------------------------------------------------------------------------------------
------------------------------------------------------------------------------------------------------------------------------------------------------
---------------------------------------------------oo-------------------------------------------------------------------SSS-----SS--------------------
--------------------------------------------------%%%%------------------------------------------------------------------------------------------------
-----------------------SSS--------------ooooo------||-------------------------------------------------------------------------------------------------
------------------Q--------------------------------||-------------------SSSSS-------y------------------------R--------USUS---------------##-SS--------
---------------------g--------------------------SS-||--SSS------------------------#SSS---------------r-----------------------------------##-----------
--------------------%%%------------------SSSS------||----------------------------##-----------------%%%%%%%-----------------SSS--------####-----------
--------------------||----SSS----------------------||---------------------------###1------------g---||||||----------E------------------####-----------
---------Q--------?-||-----------------------------||----------------#-------2--###-------------TT--||||||---------TT---SSS----------######-SS--------
--------------TT----||-----------------T-----------||---------------##-----TT---###--SSS--------TT--||||||---------TT--t-------------######-------#-TT
--------------TT----||-----------------T----%%%%%-%||-------TT-----###t----TT--T###-------------TT--||||||---------TT--t-------------######------##-TT
--------------TT----||----oo---------kkT-----|||---||-------TT----####t----TT--T###-------------TT--||||||--oo--g--TT--t-------------######-----###-TT
XXXXXXXXXXXXXXXXXXXX||---%%%--XXXXXXXXXX%%---|||---||-------XXXXXXXXXXXXXXXXXXXXXXXXXX---XXXXXXXXXX-||||||--%%XXXXXXXXXXXXX------XXXXXXXXXXXXXXXXXX-XX
XXXXXXXXXXXXXXXXXXXX||----|---XXXXXXXXXX|----|||---||-------XXXXXXXXXXXXXXXXXXXXXXXXXX---XXXXXXXXXX-||||||---|XXXXXXXXXXXXX------XXXXXXXXXXXXXXXXXX-XX
