------------------------------------------------------------------------------------------------------------------------------------------------------
------------------------------------------------------------------------------------------------------------------------------------------------------
------------------------------------------------------------------------------------------------------------------------------------------------------
--------------------------------------------------------------------------------ooo-----------------SSSSSSSSSS--------------------SSSSSSSS------------
--------------------------------------------------------------------------------%%%-------------------------------------------------------------------
----------------------ooor-------------------------------------------------------|----------oo--------------------------------------------------------
------------------SC-%%%%%-------------------------------Q-Q---------------g-----|--------------------------------------SS----------------------------
----------------------|||----------------------------------------------%%%%%%----|--------------------------------------------------------------------
----------------------|||-----------------------------------------------||||-----|-----------------%--------------------------------------------------
----------------------|||----------oo-----------------------------------||||-----|---%%%%----------------------------------TT-------------------------
--------------TT---2%%%%%%%-------o--o-------------------Q-Q---------#--||||-----|----||--SS---------------TT---------r----TT----------g##------------
--------------TT----||||||------------------------------------------##--||||----%%%%%%||----------------#--TT-----%%%%%%t--TT----------###------------
--------------TT----||||||--o-------------------------------TT-----###--||||-----||||-||-----%%%%------##--TT------|||||t--TT--------g####---------F--
--------------TT----||||||-%%%------------------------------TT----####--||||-----||||-||------||----kk-##--TT------|||||t--TT--------#####---------#--
XXXXXXXXXXXXXXXXXXXX||||||--|-XXXXXXXXXXX-XX-XX-XXXXXXXXXXXXXXXXXXXXXX--||||-----||||-||%%----||----XXXXX--XX--%%%-|||||XXXXXXXXXXXXXXXXXX--XXXXXXXXXX
XXXXXXXXXXXXXXXXXXXX||||||--|-XXXXXXXXXXX-XX-XX-XXXXXXXXXXXXXXXXXXXXXX--||||-----||||-||-|----||----XXXXX--XX---|--|||||XXXXXXXXXXXXXXXXXX--XXXXXXXXXX
