------------------------------------------------------------------------------------------------------------------------------------------------------
------------------------------------------------------------------------------------------------------------------------------------------------------
------------------------------------------------------------------------------------------------------------------------------------------------------
--------------------------------------------------------------------------------SSSSSSSSSL----------SSSSSSSSSS------------------------------SSSSSSSSSS
------------------------------------------------------------------------------------------------------------------------------------------------------
------------------------------------------------------------------------------------------------------------------------------------------------------
------------------------------S--------------------------Q-Q--------------SS--------oooooo------------------------------SS--------%-------------------
------------------------------------------------------------------------------------------------------------------------------------------------------
-----------------g---------------------------------------------------o--------------SSSSSS-----------------------------y----------------SSS-----------
-----------------#-----------------------------------------------y------------------SSSSSS--------oo-------------------X---TT-------------------------
--------SUS-----##------------##--SSC--------------------Q-Q-----##---SS-----SS------------------------------T--------XX---TT-----%%%%%-------TT------
---------------###----------------------------------------------###----------------------------TT------TT----T-------XXXt--TT------|||--------TT------
--------------####---------------------------------------------####----------------------------TT------TT----T------XXXXt--TT------|||--------TT------
--M----------#####--------------------------y-y---------------#####-------------------------y--TT---g--TT----T-----XXXXXt--TT------|||--------TT------
XXXXXXXXXXXXXXXXXXXXXXXXX--XXXXX--XXXXXXXXXXXXXXXXXXXXXXXXXXXXXXXXX----------------XXXXXXXXXXXXXXXXXXXXXXXXXXXXXXXXXXXXXXXXXXXXXXX%|||------XXXX--XXXX
XXXXXXXXXXXXXXXXXXXXXXXXX--XXXXX--XXXXXXXXXXXXXXXXXXXXXXXXXXXXXXXXX----------------XXXXXXXXXXXXXXXXXXXXXXXXXXXXXXXXXXXXXXXXXXXXXXX-|||------XXXX--XXXX
