------------------------------------------------------------------------------------------------------------------------------------------------------
------------------------------------------------------------------------------------------------------------------------------------------------------
------------------------------------------------------------------------------------------------------------------------------------------------------
------------------------------------------------------------------------------------------SSSSSSSSSSSSSSSSSSSS----------SSS-----SS--------------------
------------------------------------------------------------------------------------------------------------------------------------------------------
----------------------------------------ooooo-----------------------------------K----------------------------------k----------------------------------
--------------------------------------------------------------------------SSCSS-SS----1-----------------------S---SSSSSSUS----------------------------
------------------------------------------------SS--------------------------------------------------------------------------------oo------------------
-----------------------------------------SSSS------------TT----------o------------------------------------------------------SSS-----------------------
---------------------------------------------------TT----TT------y------------------------------------------------------------------------------------
---------QQ-----------------TT---------------------TT----XX------##-----QQQQ--QQSS---------------------------T----------SSS----------------Q----------
----------------------------TT--------K------------TT-----------###-------------------TT---------------TT----T----------------------------------------
----------------------------TTTTTT----------%%%%%--TT----------####-------------------TT---------------TT----TTT-----------------------------------F--
-------------------#----ggg-TTTTTT-----------|||---TT---------#####-------------------TT--------g-g-g--TT----TTT-----------------------------------#--
XXXXXXXXXXXXX--XXXXXXXXXXXXXXXXXXXXXXXXX%%---|||--XXXXXXXXXXXXXXXXX---XXXXXXXXXXXXXXXXXXXXXXXXXXXXXXXXXXXXXXXXXXXXXXXX--XXX------XXXXXXXXXXXXXXXXXXXXX
XXXXXXXXXXXXX--XXXXXXXXXXXXXXXXXXXXXXXXX|----|||--XXXXXXXXXXXXXXXXX---XXXXXXXXXXXXXXXXXXXXXXXXXXXXXXXXXXXXXXXXXXXXXXXX--XXX------XXXXXXXXXXXXXXXXXXXXX
