------------------------------------------------------------------------------------------------------------------------------------------------------
------------------------------------------------------------------------------------------------------------------------------------------------------
------------------------------------------------------------------------------------------------------------------------------------------------------
------------------------------------------------------------------------------------------------------------------------------------------------U-----
------------------------------------------------------------------------------------------------------------------------------------------------------
------------------------------------------------------------------------------------------------------------------------------------------------------
-----------------------------US-------------------------------------------------------------------------------?SSS--------oo---%%%--------------------
--------------------------------------------------------------------------------------------------------------------------SS----||oo--------------SS--
-----------------g---------------------------------------B------------o-----------TT--------------------------------------------||--------------------
-----------------#---------------------------------------b------------------------TT------------g-------------------------------||------------SS------
----------S-----##----------####--SSC------------------SS#CS---------#------------TT------------TT------------SSSSS----------SS-||---------Q---------#
---------------###-----y-#####--------------------------------------##--------#---TT-----T------TT----------g-------------------||------------------##
--------------####--y-######-------------------------------KTT-----###-------##-T-TT-----T------TT----------TT------------------||-----------------###
---M---------#####--######------------------y-y-------------TT----####----------T-TT---k-T------TT----------TT--K---------------||----------------####
XXXXXXXXXXXXXXXXXXXXXXXX------XX--XXXXXXXXXXXXXXXXXXXXXXXXXXXXXXXXXXXXXXXXXXXXXXXXXXXXXXXXXXXXXXXXX---XXXXXXXXXXXXXXXXXX%%-----%%%XXXXXXXXXXXXXXX-XXXX
XXXXXXXXXXXXXXXXXXXXXXXX------XX--XXXXXXXXXXXXXXXXXXXXXXXXXXXXXXXXXXXXXXXXXXXXXXXXXXXXXXXXXXXXXXXXX---XXXXXXXXXXXXXXXXXX|-------||XXXXXXXXXXXXXXX-XXXX
