------------------------------------------------------------------------------------------------------------------------------------------------------
------------------------------------------------------------------------------------------------------------------------------------------------------
------------------------------------------------------------------------------------------------------------------------------------------------------
------------------------------SSSSSSSSSS---------------------------SSS--------------------------------------------------------------------------------
-----------------------------------------g-------------------------------o----------------------------------------------------------------------------
----------------------------------------%%------------------------------%%%---------------------------------------------------------------------------
--------------------S-------------------|----------------Q-Q----CSS------|--o------o--o---SSS------%---------@----------------------------------------
---------------------------TT-----------|----oo--------------------------|--SSSS----------------------------------------------------------------------
---------------------------TT----------S|-------------------SS--2-----%--|----------------------------------------------------------------------------
---------------------------XX----------S|----------------------2-2-------|---------SSSS---------------------------------------------------------------
-------------------%---TT--------------S|----------------Q-Q------2------|------------------%%%-----SU----!--!----------------------------------------
-----------------------TT------#--------|--------------------------------|-------------------|-----------------#--------------------------------------
-----------------------TT------#-#------|--------------------------------|-----%%%%----------|-----------------#-----------------------------------F--
-M-----------%%%%---k--TT------#-#------|--------------------------------|------||-----------|------------k----#----ggg--k----ggg-k----------------#--
XXXXXXXXXXX---||----XXXXXXXXXXXXXXXXXXXX|----%%%%-XXXXXXXXXX---XXXXXXX%%%%%%----||-----------|------XXXXXXXXXX-XXXXXXXXXXXXXXXXXXXXX---XXXXXXXXXXXXXXX
XXXXXXXXXXX---||----XXXXXXXXXXXXXXXXXXXX|-----||--XXXXXXXXXX---XXXXXXX|||||-----||-----------|------XXXXXXXXXX-XXXXXXXXXXXXXXXXXXXXX---XXXXXXXXXXXXXXX
