------------------------------------------------------------------------------------------------------------------------------------------------------
------------------------------------------------------------------------------------------------------------------------------------------------------
------------------------------------------------------------------------------------------------------------------------------------------------------
----------------------------------------------------------------------------------------------------SSSSSSSSSS----------------------------------------
--------------------------------------------?---------------------------------------------------------------------------------------------------------
-----------------------SSS----------------------------------------------------------------------------------------------------------------------------
--------------------------------------------------------------USSS----------SSSS-----------SSS!-------------------------SS------------------SS--------
---------------------g------------------------r-------------------------------------------------------------------------------------------------------
--------------------%%%-------------------%%%%%%---------TT-----------------------TT------------------------------------------------------------------
------------Q--?----||----SSS--------------||||----TT----TT------------------K----TT---------------------------------------TT-------------------------
-------------------S||------------------%%-||||ooo-TT----XX--S-----TT------SSSSS--TT----------C------------TT--------------TT---------------SS--------
--------------------||------------------|--||||--r-TT--------------TT-T-----------TT-----T--------------#--TT-----------t--TT---------------------#-TT
--------------------||------------------|%%%%%%%%%-TT--------------TT-T---------T-TT-----T-------------##--TT-----------t--TT--------------------##-TT
-M----------------K-||----oo------k-k---|-||||||||-TT--------ggg---TT-T---------T-TT---k-T-----g-g--kk-##--TT--k----kkk-t--TT-----k-------------###-TT
XXXXXXXXXXXXXXXXXXXX||---%%%--XXXXXXXXX-|-||||||||XXXXXXXXXXXXXXXXXXXXXXXXXXXXXXXXXXXXXXXXXXXXXXXXXXXXXXX--XX-XXXXXXXXXXXXXXXXXXXXXX---XXXXXXXXXXXX-XX
XXXXXXXXXXXXXXXXXXXX||----|---XXXXXXXXX-|-||||||||XXXXXXXXXXXXXXXXXXXXXXXXXXXXXXXXXXXXXXXXXXXXXXXXXXXXXXX--XX-XXXXXXXXXXXXXXXXXXXXXX---XXXXXXXXXXXX-XX
