------------------------------------------------------------------------------------------------------------------------------------------------------
------------------------------------------------------------------------------------------------------------------------------------------------------
------------------------------------------------------------------------------------------------------------------------------------------------------
------------------------------SSSSSSSSSS--------------------------------------------------------------------------------------------------------------
------------------------------SSSSSSSSSS-------------------------------------------------------------------------------------------------------------o
------------------------------SSSSSSSSSS--------------------------------------------------------------------------------------------------------------
------------------------------SSSSSSSSSS------QQQQ-----------------------------------1----------------------------------------------------------------
----------------------------------------------------------------------------------------------------------------oooo----------------------------SSS---
---------------------------------------------------------------------o---------------------------------------------------------------g#-----oo--------
------------------------------------------------k----------------y-------------------------o----------------------------------------g##---------------
----------------%%%%--------TTSSSSSSSSSST-----?QQQ-------tt------##----------------QQQQ----------TT---%%%%%%--T---------------------###-----SS--------
-----------------||---------TTSSSSSSSSSST----------------tt-----###------------------------------TT----||||---T--------------------####---------------
-----------------||---------TTSSSSSSSSSST----------------tt----####------------------------------TT----||||---T-------------------#####---------------
-M---------------||-----ggg-TTSSSSSSSSSST------------g-g-tt---#####---gg------------yy-----------TT----||||---T---y------k----ggg-#####---------------
XXXXXXXXXXX--%%%%||%XXXXXXXXXXXXXXXXXXXXXXXXXXXXXXXXXXXXXXXXXXXXXXX---XXXXXXXXXXXXXXXXXXXXXXXXXXXXXX%%-||||-%%XXXXXXXXXXXXXXXXXXXXXXXXX--XXX----------
XXXXXXXXXXX---||-||-XXXXXXXXXXXXXXXXXXXXXXXXXXXXXXXXXXXXXXXXXXXXXXX---XXXXXXXXXXXXXXXXXXXXXXXXXXXXXX|--||||--|XXXXXXXXXXXXXXXXXXXXXXXXX--XXX----------
