------------------------------------------------------------------------------------------------------------------------------------------------------
------------------------------------------------------------------------------------------------------------------------------------------------------
------------------------------------------------------------------------------------------------------------------------------------------------------
--------------------SSSSSSSSSSSSSSSSSSSS--------------------------------------------------------------------------------------------------------------
--------------------SSSSSSSSSSSSSSSSSSSS--------------------------------------------------------------------------------------------------------------
--------------------SSSSSSSSSSSSSSSSSSSS--------------------------------------------------------------------------------------------------------------
--------------------SSSSSSSSSSSSSSSSSSSS-----------------Q-Q---------------g-------USS-----SSS!--------------------oo----SSS----S!-----------QQQQ-----
-----------------------------------------------------------------------%%%%%%-------------------------------------------------------------------------
------------------------------------------------------------------------||||--------------------------------------------------------------------------
------------------------------------------------------------------------||||-------------------------------------------------------------------y------
----------------------SSSSSS?-SSSSSSSSSS-----------------Q-Q------------||||------#-----------C----------------%%%%--%%%---------S----------Q?SSQQQ---
----------------------SSSSS---SSSSSSSSSS--------------------------------||||------#-------------------------g---||----||-------------TT---------------
----------------------SSSSS---SSSSSSSSSS--------------------------------||||------##------------------------TT--||----||-------------TT---------------
-M--------k---ggg----------oooSSSSSSSSSS-------y-------------y----------||||------##--gg-------g-g----------TTo-||----||----gg-g-g---TT---------------
XXXXXXXXXXXXXXXXXXXX-XXXXXXXXXXXXXXXXXXXXXXXXXXXXXXXXXXXXXXXXXXXXXXXXX--||||------XXXXXXXXXXXXXXXXXX--XXXXXXXX%-||----||XXXXXXXXXXXXXXXXXXXXXX--XXXXXX
XXXXXXXXXXXXXXXXXXXX-XXXXXXXXXXXXXXXXXXXXXXXXXXXXXXXXXXXXXXXXXXXXXXXXX--||||------XXXXXXXXXXXXXXXXXX--XXXXXXXX--||----||XXXXXXXXXXXXXXXXXXXXXX--XXXXXX
