------------------------------------------------------------------------------------------------------------------------------------------------------
------------------------------------------------------------------------------------------------------------------------------------------------------
------------------------------------------------------------------------------------------------------------------------------------------------------
----------------------------------------------------------------------SSSSSSSSSS------------------------------------------------------------SSSSSSSSSS
----------------------------------------------------------------------------SSSS----------------------------------------------------------------------
----------------------ooor-----------------------------------------------g--SSSS--------oo------------------------------------------------------------
---------------------%%%%%----------------------------------------------SS------oo---------------------------------oo---SS--------!S------------------
----------------------|||-------o----ooo--------------------------------SS--------------------------oo------------------------------------------------
----------------------|||--------------------------------------------o--SS----------------------------------------------------------------------------
----------------------|||----------------------------------------y------SC--g-g--SS----------------------------------------TT-------------------------
----------Q---------%%%%%%%-----------%%--------------S----------##-----SS--SSSS---------S-------------------T-%%%%--%%%---TT-----S------#----TT------
--------------------||||||-------------|----------TT------------###------------------------------------------T--||----||t--TT-----------##----TT------
--------------------||||||--o----------|----------TT-----------####------------------------------------------T--||----||t--TT----------###----TT------
-M-----------------#||||||-%%%-%%%%%%%-|-------y--TT------k---#####--------------------------------g------y--To-||----||t--TT---------####----TT------
XXXXXXXXXXXXX--XXXXX||||||--|---|||||--|XXXXXXXXXXXXXXXXXXXXXXXXXXX---XXXXXXXXXX-----------XXXXXXXXXXXXXXXXXXX%-||----||XXXXXXXXXXXXXXXXXXXXXXXX--XXXX
XXXXXXXXXXXXX--XXXXX||||||--|---|||||--|XXXXXXXXXXXXXXXXXXXXXXXXXXX---XXXXXXXXXX-----------XXXXXXXXXXXXXXXXXXX--||----||XXXXXXXXXXXXXXXXXXXXXXXX--XXXX
