------------------------------------------------------------------------------------------------------------------------------------------------------
------------------------------------------------------------------------------------------------------------------------------------------------------
------------------------------------------------------------------------------------------------------------------------------------------------------
------------------------------------------------------------------------------------------------------------------------------------------------------
------------------------------------------------------------------------------------------------------------------------------------------------------
------------------------------------------------------------------------------------------------------oo----------------------------------------------
-------------------------------------------------------------------------------------SSSS-------------------------------SS----------------------------
------------------------------------------------------------------------------------------------------------------------------------------------------
---------------------------------------------------------------------oo-------------------------------------------------------------------------------
-----------------------------------------------------------------y--------------------------------oo-----------------------TT-------------------------
--------------------SS---------TT------------------------tt------##-------------Q------------------------------------------TT-------------------------
---------------------K---TT----TT------------------------tt-----###-----------#----------------TT--------------#--------t--TT-------------------------
-------------------------TT----TT------------------------tt----####----------##----------------TT-----------tt-#--------t--TT----------------------F--
-M--------k---ggg--------TT---gTT--------------------g-g-tt---#####--------------ggg--------y--TT-----ggg---tt-#----ggg-t--TT-----k----------------#--
XXXXXXXXXXXXXXXXXXXXXXXXXXXXXXXXXXXXXX--X-XX-XX-XXXXXXXXXXXXXXXXXXX---XXXXXXXXXXXXXXX----XXXXXXXXXXXXXXXXXXXXX-XXXXXXXXXXXXXXXXXXXXX---XXXXXXXXXXXXXXX
XXXXXXXXXXXXXXXXXXXXXXXXXXXXXXXXXXXXXX--X-XX-XX-XXXXXXXXXXXXXXXXXXX---XXXXXXXXXXXXXXX----XXXXXXXXXXXXXXXXXXXXX-XXXXXXXXXXXXXXXXXXXXX---XXXXXXXXXXXXXXX
