------------------------------------------------------------------------------------------------------------------------------------------------------
------------------------------------------------------------------------------------------------------------------------------------------------------
------------------------------------------------------------------------------------------------------------------------------------------------------
------------------------------------------------------------------------------------------------------------------------------------------------------
------------------------------------------------------------------------------------------------------------------------------------------------------
----------------------ooor--------------------------------------------------------------oo------------------------------------------------------------
---------------------%%%%%------------------------------------------------------oo----------------------SSQSSS--------US-------SSS--------------------
----------------------|||-----------------------------------------------------------------------------------------------------------------------------
----------------------|||---------------------------------------------o--------------------------------------------------------------g#---------------
----------------------|||--------------------------------o-----------------------SS-----------------------K---------E-----------K---g##---------------
-------------------%%%%%%%%--------------TT---SU-----------------------------------------S------TT------SSSSSS-----TT----------SSS--###---------------
--------------------||||||------------tt-TT-----------------------------------#-----------------TT-----------------TT--t-----------####---------------
--------------------||||||--o---------tt-TT----------------------------------##-----------------TT-----------------TT--t-TT-------#####------------F--
-M-----------%%%%---||||||-%%%--------tt-TT------k--k-------gg-------g----------------------k---TT--------------g--TT--t-TT-------#####------------#--
XXXXXXXXXXX---||----||||||--|-XXXXXXXXXXXXXXXXXXXX-XXXXXXXXXXXXXXXXXXXXXXXXXXXXX----------XXXXXXXXXXXXXXXXXXXXXXXXXXXXXXXXXXXXXXXXXXXXX--XXXXXXXXXXXXX
XXXXXXXXXXX---||----||||||--|-XXXXXXXXXXXXXXXXXXXX-XXXXXXXXXXXXXXXXXXXXXXXXXXXXX----------XXXXXXXXXXXXXXXXXXXXXXXXXXXXXXXXXXXXXXXXXXXXX--XXXXXXXXXXXXX
