------------------------------------------------------------------------------------------------------------------------------------------------------
------------------------------------------------------------------------------------------------------------------------------------------------------
------------------------------------------------------------------------------------------------------------------------------------------------------
--------------------SSSSSSSSSSSSSSSSSSSS--------------------------------------------------SSSSSSSSSS--------------------------------------------------
------------------------------SSSSSSSSSS-------------------------------------------------------------------------------------------------------------o
------------------------------SSSSSSSSSS---------------oooo----------R--------------------------------------------------------------------------------
------------------------------SSSSSSSSSS---------------%%%%----------------1-------o--o----------------------R-----------------SSS--------------------
--------------------------------------------------SSSS--||-------------------------------------------r------------------------------------------SSS---
--------------------------------------------------------||------------------------------------------%%%%%%%--------------------------g#-----oo--------
-----------------------------C--------------------------||-----------------ggg-----SSSS-------------||||||----------------------K---g##---------------
-----------------------#-#----SSSSSSSSSS-TT---SU--------||-------%%%--#########---------------------||||||------------r--------SSS--###-----SS--------
---------------------#-#-#-#--SSSSSSSSSS-TT-----------U-||--------|-----------#-----------t---------||||||--------%%%%%%-----------####---------------
---------------------#-#-#-#--SSSSSSSSSS-TT-------------||--------|-----------#-%%%-------t---------||||||---------|||||-TT-------#####---------------
-M--------k---ggg----#-#-#-#-ESSSSSSSSSS-TT------k------||--------|-----------#-||--------t---------||||||--oo-----|||||-TT-------#####---------------
XXXXXXXXXXXXXXXXXXXXXXXXXXXXXXXXXXXXXXXXXXXXXXXXXX----%%%%%-%%%%%-|-----------X-||--------XXXXXXXXXX||||||--%%-%%%-|||||XXXXXXXXXXXXXXX--XXX----------
XXXXXXXXXXXXXXXXXXXXXXXXXXXXXXXXXXXXXXXXXXXXXXXXXX-----|||---|||--|-----------X-||--------XXXXXXXXXX||||||---|--|--|||||XXXXXXXXXXXXXXX--XXX----------
