------------------------------------------------------------------------------------------------------------------------------------------------------
------------------------------------------------------------------------------------------------------------------------------------------------------
------------------------------------------------------------------------------------------------------------------------------------------------------
S-----SSSS---------------------------------------------------------SSS----------SSSSSSSSSL------------------------------SSS-----SSSSSSSSSSSSSSSSSSSSSS
S-----------------------------------------------------------------------------------------------------------------------------------------------------
S-----------------------------------------------------------------------------------------------------------------------------------------------------
S---------------------------------------------QQQQ--------------CSS-----------------oooooo-------------------R----------US----------------------------
S----------------------------------------------------------------------------------------------------r------------------------------------------------
S-----------------------------------------------------------SS--2--------------g----SSSSSS----------%%%%%%%-----------------SSS-----------------------
S-----------------------------------------------k--------------2-2------------------SSSSSS----------||||||--------------------------------------------
S---------------%%%%SS----------QQQQ----T-----?QQQ-----ooo--------2----------S@S--------------------||||||--------------SSS-------------------TT------
S----------------||--K---TT----------K-BT-----------------------------------------------------------||||||-----#--------------------------TT--TT------
S----------------||------TT------------bT-----------------------------------------------------------||||||-----#-------------------tt-----TT--TT------
S----------------||------TT------------bT----------------------------------------------------------g||||||--oo-#----ggg------------tt----kTT--TT------
XXXXXXXXXXX--%%%%||%XXXXXXXXXXXXXXXXXXXXXXXXXXXXXX--XXXXXXXX---XXXXXXX-XXXXXXXXX---XXXXXXX-XXXXXXXXX||||||--%%-XXXXXXXXXXXX------XXXXXXXXXXXXXXX--XXXX
XXXXXXXXXXX---||-||-XXXXXXXXXXXXXXXXXXXXXXXXXXXXXX--XXXXXXXX---XXXXXXX-XXXXXXXXX---XXXXXXX-XXXXXXXXX||||||---|-XXXXXXXXXXXX------XXXXXXXXXXXXXXX--XXXX
