------------------------------------------------------------------------------------------------------------------------------------------------------
------------------------------------------------------------------------------------------------------------------------------------------------------
------------------------------------------------------------------------------------------------------------------------------------------------------
------------------------------SSSSSSSSSS----------SSSSSSS-------------------------------------------------------------------------SSSSSSSSSS----------
-------------------------------------------------------------------------o----------------------------------------------------------------------------
----------------------------------------ooooo---------------------------%%%-----------------oo--------------------------------------------------k-----
--------------------USS---------------------------QQ---------------------|--o------USS------------------------?SSS-----------------------------SQS--SQ
------------------------------------------------SS-----------o---o---o---|--SSSS--------------------oo------------------------------------------------
---------------------------------------S-SSSS--------------S%%%-%%%-%%%--|-------------------------%--------------------------SSS---------------------
---------------------------------------S---------------------|---|---|---|----------------------------------------------------------------------------
----------Q----------------------------S----------QQ--QQQ----|---|---|---|--------#-------SS-----------------TSSSSS-----%----------------------SQS--S?
---------------------B---------#-----------------------------|---|---|---|--------#--------------------------T----------------------------TT----------
---------------------b-------B-#-#----------%%%%%------------|---|---|---|-----%--##---------%%%%------------T---------------------tt-----TT----------
-------------------#-B-------b-#-#-----------|||-------------|---|-r-|---|--------##--gg------||----------y--T--K----------------r-tt----kTT-k------gg
XXXXXXXXXXXXX--XXXXXXXXXXXXXXXXXXXXXXXXX%%---|||--XXXXXXX---%%%%%%%%%%%%%%%%------XXXXXXXX----||----XXXXXXXXXXXXXXXXXXXX----XXXXXXXXXXXXXXXXXXXXXXXXXX
XXXXXXXXXXXXX--XXXXXXXXXXXXXXXXXXXXXXXXX|----|||--XXXXXXX----||||||||||||||-------XXXXXXXX----||----XXXXXXXXXXXXXXXXXXXX----XXXXXXXXXXXXXXXXXXXXXXXXXX
