------------------------------------------------------------------------------------------------------------------------------------------------------
------------------------------------------------------------------------------------------------------------------------------------------------------
------------------------------------------------------------------------------------------------------------------------------------------------------
------------------------------SSSSSSSSSS------------------------------------------------------------SSSSSSSSSS----------------------------------U-----
--------------------------------------------------?---------------------------------------------------------------------------------------------------
----------------------------------------ooooo-----------------------------------------------oo--------------------------------------------------------
----------------------!----------------------------------------------------g---------SUS------------------------------------------%-------------------
------------------------------------------------SSSS-------------------%%%%%%---------------------------------------------------------------------SS--
---------------------------------------S-SSSS---------------------------||||-----------------------%------------------------------------SSS-----------
---------------------------------------S--------------------------------||||---------------------------------------------------SSS------------SS------
---------Q------%%%%S@S!S--------------S--------------------------------||||--------#####-SS-----------------T----------%---------%%%%%--------------#
-----------------||------------#-----------------------SSS--------------||||--------#------------------TT----T-#-------------------|||--------------##
-----------------||---------tt-#-#----------%%%%%-----------------------||||-------K#--------%%%%------TT----T-#-------------------|||-------------###
-M---------------||--g------tt-#-#-----------|||------------gg-------g--||||--------#---------||----g--TT----T-#----ggg----------r-|||------------####
XXXXXXXXXXX--%%%%||%XXXXXXXXXXXXXXXXXXXX%%---|||------------XXXXXXXXXX--||||----XXXXXXX-------||----XXXXXXXXXX-XXXXXXXXX----XXXXXX%|||------XXXXX-XXXX
XXXXXXXXXXX---||-||-XXXXXXXXXXXXXXXXXXXX|----|||------------XXXXXXXXXX--||||----XXXXXXX-------||----XXXXXXXXXX-XXXXXXXXX----XXXXXX-|||------XXXXX-XXXX
