------------------------------------------------------------------------------------------------------------------------------------------------------
------------------------------------------------------------------------------------------------------------------------------------------------------
------------------------------------------------------------------------------------------------------------------------------------------------------
--------------------SSSSSSSSSS-------------------------------------SSS----------------------------------------SSSSSSSSSS------------------------U-----
--------------------SSSSSSSSSS-----------g------------------------------------------------------------------------------------------------------------
--------------------SSSSSSSSSS----------%%----------------------------------------------oo----------oo------------------------------------------------
--------------------SSSSSSSSSS----------|-----------------------CSS-------SSCSS-oo------------------%%%-----------------SSS-------!S------------------
----------------------------------------|----oo-----------------------------------------------------||--o----R------------------------------------SS--
----------------------------------------|-------------------SS--2-----------------------------------||-%%%--------------------------------------------
----------------------------------------|----------------------2-2---------------SSS----------------||--|-------------------------------------SS------
----------Q-----------SSSSSS?---QQQQ----|--------------ooo--------2-----QQQQ--QQ---------S----------||--|-----T-------------------S------#-----------#
----------------------SSSSS----------K-B|-----------------------------------------------------------||-o|-----T-------------------------##----------##
----------------------SSSSS------------b|-----------------------------------------------------------||%%%%%---T----TT---------TT-------###---------###
-M-----------------#-------ooo---------b|----------------------------------------------------------g||-|||----T--g-TT---------TT------####--------####
XXXXXXXXXXXXX--XXXXX-XXXXXXXXXXXXXXXXXXX|----%%%%---XXXXXXXX---XXXXXXXXXXXXXXXXX-----------XXXXXXXXX||-|||----XXXXXXXXXX----XXXXXXXXXXXXXXXXXXXXX-XXXX
XXXXXXXXXXXXX--XXXXX-XXXXXXXXXXXXXXXXXXX|-----||----XXXXXXXX---XXXXXXXXXXXXXXXXX-----------XXXXXXXXX||-|||----XXXXXXXXXX----XXXXXXXXXXXXXXXXXXXXX-XXXX
