------------------------------------------------------------------------------------------------------------------------------------------------------
------------------------------------------------------------------------------------------------------------------------------------------------------
------------------------------------------------------------------------------------------------------------------------------------------------------
S-----SSSS------------------------------------------------------------SSSSSSSSSS----------------------------------------------------------------------
S-------------------------------------------------?--------------------------------------------------------------------------------------------------o
S---------------------ooor--------------%%------------------------------------------------------------------------------------------------------------
S--------------------%%%%%--------------|--------------------------------------------SSSS--------------------R-----oo--------------SSSS---------------
S---------------------|||---------------|----oo---SS---------o---o---o--------TT------------------oo-----r--------------------------------------SSS---
S----------------g----|||---------------|-------------------%%%-%%%-%%--------TT--------------------%%%%%%%------------------SSS------------oo--------
S----------------#----|||---------------|--------------------|---|---|--------TT--------------------||||||-----------------------------SSSS-----------
S---------S-----##--%%%%%%%-------------|--------------------|---|---|------SCTTQ-------------------||||||-----%%%%--%%%r-------------------SS--------
S--------------###--||||||------------tt|--------------SSS---|---|---|--TT----TT----------------#---||||||------||----||%%%%%%------------------------
S-------------####--||||||--o---------tt|--------------------|---|---|--TT----TT----------------#---||||||------||----|||||||-------------------------
S------------#####--||||||-%%%--------tt|--------------------|---|-r-|--TT---kTT-ggg------------#---||||||--ooo-||----|||||||-------------------------
XXXXXXXXXXXXXXXXXXXX||||||--|-XXXXXXXXXX|----%%%%-----------%%%%%%%%%%XXXXXXXXXXXXXXX----XXXXXXXXXXX||||||--%%%-||----|||||||--------------X----------
XXXXXXXXXXXXXXXXXXXX||||||--|-XXXXXXXXXX|-----||-------------|||||||||XXXXXXXXXXXXXXX----XXXXXXXXXXX||||||---|--||----|||||||--------------X----------
