------------------------------------------------------------------------------------------------------------------------------------------------------
------------------------------------------------------------------------------------------------------------------------------------------------------
------------------------------------------------------------------------------------------------------------------------------------------------------
S-----SSSSSSSSSSSSSS--------------------SSSSSSSSSS----------------------------------------------------------------------SSSSSSSSSS--------------------
S-----------------------------------------------------------------------------------------------------------------------------------------------------
S-----------------------------------------------------------------------------------------------------oo----------------------------------------------
S-------------------S--------------------oooo-----Q------------------------1--------y----------------------------------------------------##-----------
S--------------------------TT-----------------------------------------------------#SSS---------------------------SSS---------------------##-----------
S--------------------------TT------------SSSS-U----------------------------------##----------------------------------------------------####-----------
S--------------------------XX-----------oS--SoS-----------------1----------ggg--###1-----------oooo------------------------------------####-----------
S---------@QQQQ--------TT---------------SS--SSS---Q-------------------#########-###--------------------------------------------------######-----------
S----------------------TT-------------tt--------------------------------------#-###--SSS----------------------------------SS---------######-----------
S----------------g-#---TT-------------tt--------------------------------------#-###-------------------------tt------------SS---------######--------F--
S--M------------g#-#k--TT-------------tt--kk---------gg----k------------------#-###-------------------ggg---tt------------SS---------######--------#--
XXXXXXXXXXXXXXXXXXXXXXXXXXXXXXXXXXXXXXXXXXXXXXXXXXXXXXXXXXXXXXXXXXXXX---------X-XXXXXX---X%%%%%%%-%%XXXXXXXXXX%%%%----%%--XX--XXXXXXXXXXXXXXXXXXXXXXXX
XXXXXXXXXXXXXXXXXXXXXXXXXXXXXXXXXXXXXXXXXXXXXXXXXXXXXXXXXXXXXXXXXXXXX---------X-XXXXXX---X||||||---|XXXXXXXXXX|||------|--XX--XXXXXXXXXXXXXXXXXXXXXXXX
