------------------------------------------------------------------------------------------------------------------------------------------------------
------------------------------------------------------------------------------------------------------------------------------------------------------
------------------------------------------------------------------------------------------------------------------------------------------------------
------------------------------------------------------------------------------------------------------------------------------------------------------
------------------------------------------------------------------------------------------------------------------------------------------------------
---------------------------------------------------------------------R--------------------------------oo-----------k----------------------------------
---------------------LSSS-------------------------------------------------------------------------------------S---SSSSSS-------SSS-----US---SSS-------
------------------------------------------------------------------------------------------------------------------------------------------------------
---------------------------------------------------------B------------o-------------------------------------------------------------------------------
---------------------------------------------------------b------------------------o---------------------------------------------K----SS----------SSSSS
---------Q-----------2-----#---------------------------SS#CS-----%%%-------------------TT--------tt----------------------------SSS---------S----------
---------------------------#----------K---------------------------|-----------#--------TT-T------tt---------------------------------------------------
---------------------------##-TTTT-------------------------K------|----------##--------TT-T------tt---------ttTT---------TT-------TT--------SSS-------
----------k---ggg-----kk---##-TTTT----------y-y-------------------|--------------------TT-T------tt---ggg---ttTT---------TT-------TT---------------r--
XXXXXXXXXXXXXXXXXXXXXXXXXXXXXXXXXXXXXXXXXXXXXXXXXXXXXXXXXXXX%%%%%-|---XXXXXXXXXXXXXXXXXXXXXXXXXXXXXXXXXXXXXXXXXXXXXXXX--XXXXXXXXXXXXXXXX-X-X-----XXXXX
XXXXXXXXXXXXXXXXXXXXXXXXXXXXXXXXXXXXXXXXXXXXXXXXXXXXXXXXXXXX-|||--|---XXXXXXXXXXXXXXXXXXXXXXXXXXXXXXXXXXXXXXXXXXXXXXXX--XXXXXXXXXXXXXXXX-X-X-----XXXXX
