------------------------------------------------------------------------------------------------------------------------------------------------------
------------------------------------------------------------------------------------------------------------------------------------------------------
------------------------------------------------------------------------------------------------------------------------------------------------------
-----------------------oo-----------------------------------------------------------------------------------------------------------------------------
-----------------------------------------------------------------------------------------------------------------------------------------------------o
---------------------------------------------------------------------R----------K---------------------------------------------------------------------
----------------------SSSS------------------------------------------------SSCSS-SS----1---------------------------------------------------------------
----------------------------------------------------------------------------------------------------oo------------------------------------------SSS---
---------------------------------------------------------TT--------------------------------------------------------------------------g#-----oo--------
---------------------------------------------------TT----TT--------------------------------o-----------------------------------SSS--g##---------------
-----SSS--------!---------%%%%----------------tt---TT----XX------%%%----QQQQ--QQSS---------------TT----------T--!-----S-%-----------###-----SS--------
---------------------------|||--------tt------tt---TT-------------|-------------------TT---------TT----------T---------------------####---------------
---------------------------|||--------tt------tt---TT-------------|-------------------TT---------TT----------T--------------------#####---------------
---------------------------|||--------tt-g----tt---TT-------------|-------------------TT---------TT-------y--T-------------------r#####---------------
XXXXXXXXXXXXXXXXXXXX%%%----|||XXXXXXXXXXXXXXXXXXXXXXXXXXXXXX%%%%%-|---XXXXXXXXXXXXXXXXXXXXXXXXXXXXXXXXXXXXXXXXXXXXXXXXXX----XXXXXXXXXXX--XXX----------
XXXXXXXXXXXXXXXXXXXX||-----|||XXXXXXXXXXXXXXXXXXXXXXXXXXXXXX-|||--|---XXXXXXXXXXXXXXXXXXXXXXXXXXXXXXXXXXXXXXXXXXXXXXXXXX----XXXXXXXXXXX--XXX----------
