------------------------------------------------------------------------------------------------------------------------------------------------------
------------------------------------------------------------------------------------------------------------------------------------------------------
------------------------------------------------------------------------------------------------------------------------------------------------------
S-----SSSSSSSSSSSSSSSSSSSSSSSS----------------------------------------SSSSSSSSSS----------------------------------------------------------------------
S-------------------------------------------?---------------------------------------------------------------------------------------------------------
S------------------------------------------------------oooo----------R--------------------------------------------------------------------------------
S------------------------------------------------------%%%%-----------------------------------------------------------------------!S---------------SSS
S---------------------------------------------r---------||--------------------TT--------------------oo--------------------------oo--------------------
S-----------------------------------------%%%%%%--------||--------------------TT--TT-----------------------------------y------------------------------
S----------------------------C-----oo------||||---SSS---||--------------------TT--TT--------------oo-------------------X------------------------------
S----------------------#-#--------o--o--%%-||||ooo------||-------%%%--------SCTT--TT-------------------------T--------XX-----TT---S------#--------#---
S--------------------#-#-#-#------------|--||||--r----U-||--------|-----TT----TT--TT-----T-----TT------------T-------XXX-----TT---------##--------#---
S--------------------#-#-#-#------------|%%%%%%%%%------||--------|-----TT----TTT-TT-----T-----TT------------T------XXXX-----TT--------###--------#---
S--M-----------------#-#-#-#-E----------|-||||||||------||--------|-----TT---kTTT-TT---k-T--y--TT---------y--T-----XXXXX-y---TT-------####---ggg--#---
XXXXXXXXXXX--XX--X--XXXXXXXXXXXXXXXXXXXX|-||||||||----%%%%%-%%%%%-|---XXXXXXXXXXXXXXXXXXXXXXXXXXXXXXXXXXXXXXXXXXXXXXXXXXXXXXXXXXXXXXXXXXXXXXXXXXXXXXXX
XXXXXXXXXXX--XX--X--XXXXXXXXXXXXXXXXXXXX|-||||||||-----|||---|||--|---XXXXXXXXXXXXXXXXXXXXXXXXXXXXXXXXXXXXXXXXXXXXXXXXXXXXXXXXXXXXXXXXXXXXXXXXXXXXXXXX
