------------------------------------------------------------------------------------------------------------------------------------------------------
------------------------------------------------------------------------------------------------------------------------------------------------------
------------------------------------------------------------------------------------------------------------------------------------------------------
--------------------------------oo----------------SSSSSSSSSS--------------------------------------------------SS-------S------------------------------
---------------------------------------g--------------SS--SS------------------------------------------------------------------------------------------
-----------------------------------%%%%%--------------SS--SS----------------------------oo------------------------------------------------------------
------------------------------------||||------------SS------------------SSSSS---oo---------SSS!--------------R---------S---------------US-------------
------------------------------------||||------------SS---------------------------------------------------r----------------------oo--------------------
------------------------------------||||------------SS----------------------------------------------%%%%%%%--------SSS--------------------------------
------------------------------%%%%%-||||------------SS----oo---------------------SS-----------------||||||---------------------------SS---------------
---------Q---------%-----------|||--||||------------SSSS--SS---------#-------2-----------S----C-----||||||-------------S-----TT------------S----------
-------------------------------|||--||||--------------SS------------##-----TT-----------------------||||||-----##------------TT--------------------#--
-------------------------------|||--||||--------------SS----TT-----###t----TT--T--------------------||||||-----##------------TT---TT-----------K---#--
-------------%%%%--------ggg---|||--||||-------ggg----------TT----####t----TT--T---------------g-g--||||||--oo-##--------y---TT---TT---------------#--
XXXXXXXXXXX---||----XXXXXXXXXX-|||--||||-XXXXXXXXXXXXXXXXXXXXXXXXXXXXXXXXXXXXXXX----------XXXXXXXXXX||||||--%%-XX------XXXXXXXXXXXXXXXXX-X-XXXXXX--XXX
XXXXXXXXXXX---||----XXXXXXXXXX-|||--||||-XXXXXXXXXXXXXXXXXXXXXXXXXXXXXXXXXXXXXXX----------XXXXXXXXXX||||||---|-XX------XXXXXXXXXXXXXXXXX-X-XXXXXX--XXX
