------------------------------------------------------------------------------------------------------------------------------------------------------
------------------------------------------------------------------------------------------------------------------------------------------------------
------------------------------------------------------------------------------------------------------------------------------------------------------
------------------------------------------------------------------------------------------------------------------------------------------------------
------------------------------------------------------------------------------------------------------------------------------------------------------
----------------------ooor------------------------------------------------------------------oo--------------------------------------------------------
---------------------%%%%%--------------------QQQQ------------------------SSCSS------1------------------SSQSSS--------US------------------------------
----------------------|||-----------------------------------------------------------------------------------------------------------------------------
----------------------|||--------------------------------------------------------------------------%--------------------------------------------------
----------------------|||-----------------------k---------------------------------------------------------K---------E----------SSS--------------------
-----SSS------------%%%%%%%-------------T-----?QQQ-----ooo--------------QQQQ--QQ---QQQQ---SS------------SSSSSS-----TT---%---------------------#LSS----
--------------------||||||------------K-T--------------------------------------------------------------------------TT--t----------------------#-------
--------------------||||||--o-TTTT------T----------------------------------------------------%%%%------------------TT--t----------------------#-------
----------k---ggg---||||||-%%%TTTT------T--------------------y----------------------yy--------||----------------g--TT--t---------rk---------kk#-------
XXXXXXXXXXXXXXXXXXXX||||||--|-XXXXXXXXXXXXXXXXXXXX--XXXXXXXXXXXXXXXXXXXXXXXXXXXXXXXXXXXXXX----||----XXXXXXXXXXXXXXXXXXXX----XXXXXXXX---XXXXXXXXXXXX---
XXXXXXXXXXXXXXXXXXXX||||||--|-XXXXXXXXXXXXXXXXXXXX--XXXXXXXXXXXXXXXXXXXXXXXXXXXXXXXXXXXXXX----||----XXXXXXXXXXXXXXXXXXXX----XXXXXXXX---XXXXXXXXXXXX---
