------------------------------------------------------------------------------------------------------------------------------------------------------
------------------------------------------------------------------------------------------------------------------------------------------------------
------------------------------------------------------------------------------------------------------------------------------------------------------
-----------------------oo-----SSSSSSSSSS----------------------------------------SSSSSSSSSS------------------------------------------------------------
------------------------------------------------------------------------------------------------------------------------------------------------------
-------------------------------------------------------oooo-------------------------------------------------------------------------------------------
----------------------SSSS-----------------------------%%%%----------------g-----------------------------------------------------------US-------------
--------------------------------------------------------||-------------%%%%%%-------------------------------------------------------------------------
---------------------------------------S----------------||--------------||||-------------------------------------------------SSS----------------------
---------------------------------------S----------SSS---||--------------||||-----------S---------------------------------------------SS---------------
--------------------------%%%%---------S-TT---SU--------||--------------||||----SU--------------------%%%%%%----------r-r------------------S#---------
---------------------------|||-#---------TT-----------U-||-----------T--||||--------TT---t-------------||||-------%%%%%%%%%%%%--------------##--------
---------------------------|||-#-#-------TT-------------||---B-------T--||||--------TT---t-------------||||--------||||||||||-----TT--------###------#
-M--------k---ggg----------|||-#-#-------TT------k------||---b-------T--||||-------kTT--kt---------g---||||--------||||||||||-----TT--------####----##
XXXXXXXXXXXXXXXXXXXX%%%----|||XXXXXXXXXXXXXXXXXXXX----%%%%%-XXXXXX--XX--||||----XXXXXXXXXX-XXXXXXXXX%%-||||-%%-%%%-||||||||||-----XXXXXX-X-XXXXXXXXXXX
XXXXXXXXXXXXXXXXXXXX||-----|||XXXXXXXXXXXXXXXXXXXX-----|||--XXXXXX--XX--||||----XXXXXXXXXX-XXXXXXXXX|--||||--|--|--||||||||||-----XXXXXX-X-XXXXXXXXXXX
