------------------------------------------------------------------------------------------------------------------------------------------------------
------------------------------------------------------------------------------------------------------------------------------------------------------
------------------------------------------------------------------------------------------------------------------------------------------------------
----------SSSSSSSSSS---oo-----------------------------------------------------------------SSSSSSSSSS--------------------------------------------------
--------------------------------------------------?---------------------------------------------------------------------------------------------------
----------------------------------------------------------------------------------------oo------------------------------------------------------------
----------------------SSSS------------------------------------------------------oo----------------------------?SSS------SSS---------------------------
--------------------------------------------------SS--------------------------------------------------------------------------------------------------
----------------------------------------------------------------------o-------------------------------------------------------------------------------
---------------------------------------------------------------------------------SSS------------------------------------------------------------------
----------@QQQQ-----------%%%%-----------------------------------------------------------S--------------------SSSSS------------------------#----------
---------------------------|||-------------------------SSS-----------T--------#-----------t-----------------g-----------------------------##-------#--
-----------------g-#-------|||-------------------------------B-------T-------##-----------t-----------------TT----------------TT---------###---K---#--
-M--------------g#-#-------|||----k-k-------y-y--------------b-------T--------------------t-----------------TT--K-------------TT-----y--####-------#--
XXXXXXXXXXXXXXXXXXXX%%%----|||XXXXXXXXX-XXXXXXXXXX----------XXXXXX--XXXXXXXXXXXX----------XXXXXXXXXX--XXXXXXXXXXXXXXXXXX----XXXXXXXXXXXXXXXXXXXXX--XXX
XXXXXXXXXXXXXXXXXXXX||-----|||XXXXXXXXX-XXXXXXXXXX----------XXXXXX--XXXXXXXXXXXX----------XXXXXXXXXX--XXXXXXXXXXXXXXXXXX----XXXXXXXXXXXXXXXXXXXXX--XXX
