------------------------------------------------------------------------------------------------------------------------------------------------------
------------------------------------------------------------------------------------------------------------------------------------------------------
------------------------------------------------------------------------------------------------------------------------------------------------------
--------------------SSSSSSSSSS--------------------SSSSSSSSSS------------------------------------------------------------------------------------------
------------------------------------------------------SS--SS-----------------------------------------------------------------------------------------o
------------------------------------------------------SS--SS--------------------------------oo--------------------------------------------------------
----------------------------------------------------SS-----------------------------o--o-----------------SSQSSS---------------------------##-----------
----------------------------------------------------SS-----------------------------------------------------------------------------------##-----SSS---
----------------------------------------------------SS---------------o---------g-------------------%-------------------------SSS-------####-oo--------
-----------------------------C----------------------SS----oo-----y-----------------SSSS-------------------K----------------------------####-----------
---------QQ------------#-#--------------------------SSSS--SS-----##----------S@S----------S-------------SSSSSS----------r------------######-SS--------
---------------------#-#-#-#------------T-----TT------SS--------###-----------------------------------------------------%%%%%%-------######-----------
---------------------#-#-#-#------------T-----TT------SS-------####-------------%%%----------%%%%------------------B----|||||--------######-----------
-M-----------------#-#-#-#-#-E----k-k---T-----TT--------------#####-------------||------------||-------------------b----|||||--------######-----------
XXXXXXXXXXXXX--XXXXXXXXXXXXXXXXXXXXXXXX-XXXX--XXXXXXXXXXXXXXXXXXXXX----XXXXXXXXX||------------||----XXXXXXXXXXXXXXXXXXXX|||||-----XXXXXXXXXX----------
XXXXXXXXXXXXX--XXXXXXXXXXXXXXXXXXXXXXXX-XXXX--XXXXXXXXXXXXXXXXXXXXX----XXXXXXXXX||------------||----XXXXXXXXXXXXXXXXXXXX|||||-----XXXXXXXXXX----------
