------------------------------------------------------------------------------------------------------------------------------------------------------
------------------------------------------------------------------------------------------------------------------------------------------------------
------------------------------------------------------------------------------------------------------------------------------------------------------
------------------------------SSSSSSSSSS--------------------------------------------------------------------------------------------------------U-----
------------------------------------------------------------------------------------------------------------------------------------------------------
---------------------------------------------------------------------R------------------oo------------------------------------------------------------
---------------------LSSS-------------------------Q-----------------------------oo----------------------------?SSS---------------------US-------------
--------------------------------------------------------------------------------------------------------------------------------------------------SS--
---------------------------------------S---------------------------------------g----------------------------------------------------------------------
---------------------------------------S-----------------------------------------SSS------------g------------------------------SSS---SS-------SS------
---------------------2-----#-----------S----------Q--------------%%%---------S@S---------S------TT----%%%%%%--SSSSS-----%------------------S---------#
---------------------------#---#-------------K---B----------------|-----------------------------TT-----||||-----------------------------------------##
---------------------------##--#-#---------------b----------------|-----------------------------TT-----||||-----------------------TT---------------###
-M------------k-ggg---kk---##--#-#---------------B---gg----k------|-----------------------------TT-----||||-----K----------------rTT--------------####
XXXXXXXXXXXXXXXXXXXXXXXXXXXXXXXXXXXXXXXXXXXXXXXXXXXXXXXXXXXX%%%%%-|----XXXXXXXXX----------XXXXXXXXX-%%-||||-%%XXXXXXXXXX----XXXXXXXXXXXX-X-XXXXXX-XXXX
XXXXXXXXXXXXXXXXXXXXXXXXXXXXXXXXXXXXXXXXXXXXXXXXXXXXXXXXXXXX-|||--|----XXXXXXXXX----------XXXXXXXXX-|--||||--|XXXXXXXXXX----XXXXXXXXXXXX-X-XXXXXX-XXXX
