------------------------------------------------------------------------------------------------------------------------------------------------------
------------------------------------------------------------------------------------------------------------------------------------------------------
------------------------------------------------------------------------------------------------------------------------------------------------------
S-----SSSS----------------------------------------------------------------------SSSSSSSSSLSSSSSSSSSS----------SS-------S----------SSSSSSSSSS----------
S-----------------------------------------------------------------------------------------------------------------------------------------------------
S---------------------ooor------------oo--------------------------------------------------------------------------------------------------------------
S--------------------%%%%%---------SSSS---------------------------SSoo--------------oooooo-----------------------------SSSS------------------------SSS
S---------------------|||-----------------------------------------------------------------------------------------------------------------------------
S---------------------|||---------------------------------------------o-------------SSSSSS-------------------------SSS--------------------------------
S---------------------|||-----------------------------------------------------------SSSSSS------------------------------------------------------------
S-------------------%%%%%%%---%----------TT---SU------------%%%%%%-----------------------------------------------------S--------------------------#---
S-------------------||||||---------------TT---------K--------||||-------------#-----------t-----------TT-------##-------------------------TT------#---
S-------------------||||||--o------------TT------------------||||------------##-----------t-----------TT----TT-##-------------TT---tt-----TT------#---
S--M------k---ggg---||||||-%%%-----------TT------k---------g-||||-------------------------t-----------TT-k--TT-##-------------TT---tt----kTT-ggg--#---
XXXXXXXXXXXXXXXXXXXX||||||--|---%%%%--%%XXXXXXXXXXXXXXXXXXXX-||||-----XXXXXXXXXX---XXXXXXXXXXXXXXXXXXXXXXXXXXX-XX------X----XXXXXXXXXXXXXXXXXXXXXXXXXX
XXXXXXXXXXXXXXXXXXXX||||||--|----||----|XXXXXXXXXXXXXXXXXXXX-||||-----XXXXXXXXXX---XXXXXXXXXXXXXXXXXXXXXXXXXXX-XX------X----XXXXXXXXXXXXXXXXXXXXXXXXXX
