------------------------------------------------------------------------------------------------------------------------------------------------------
------------------------------------------------------------------------------------------------------------------------------------------------------
------------------------------------------------------------------------------------------------------------------------------------------------------
--------------------------------------------------SSSSSSSSSS--------------------------------------------------SSSSSSSSSS------------------------------
------------------------------------------------------SS--SS------------------------------------------------------------------------------------------
------------------------------------------------------SS--SS--g-------------------g---------oo--------------------------------------------------------
------------------SCS-------------------------------SS--------SSSSS-------------SSSSSSSS--------------------------------------------------------------
---------------------------TT-----------------------SS----------------------------------------------------TT-----------------------------------y------
---------------------------TT-----------------------SS----------------o----------------------------%------TT-------------------------g#------#SS--o---
---------------------------XX-----------------------SS----oo----------------------------------------------TT------------------------g##-----##--------
---------Q----TT---2---TT---------------------------SSSS--SS------------------------------SS-------------SXXS-T---------------------###-----##--SC----
--------------TT-------TT--------------T--------------SS----------------------#-------------------------------T--------------------####-----##--------
--------------TT-------TT--------------T--------------SS------TT-----t-------##--------------%%%%---TT--------T----TT-------------#####-----##---SSS--
-M------------TT----k--TT------------kkT----y-y---------------TT-----t------------------------||----TT--------T--g-TT-----kkk-----#####-----##--------
XXXXXXXXXXXXXXXXXXXXXXXXXXXXXXXXXXXXXXXXXXXXXXXXXXXXXXXXXXXXXXXXXXXXXXXXXXXXXXXXXXXXXX---X----||----XXXXXXXXXXXXXXXXXXXXXXXXXXXXXXXXXXX--XXXXX------XX
XXXXXXXXXXXXXXXXXXXXXXXXXXXXXXXXXXXXXXXXXXXXXXXXXXXXXXXXXXXXXXXXXXXXXXXXXXXXXXXXXXXXXX---X----||----XXXXXXXXXXXXXXXXXXXXXXXXXXXXXXXXXXX--XXXXX------XX
