------------------------------------------------------------------------------------------------------------------------------------------------------
------------------------------------------------------------------------------------------------------------------------------------------------------
------------------------------------------------------------------------------------------------------------------------------------------------------
----------SSSSSSSSSS--------------------SSSSSSSSSSSSSSSSS----------SSSSSSSSSSSSSSSSSSSSSSL------------------------------------------------------------
----------------------------------------SSSSSSSS------------------------------------------------------------------------------------------------------
----------------------------------------SSSCSSSS------------------------------------------------------------------------------------------------k-----
----------------------------------------SSSSSSSS--QQ------------CSS-----------------oooooo-SSS!-------------------------SSS--------------##----SQS--SQ
------------------------------------------------------------------------------TT---------------------------------------------------------##-----------
-----------------------------------------------------------SSS--2-------------TT----SSSSSS---------------------------------------------####-----------
-------------------------------------------ggg-----------------2-2------------TT----SSSSSS---------------------------------------------####-----------
----------------------------------------SSSSSSSS--QQ--QQQ---------2---------SCTT--------------C-------%%%%%%-------------------------######----SQS--S?
----------------------------------------SSSSSSSS------------------------TT----TT-----------------------||||--------------------------######-----------
----------------------------------------SSSSSSSS------------------------TT----TT-----------------------||||--------B----------TT-----######-----------
---M---------------------ggg------k-k---SSSSSSSS------------------------TT---kTT---------------g-g-----||||--------b----------TT-----######--k------gg
XXXXXXXXXXX--XX--X--XXXXXXXXXXXXXXXXXXX-XXXXXXXXXXXXXXXXX------XXXXXXXXXXXXXXXXX---XXXXXXXXXXXXXXXXX%%-||||-%%XXXXXXXXXX----XXXXXXXXXXXXXXXXXXXXXXXXXX
XXXXXXXXXXX--XX--X--XXXXXXXXXXXXXXXXXXX-XXXXXXXXXXXXXXXXX------XXXXXXXXXXXXXXXXX---XXXXXXXXXXXXXXXXX|--||||--|XXXXXXXXXX----XXXXXXXXXXXXXXXXXXXXXXXXXX
