------------------------------------------------------------------------------------------------------------------------------------------------------
------------------------------------------------------------------------------------------------------------------------------------------------------
------------------------------------------------------------------------------------------------------------------------------------------------------
--------------------SSSSSSSSSS--oo--------------------------------------------------------------------------------------------------------------------
--------------------SSSSSSSSSS---------g--------------------------------------------------------------------------------------------------------------
--------------------SSSSSSSSSS-----%%%%%-----------------------------R------------g---------oo--------------------------------------------------------
--------------------SSSSSSSSSS------||||-----------------Q-Q--------------SS----SSSSSSSS------------------------------------------!S------------------
------------------------------------||||------------------------------------------------------------------TT------------------------------------------
------------------------------------||||-----------------------------------------------------------%------TT-----------------SSS----------------------
------------------------------%%%%%-||||------------------------------------------------------------------TT------------------------------------------
-------------------%--SSSSSS?--|||--||||------tt---------Q-Q-----%%%--SS-----SS-----------S--------------SXXS-----------r---------S------#--#---------
----------------------SSSSS----|||--||||------tt------------------|-----------------------------------------------------%%%%%%----------##--##--------
----------------------SSSSS----|||--||||------tt------------------|--------------------------%%%%---TT------------------|||||----------###--###------#
-------------%%%%----------ooo-|||--||||-g----tt------------------|---------------------------||----TT---------k----kkk-|||||---------####--####----##
XXXXXXXXXXX---||-----XXXXXXXXX-|||--||||XXXXXXXXXXXXXXXXXXXX%%%%%-|-------------XXXXXX---X----||----XXXXXXXXXXXXXXXXXXXX|||||-----XXXXXXXXXXXXXXXXXXXX
XXXXXXXXXXX---||-----XXXXXXXXX-|||--||||XXXXXXXXXXXXXXXXXXXX-|||--|-------------XXXXXX---X----||----XXXXXXXXXXXXXXXXXXXX|||||-----XXXXXXXXXXXXXXXXXXXX
