------------------------------------------------------------------------------------------------------------------------------------------------------
------------------------------------------------------------------------------------------------------------------------------------------------------
------------------------------------------------------------------------------------------------------------------------------------------------------
--------------------------------------------------SSSSSSS-----------------------------------------------------SS-------S------------------------------
------------------------------------------------------------------------------------------------------------------------------------------------------
--------------------------------------------------------------------------------------------oo--------------------------------------------------------
-----------------------------U--------------------QQ---------------------------------SSSS--------------------R---------S--oo---%%%-------##-----------
-----------------------------------------------------------------------------------------------------r--------------------SS----||-------##-----------
-----------------------------------------------------------S---------------------------------------%%%%%%%%--------SSS----------||-----####-----------
-------------------------------------------------------------------------1--------------------------||||||----------------------||-----####-----------
----------------------------##--------------------QQ--QQQ------------#T---------Q---------S---------||||||-------------S-----SS-||---######-----------
-----------------------y-#####---------T----------------------------##T----TT-----------------------||||||-----##---------------||---######-----------
--------------------y-######-----------T--------------------TT-----###T----TT----------------%%%%---||||||-----##---------------||---######--------F--
-M--------k---ggg---######-----------kkT--------------------TT----####T---kTT----ggg----------||----||||||--oo-##---------------||---######--------#--
XXXXXXXXXXXXXXXXXXXXXXXX------XXXXXXXXXXX-XX-XX-XXXXXXXXX---XXXXXXXXXXXXXXXXXXXXXXXXX----X----||----||||||--%%-XX------X%%-----%%%XXXXXXXXXXXXXXXXXXXX
XXXXXXXXXXXXXXXXXXXXXXXX------XXXXXXXXXXX-XX-XX-XXXXXXXXX---XXXXXXXXXXXXXXXXXXXXXXXXX----X----||----||||||---|-XX------X|-------||XXXXXXXXXXXXXXXXXXXX
