------------------------------------------------------------------------------------------------------------------------------------------------------
------------------------------------------------------------------------------------------------------------------------------------------------------
------------------------------------------------------------------------------------------------------------------------------------------------------
------------------------------SSSSSSSSSS----------------------------------------SSSSSSSSSL------------------------------------------------------------
------------------------------SSSSSSSSSS--------------------------------------------------------------------------------------------------------------
------------------------------SSSSSSSSSS----------------------g---------------------------------------------------------------------------------k-----
------------------------------SSSSSSSSSS----------------------SSSSS---------SSSS----oooooo----------------2---?SSS----------------!S-----------SQS--SQ
------------------------------------------------------------------------------------------------------------------------------------------------------
------------------------------------------------------------------------------------SSSSSS------------------------------------------------------------
------------Q--?-------------------------------------------------------------K------SSSSSS--------ooo--------------------------SSS--------------------
--------SU---------S----------SSSSSSSSSS---------------ooo-----------------SSSSS--------------------------2---SSSSS-----%---------S------#-----SQS--S?
------------------------------SSSSSSSSSST-----TT----------------------T------------------------TT---------------------------------------##------------
------------------------------SSSSSSSSSST-----TT--------------TT-----tT------------------------TT--------------------------------------###------------
--M---------------K-----------SSSSSSSSSST-----TT--------------TT-----tT---------------------y--TT-------y--y----K----------------r----####---k------gg
XXXXXXXXXXXXXXXXXXXXXXXXX--XXXXXXXXXXXXXXXXX--XXXX--XXXXXXXXXXXXXXXXXXXXXXXXXXXX---XXXXXXXXXXXXXXXXXXXXXXXXXXXXXXXXXXXXX----XXXXXXXXXXXXXXXXXXXXXXXXXX
XXXXXXXXXXXXXXXXXXXXXXXXX--XXXXXXXXXXXXXXXXX--XXXX--XXXXXXXXXXXXXXXXXXXXXXXXXXXX---XXXXXXXXXXXXXXXXXXXXXXXXXXXXXXXXXXXXX----XXXXXXXXXXXXXXXXXXXXXXXXXX
