------------------------------------------------------------------------------------------------------------------------------------------------------
------------------------------------------------------------------------------------------------------------------------------------------------------
------------------------------------------------------------------------------------------------------------------------------------------------------
----------------------------------------------------------------------SSSSSSSSSS----------------------------------------------------------------------
----------------------------------------------------------------------------SSSS---------------------------------------------------------------------o
----------------------ooor------------ooooooo----------oooo--------------g--SSSS----------------------------------------------------------------------
---------------------%%%%%---------SSSS----------------%%%%-------------SS-----------------------------------------------SSS----S!--------------------
----------------------|||-----------------------SSSSSS--||--------------SS----------------------------------------------------------------------SSS---
----------------------|||----------------SSSS-----------||-----------o--SS------------------------------------------------------------------oo--------
----------------------|||-------------------------------||-------y------SC--g-g---o-------------------------------------------------------------------
-------------------%%%%%%%%---%-------------------------||-------##-----SS--SSSS-------TT--------tt-------------!-----S----------S----------SS--------
--------------------||||||----------------------------U-||------###--------------------TT-T------tt---------------------------------------------------
--------------------||||||--o---------------%%%%%-------||-----####--------------------TT-T------tt-------*-------------------------------------------
-------------%%%%---||||||-%%%---------------|||--------||----#####--------------------TT-T------tt-gg----*-----------------gg-g-gk-------------------
XXXXXXXXXXX---||----||||||--|---%%%%--%%%%---|||------%%%%%-XXXXXXX---XXXXXXXXXXXXXXXXXXXXXXXXXXXXXXXXXXXXXXX-XXXXXXXXXXXXXXXXXXXXXX---XXXXX----------
XXXXXXXXXXX---||----||||||--|----||----||----|||-------|||--XXXXXXX---XXXXXXXXXXXXXXXXXXXXXXXXXXXXXXXXXXXXXXX-XXXXXXXXXXXXXXXXXXXXXX---XXXXX----------
