------------------------------------------------------------------------------------------------------------------------------------------------------
------------------------------------------------------------------------------------------------------------------------------------------------------
------------------------------------------------------------------------------------------------------------------------------------------------------
---------------------------------------------------oo---------------------------SSSSSSSSSS------------------------------------------------------------
--------------------------------------------------%%%%------------------------------------------------------------------------------------------------
----------------------------------------%%---------||-----------------------------------------------oo------------------------------------------------
--------------------USS-----------------|----------||----------------------1---------------SSS!-----%%%---------------------------%-------------------
----------------------------------------|----oo----||--SSS------------------------------------------||--o----R--oooo----------------------------------
----------------------------------------|----------||-----------------------------------------------||-%%%------------------------------SSS-----------
----------------------------------------|----------||----------------------ggg---------S------------||--|---------------------------------------------
----------Q-----------------------------|----------||-----------------#########-SU------------C-----||--|-----T-------------------%%%%%---------------
---------------------B----------------tt|----------||----------------T--------#-----TT---t----------||-o|-----T--------------------|||----------------
---------------------b-------B--------tt|---------%||--------B-------T--------#-----TT---t----------||%%%%%---T--------------------|||-------------F--
-M-----------------#-B-------b--------tt|----------||--------b-------T--------#----kTT--kt-----g-g--||-|||----T---y-------kkk------|||-------------#--
XXXXXXXXXXXXX--XXXXXXXXXXXXXXXXXXXXXXXXX|----%%%%--||-------XXXXXX--XX--------X-XXXXXXXXXXXXXXXXXXXX||-|||----XXXXXXXXXXXXXXXXXXXX%|||------XXXXXXXXXX
XXXXXXXXXXXXX--XXXXXXXXXXXXXXXXXXXXXXXXX|-----||---||-------XXXXXX--XX--------X-XXXXXXXXXXXXXXXXXXXX||-|||----XXXXXXXXXXXXXXXXXXXX-|||------XXXXXXXXXX
