------------------------------------------------------------------------------------------------------------------------------------------------------
------------------------------------------------------------------------------------------------------------------------------------------------------
------------------------------------------------------------------------------------------------------------------------------------------------------
S-----SSSS------------------------------SSSSSSSSSS----------------------------------------SSSSSSSSSS--------------------SSS-----SS--------------------
S---------------------------------------SSSSSSSS------------------------------------------------------------------------------------------------------
S----------------------SSS--------------SSSCSSSS--------------g---------------------------------------------------------------------------------k-----
S---------------------------------------SSSSSSSS--------------SSSSS------------------SUS---------------------R--------USUS---------------------SQS--SQ
S--------------------g-----------------------------------------------------------------------------------r--------------------------------------------
S-------------------%%%-----------------------------------------------------------------------------%%%%%%%-----------------SSS-----------------------
S-------------------||----SSS--------------ggg-----------o---------------1--------------------------||||||----------E---------------------------------
S-------------------||---------TT-------SSSSSSSS----------------------T-------------#####-----------||||||---------TT---SSS--------------------SQS--S?
S----------------K--||---------TT-------SSSSSSSS----------------------T----TT-------#---------------||||||---------TT--t-------------TT---------------
S-----------B-------||---------TT-------SSSSSSSS--------------TT-----tT----TT------K#---------------||||||---------TT--t-------------TT---------------
S--M--------b-------||----oo--gTT-------SSSSSSSS----k---------TT-----tT---kTT-------#-----------g-g-||||||--oo--g--TT--t-------------TT------k------gg
XXXXXXXXXXXXXXXXXXXX||---%%%--XXXXXXXX--XXXXXXXXXX-XXXXXXXXXXXXXXXXXXXXXXXXXXXXXXXXXXXX---XXXXXXXXXX||||||--%%XXXXXXXXXXXXX------XXXXXXXXXXXXXXXXXXXXX
XXXXXXXXXXXXXXXXXXXX||----|---XXXXXXXX--XXXXXXXXXX-XXXXXXXXXXXXXXXXXXXXXXXXXXXXXXXXXXXX---XXXXXXXXXX||||||---|XXXXXXXXXXXXX------XXXXXXXXXXXXXXXXXXXXX
