------------------------------------------------------------------------------------------------------------------------------------------------------
------------------------------------------------------------------------------------------------------------------------------------------------------
------------------------------------------------------------------------------------------------------------------------------------------------------
S-----SSSSSSSSSSSSSSSSSSSSSSSSSSSSSSSSSS--------------------------------------------------------------------------------------------------------------
S-----------------------------SSSSSSSSSS--------------------------------------------------------------------------------------------------------------
S-----------------------------SSSSSSSSSS%%----------------------------------------g-------------------------------------------------------------------
S-----------------------------SSSSSSSSSS|---------------------USSS--------------SSSSSSSS---SSS!--------------------------------SSS%-------------------
S---------------------------------------|----oo-------------------------------------------------------------------------------------------------------
S---------------------------------------|----------------B-------------------------------------------------------------y----------------SSS-----------
S----------------------------C----------|----------------b-------------------------------------------------------------X--------K---------------------
S----------------------#-#----SSSSSSSSSS|--------------SS#CS-S-----TT-------------------------C-----------------------XX-------SSS%%%%%---------------
S--------------------#-#-#-#--SSSSSSSSSS|--------------------------TT---------------------------------TT-------------XXX-----------|||----------------
S--------------------#-#-#-#--SSSSSSSSSS|------------------K-------TT---------------------------------TT----TT------XXXX-TT--------|||-------------F--
S--------------------#-#-#-#-ESSSSSSSSSS|--------------------ggg---TT--------------------------g-g----TT-k--TT-----XXXXX-TT--------|||-------------#--
XXXXXXXXXXX--XX--X--XXXXXXXXXXXXXXXXXXXX|----%%%%-XXXXXXXXXXXXXXXXXXXXX----XXXXXXXXXXX---XXXXXXXXXXXXXXXXXXXXXXXXXXXXXXXXXXXXXXXXX%|||------XXXXXXXXXX
XXXXXXXXXXX--XX--X--XXXXXXXXXXXXXXXXXXXX|-----||--XXXXXXXXXXXXXXXXXXXXX----XXXXXXXXXXX---XXXXXXXXXXXXXXXXXXXXXXXXXXXXXXXXXXXXXXXXX-|||------XXXXXXXXXX
