------------------------------------------------------------------------------------------------------------------------------------------------------
------------------------------------------------------------------------------------------------------------------------------------------------------
------------------------------------------------------------------------------------------------------------------------------------------------------
------------------------------SSSSSSSSSS--------------------------------------------------------------------------------------------------------------
------------------------------------------------------------------------------------------------------------------------------------------------------
------------------------------------------------------------------------------------------------------------------------------------------------------
----------------------!----------------------------------Q-Q------------SSSSS--------------------------------R----------SS----------------------------
-----------------------------------------------------------------------------------------------------r------------------------------------------------
---------------------------------------S-----------------------------o------------TT----------------%%%%%%%-------------------------------------------
------------Q--?-----------------------S-------------------------y----------------TT----------------||||||-----------------TT-------------------------
---------Q---------SS@S!S--------------S-----------------Q-Q-----##----------2----TT-------------tt-||||||-----------------TT-----------------#LSS----
-------------------------------#-------------K---B--------------###--------TT-----TT-----TT------tt-||||||--------------t--TT-----------------#-------
----------------------------tt-#-#---------------b-------------####---t----TT--TT-TT-----TT------tt-||||||---------B----t--TT-----------------#-------
-M----------------K--g------tt-#-#---------------B------------#####---t----TT--TT-TT---k-TT------tt-||||||--oo-----b----t--TT---------------kk#-------
XXXXXXXXXXXXXXXXXXXXXXXXXXXXXXXXXXXXXXXXXXXXXXXXXXXXXXXXXXXXXXXXXXX---XXXXXXXXXXXXXXXXXXXXXXXXXXXXXX||||||--%%XXXXXXXXXXXXXXXXXXXXXXXXXXXXXXXXXXXXX---
XXXXXXXXXXXXXXXXXXXXXXXXXXXXXXXXXXXXXXXXXXXXXXXXXXXXXXXXXXXXXXXXXXX---XXXXXXXXXXXXXXXXXXXXXXXXXXXXXX||||||---|XXXXXXXXXXXXXXXXXXXXXXXXXXXXXXXXXXXXX---
