------------------------------------------------------------------------------------------------------------------------------------------------------
------------------------------------------------------------------------------------------------------------------------------------------------------
------------------------------------------------------------------------------------------------------------------------------------------------------
--------------------------------------------------------------------------------------------------------------------------------------------SSSSSSSSSS
------------------------------------------------------------------------------------------------------------------------------------------------------
-----------------------SSS------------oo----------------------------------------K---------------------------------------------------------------------
-----------------------------------SSSS------------------------------------g----SS----1----------------------@-----oo----------SSS-------##-----------
---------------------g-------------------------------------------------%%%%%%------------------------------------------------------------##-----------
-----------------g--%%%----------------------------------------------o--||||-----------------------------------------------------------####-----------
-----------------#--||----SSS------------------------------------y------||||-------------------oooo-----------------------------K------####-----------
----------S-----##--||--------%------------------------ooo-------##-----||||----SS------------------SU----!--!-%%%%--%%%-------SSS---######---TT------
---------------###--||------------------------------------------###-----||||----------TT------------------------||----||-------------######---TT------
--------------####--||-----------------------------------------####-----||||----------TT------------------------||----||-TT----------######---TT------
-M-----------#####--||----oo----------------------------------#####-----||||----------TT------------------k---o-||----||-TT----------######---TT------
XXXXXXXXXXXXXXXXXXXX||---%%%----%%%%--%%X-XX-XX-XX--XXXXXXXXXXXXXXX-----||||----XXXXXXXXXX%%%%%%%-%%XXXXXXXXXX%-||----||XXXXXXXXXXXXXXXXXXXXXXXX--XXXX
XXXXXXXXXXXXXXXXXXXX||----|------||----|X-XX-XX-XX--XXXXXXXXXXXXXXX-----||||----XXXXXXXXXX||||||---|XXXXXXXXXX--||----||XXXXXXXXXXXXXXXXXXXXXXXX--XXXX
