------------------------------------------------------------------------------------------------------------------------------------------------------
------------------------------------------------------------------------------------------------------------------------------------------------------
------------------------------------------------------------------------------------------------------------------------------------------------------
S-----SSSS----------------------------------------------------------------------SSSSSSSSSS------------------------------------------------------------
S-----------------------------------------------------------------------------------------------------------------------------------------------------
S-------------------------------------oo--------------------------------------------------------------------------------------------------------------
S-------------------USS------------SSSS-----------------------------------------------------------------------?SSS---------------------------QQQQ-----
S-------------------------------------------------------------------------------------------------------------------------------oo--------------------
S------------------------------------------------------------------------------------------------------------------------------------g#---------------
S--------------------------------------------------------o-----------------------------S--------------------------------------------g##--------y------
S---------------!-------------%--------------------------------------T----------SU----------------------------SSSSS----------TT-----###-----Q?SSQQQ---
S--------------------B-----------------------K---B-------------------T--------------TT---t------------------g----------------TT----####---------------
S--------------------b-------B-------------------b-------------------T--------------TT---t------------------TT---------------TT---#####---------------
S--M-----------------B-------b-------------------B--k---------ggg----T-------------kTT--kt---------g--------TT--K--------y---TT---#####---------------
XXXXXXXXXXXXXXXXXXXXXXXXXXXXXX--%%%%--%%XXXXXXXXXX-XXXXXXXXXXXXXXXXXXXX----XXXXXXXXXXXXXXX-XXXXXXXXX--XXXXXXXXXXXXXXXXXXXXXXXXXXXXXXXXX--XXXXX--XXXXXX
XXXXXXXXXXXXXXXXXXXXXXXXXXXXXX---||----|XXXXXXXXXX-XXXXXXXXXXXXXXXXXXXX----XXXXXXXXXXXXXXX-XXXXXXXXX--XXXXXXXXXXXXXXXXXXXXXXXXXXXXXXXXX--XXXXX--XXXXXX
