------------------------------------------------------------------------------------------------------------------------------------------------------
------------------------------------------------------------------------------------------------------------------------------------------------------
------------------------------------------------------------------------------------------------------------------------------------------------------
--------------------SSSSSSSSSS--oo--------------------------------------------------------------------------------------SSS-----SS--------------------
-------------------------------------g-g--------------------------------------------------------------------------------------------------------------
-----------------------------------%%%%%--------------------------------------------------------------------------------------------------------------
------------------------------------||||----------------------USSS-------------------------------------------@?SSS------US----------------------------
------------------------------------||||--------------------------------------------------------------------------------------------------------------
------------------------------------||||------------------------------------------TT----------------------------------------SSS-----------------------
-----------------------------C%%%%%-||||------------------------------------------TT-----------oooo---------------------------------------------------
----------------%%%%---#-#-----|||--||||---------------ooo---S-----TT-------------TT----------------SU----!--!SSSSS-----SSS----------------#----------
-----------------||--#-#-#-#---|||--||||---------------------------TT-------------TT-----T------------------------------------------------##----------
-----------------||--#-#-#-#---|||--||||---------------------------TT-----------T-TT-----T-----------------------------------------------###-------F--
-M---------------||--#-#-#-#-E-|||--||||---------------------ggg---TT-----------T-TT---k-T----------------k-----K--------------------y--####-------#--
XXXXXXXXXXX--%%%%||%XXXXXXXXXX-|||--||||X-XX-XX-XX--XXXXXXXXXXXXXXXXXXX----XXXXXXXXXXXXXXX%%%%%%%-%%XXXXXXXXXXXXXXXXXXXXXXX------XXXXXXXXXXXXXXXXXXXXX
XXXXXXXXXXX---||-||-XXXXXXXXXX-|||--||||X-XX-XX-XX--XXXXXXXXXXXXXXXXXXX----XXXXXXXXXXXXXXX||||||---|XXXXXXXXXXXXXXXXXXXXXXX------XXXXXXXXXXXXXXXXXXXXX
