------------------------------------------------------------------------------------------------------------------------------------------------------
------------------------------------------------------------------------------------------------------------------------------------------------------
------------------------------------------------------------------------------------------------------------------------------------------------------
------------------------------SSSSSSSSSS--------------------------------------------------------------------------------------------------------------
------------------------------SSSSSSSSSS--------------------------------------------------------------------------------------------------------------
------------------------------SSSSSSSSSS----------------------------------------K---------------------------------------------------------------------
--------------------S---------SSSSSSSSSS-----------------------------------g----SS----1----------------------R------------------------------SSS-------
---------------------------TT------------------------------------------%%%%%%------------------------r-----------SSS--------------oo------------------
---------------------------TT-------------------------------------------||||------------------------%%%%%%%-------------------------------------------
------------Q--?-----------XX-------------------------------------------||||----------------------oo||||||--------------SS-?Q--------------------SSSSS
-------------------S---TT-----SSSSSSSSSS-----------------tt-------------||||----SS------------------||||||---------------------------------Q----------
-----------------------TT-----SSSSSSSSSST-----TT---------tt----------T--||||----------TT-------TT---||||||--------------------------------------------
-----------------------TT-----SSSSSSSSSST-----TT---------tt--B-------T--||||----------TT-------TT---||||||---------------------y------------SSS-------
-M----------------K-k--TT-----SSSSSSSSSST-----TT-----g-g-tt--b-------T--||||----------TT----y--TT---||||||--oo-------------SSSSS-------------------r--
XXXXXXXXXXXXXXXXXXXXXXXXXXXXXXXXXXXXXXXXXXXX--XXXXXXXXXXXXXXXXXXXX--XX--||||----XXXXXXXXXXXXXXXXXXXX||||||--%%%%%%----%%-------XX-XXXXXXXXXX-----XXXXX
XXXXXXXXXXXXXXXXXXXXXXXXXXXXXXXXXXXXXXXXXXXX--XXXXXXXXXXXXXXXXXXXX--XX--||||----XXXXXXXXXXXXXXXXXXXX||||||---||||------|-------XX-XXXXXXXXXX-----XXXXX
