------------------------------------------------------------------------------------------------------------------------------------------------------
------------------------------------------------------------------------------------------------------------------------------------------------------
------------------------------------------------------------------------------------------------------------------------------------------------------
----------------------------------------------------------------------SSSSSSSSSS----------------------------------------------------------------------
----------------------------------------------------------------------------SSSS----------------------------------------------------------------------
-----------------------SSS-----------------------------------------------g--SSSS----------------------------------------------------------------------
------------------------------------------------------------------------SS----------y------SSS!--------------R---------------------------##--------SSS
---------------------g--------------------------------------------------SS--------#SSS---------------r-----------------------------------##-----------
--------------------%%%----------------------------------TT-------------SS-------##-----------------%%%%%%%----------------------------####-----------
--------------------||----SSS----------------------TT----TT-------------SC--g-g-###1----------------||||||-----------------------------####-----------
---------Q---------%||-----------------------------TT----XX-------------SS--SSSS###-----------C-----||||||---------------------------######-------#---
--------------------||----------------K------------TT---------------------------###--SSS------------||||||-----#---------------------######-------#---
--------------------||--------TTTT-----------------TT---------------------------###-----------------||||||-----#---------------------######-------#---
-M-----------%%%%---||----oo--TTTT----------y-y----TT--------y------------------###------------g-g--||||||--oo-#----ggg---kkk--------######--ggg--#---
XXXXXXXXXXX---||----||---%%%--XXXXXXXXXXXXXXXXXXXXXXXXXXXXXXXXXXXXXXXXXXXXXXXXXXXXXXXX---XXXXXXXXXXX||||||--%%-XXXXXXXXXXXXXXXXXXXXXXXXXXXXXXXXXXXXXXX
XXXXXXXXXXX---||----||----|---XXXXXXXXXXXXXXXXXXXXXXXXXXXXXXXXXXXXXXXXXXXXXXXXXXXXXXXX---XXXXXXXXXXX||||||---|-XXXXXXXXXXXXXXXXXXXXXXXXXXXXXXXXXXXXXXX
