------------------------------------------------------------------------------------------------------------------------------------------------------
------------------------------------------------------------------------------------------------------------------------------------------------------
------------------------------------------------------------------------------------------------------------------------------------------------------
--------------------------------------------------------------------------------ooo-------------------------------------------------------------------
--------------------------------------------------------------------------------%%%-------------------------------------------------------------------
----------------------ooor-------------------------------------------------------|------------------oo------------------------------------------------
------------------Q--%%%%%-------------------------------Q-Q--------------SS-----|------------------%%%------------------------SSS----------SS--------
----------------------|||--------------------------------------------------------|------------------||--o----R--------------------oo------------------
----------------------|||--------------------------------------------o-----------|------------------||-%%%--------------------------------------------
----------------------|||----------------------------------------y---------------|---%%%%-----------||--|-----------------------K---------------------
---------Q--------?-%%%%%%%------------------------------Q-Q-----##---SS-----SS--|----||------------||--|-------!-----S--------SSS---------QSS--------
--------------TT----||||||--------------------------------------###-------------%%%%%%||------------||-o|-----------------------------------------#-TT
--------------TT----||||||--o----------------------------------####--------------||||-||---------B--||%%%%%--------------TT----------------------##-TT
--------------TT----||||||-%%%----k-k-------------------------#####--------------||||-||---------b--||-|||---------------TT---------------------###-TT
XXXXXXXXXXXXXXXXXXXX||||||--|-XXXXXXXXX-X-XX-XX-XXXXXXXXXXXXXXXXXXX--------------||||-||%%XXXXXXXXXX||-|||----XXXXXXXXXXXXXXXXXXXXXXXXXXXXXXXXXXXXX-XX
XXXXXXXXXXXXXXXXXXXX||||||--|-XXXXXXXXX-X-XX-XX-XXXXXXXXXXXXXXXXXXX--------------||||-||-|XXXXXXXXXX||-|||----XXXXXXXXXXXXXXXXXXXXXXXXXXXXXXXXXXXXX-XX
