------------------------------------------------------------------------------------------------------------------------------------------------------
------------------------------------------------------------------------------------------------------------------------------------------------------
------------------------------------------------------------------------------------------------------------------------------------------------------
----------------------------------------SSSSSSSSSS------------------------------------------------------------SS-------S------------------------------
------------------------------------------------------------------------------------------------------------------------------------------------------
-----------------------SSS----------------------------------------------------------------------------oo----------------------------------------------
-----------------------------------------oooo--------------------------------------o--o--------------------------------S-----------------##-----------
---------------------g---------------------------------------o---o---o-------------------------------------------------------------------##-----------
--------------------%%%------------------SSSS-U-------------%%%-%%%-%%---------------------------------------------SSS-----------------####-----------
--------------------||----SSS-----------oS--SoS--------------|---|---|---1---------SSSS----o-------------------------------------------####-----------
----------------!---||-----------------TSS--SSS--------------|---|---|T--------------------------TT--------------------S-------------######-----------
--------------------||-----------------T------------K--------|---|---|T----TT--------------------TT------------##--------------------######-----------
--------------------||-----------------T---------------------|---|---|T----TT---%%%--------------TT---------tt-##--------------------######--------F--
-M------------------||----oo----gg-----T--kk---------------g-|---|-r-|T---kTT---||---------------TT---ggg---tt-##---------kkk--------######--------#--
XXXXXXXXXXXXXXXXXXXX||---%%%--XXXXXXXXXXXXXXXXXXXXXXXXXXXXXX%%%%%%%%%%XXXXXXXXXX||--------XXXXXXXXXXXXXXXXXXXX-XX------XXXXXXXXXXXXXXXXXXXXXXXXXXXXXXX
XXXXXXXXXXXXXXXXXXXX||----|---XXXXXXXXXXXXXXXXXXXXXXXXXXXXXX-|||||||||XXXXXXXXXX||--------XXXXXXXXXXXXXXXXXXXX-XX------XXXXXXXXXXXXXXXXXXXXXXXXXXXXXXX
