------------------------------------------------------------------------------------------------------------------------------------------------------
------------------------------------------------------------------------------------------------------------------------------------------------------
------------------------------------------------------------------------------------------------------------------------------------------------------
------------------------------------------------------------------------------------------------------------------------------------------------------
------------------------------------------------------------------------------------------------------------------------------------------------------
----------------------------------------------------------------------------------------oo------------------------------------------------------------
--------------------------------------------------Q-------------------------SSSSoo--------------------------------------SS--------!S--------SSS-------
------------------------------------------------------------------------------------------------------------------------------------------------------
-----------------g-----------------------------------------------------------------------------------------------------y------------------------------
-----------------#-----------------------------------------------------------K---SSS------------g----------------------X---TT--------------------SSSSS
----------S-----##----------TT--------------------Q------------------#-----SSSSS---------S------TT--------------------XX---TT-----S------#------------
---------------###----------TT--------------------------------------##T-------------------------TT-------------------XXXt--TT-----------##------------
--------------####----------TT------------------------------TT-----###T-------------------------TT--------*---------XXXXt--TT----------###--SSS-------
-M-----------#####------ggg-TT----k-k-------y-y------gg----kTT----####T-------------------------TT--gg----*--------XXXXXt--TT---------####---------r--
XXXXXXXXXXXXXXXXXXXXXXXXXXXXXXXXXXXXXXX-XXXXXXXXXXXXXXXXXXXXXXXXXXXXXXXXXXXXXXXX----------XXXXXXXXX-XXXXXXXXX-XXXXXXXXXXXXXXXXXXXXXXXXXXXXXX-----XXXXX
XXXXXXXXXXXXXXXXXXXXXXXXXXXXXXXXXXXXXXX-XXXXXXXXXXXXXXXXXXXXXXXXXXXXXXXXXXXXXXXX----------XXXXXXXXX-XXXXXXXXX-XXXXXXXXXXXXXXXXXXXXXXXXXXXXXX-----XXXXX
