------------------------------------------------------------------------------------------------------------------------------------------------------
------------------------------------------------------------------------------------------------------------------------------------------------------
------------------------------------------------------------------------------------------------------------------------------------------------------
-----------------------oo-----SSSSSSSSSS----------------------------------------------------------------------------------------------------SSSSSSSSSS
------------------------------SSSSSSSSSS--------------------------------------------------------------------------------------------------------------
------------------------------SSSSSSSSSS--------------------------------------------------------------------------------------------------------------
----------------------SSSS----SSSSSSSSSS--------------------------------------------y------------------------------oo----------SSS-SSSS---------------
----------------------------------------------------------------------------------#SSS------------oo--------------------------------------------------
---------------------------------------------------------TT----------------------##-------------------------------------------------------------------
---------------------------------------------------TT----TT---------------------###1--------------------------------------------K------SSSS-----------
----------Q---------------%%%%SSSSSSSSSS-----------TT----XX----------T----------###----------------------------%%%%--%%%-------SSS------------TT------
---------------------------|||SSSSSSSSSS-----------TT----------------T----------###--SSS--------#-----TT--------||----||----------------------TT------
---------------------------|||SSSSSSSSSS-----------TT----------------T----------###-------------#-----TT----TT--||----||-TT-------------------TT------
-M-----------------#-------|||SSSSSSSSSS-----------TT---------ggg----Tgg--------###-------------#-----TT-k--TTo-||----||-TT-------------------TT------
XXXXXXXXXXXXX--XXXXX%%%----|||XXXXXXXXXXX-XX-XX-XXXXXXXXXXXXXXXXXXXXXXXXXXXXXXXXXXXXXX---XXXXXXXXXXXXXXXXXXXXX%-||----||XXXXXXXXXX---------XXXXX--XXXX
XXXXXXXXXXXXX--XXXXX||-----|||XXXXXXXXXXX-XX-XX-XXXXXXXXXXXXXXXXXXXXXXXXXXXXXXXXXXXXXX---XXXXXXXXXXXXXXXXXXXXX--||----||XXXXXXXXXX---------XXXXX--XXXX
