------------------------------------------------------------------------------------------------------------------------------------------------------
------------------------------------------------------------------------------------------------------------------------------------------------------
------------------------------------------------------------------------------------------------------------------------------------------------------
--------------------SSSSSSSSSS----------SSSSSSSSSS----------------------------------------------------------------------------------------------------
----------------------------------------SSSSSSSS------------------------------------------------------------------------------------------------------
----------------------------------------SSSCSSSS----------------------------------------oo------------------------------------------------------------
----------------------------------------SSSSSSSS--------------------------------oo---------------------------------oo--------------------##-----------
--------------------------------------------------------------------------------------------------oo-------------------------------------##----y------
-----------------g---------------------------------------TT----------------------------------------------------------------------------####--#SS--o---
-----------------#-----------C-------------ggg-----TT----TT----------------------SSS------------------------------------SS-?Q----------####-##--------
----------S-----##-----#-#-----TT-------SSSSSSSS---TT----XX------------------------------S---------------------%%%%--%%%-------------######-##--SC----
---------------###---#-#-#-#---TT-------SSSSSSSS---TT-------------------------------------------#---------------||----||-------------######-##--------
--------------####---#-#-#-#---TT-------SSSSSSSS---TT-------------------------------------------#---------*-----||----||-------y-----######-##---SSS--
-M-----------#####---#-#-#-#-EgTT-------SSSSSSSS---TT--------y----------------------------------#---gg----*---o-||----||---SSSSS-----######-##--------
XXXXXXXXXXXXXXXXXXXXXXXXXXXXXXXXXXXXXX--XXXXXXXXXXXXXXXXXXXXXXXXXXXXXXX----XXXXX----------XXXXXXXXXXXXXXXXXXX-%-||----||-------XX-XXXXXXXXXXXX------XX
XXXXXXXXXXXXXXXXXXXXXXXXXXXXXXXXXXXXXX--XXXXXXXXXXXXXXXXXXXXXXXXXXXXXXX----XXXXX----------XXXXXXXXXXXXXXXXXXX---||----||-------XX-XXXXXXXXXXXX------XX
