------------------------------------------------------------------------------------------------------------------------------------------------------
------------------------------------------------------------------------------------------------------------------------------------------------------
------------------------------------------------------------------------------------------------------------------------------------------------------
--------------------------------------------------------------------------------ooo-------SSSSSSSSSS--------------------------------------------------
--------------------------------------------------?-----------------------------%%%-------------------------------------------------------------------
--------------------------------------------------------------g------------------|------------------oo------------------------------------------------
--------------------------------------------------------------SSSSS--------------|------------------%%%---------------US--SSC---------------SSS-------
--------------------------------------------------SS-----------------------------|------------------||--o----R----------------------------------------
---------------------------------------------------------------------------------|------------------||-%%%--------------------------------------------
-------------------------------------------------------------------------1-------|---%%%%-----------||--|-----------E-----SSS--------------------SSSSS
----------Q---------------------QQQQ----------------------------------T----------|----||------------||--|----------TT----------------------#----------
-------------------------------------K-B---------------SSS------------T----TT---%%%%%%||--t---------||-o|----------TT--t------------------##----------
---------------------------------------b----------------------TT-----tT----TT----||||-||--t---------||%%%%%--------TT--t-----------------###SSS-------
-M-----------------#-------------------b-------y--------------TT-----tT---kTT----||||-||--t---------||-|||------g--TT--t---------#---y--####-------r--
XXXXXXXXXXXXX--XXXXXXXXXX--XXXXXXXXXXXXXXXXXXXXXXX----------XXXXXXXXXXXXXXXXXXXX-||||-||%%XXXXXXXXXX||-|||----XXXXXXXXXXX----XXXXXXXXXXXXXXX-----XXXXX
XXXXXXXXXXXXX--XXXXXXXXXX--XXXXXXXXXXXXXXXXXXXXXXX----------XXXXXXXXXXXXXXXXXXXX-||||-||-|XXXXXXXXXX||-|||----XXXXXXXXXXX----XXXXXXXXXXXXXXX-----XXXXX
