------------------------------------------------------------------------------------------------------------------------------------------------------
------------------------------------------------------------------------------------------------------------------------------------------------------
------------------------------------------------------------------------------------------------------------------------------------------------------
----------------------------------------------------------------------------------------------------------------------------------SSSSSSSSSS----------
------------------------------------------------------------------------------------------------------------------------------------------------------
--------------------------------------oo--------------------------------------------------------------------------------------------------------------
---------------------LSSS----------SSSS-----------------------------------------------------------------------------------SSC-------------------------
------------------------------------------------------------------------------------------------------------------------------------------------------
---------------------------------------------------------------------o------------TT------------------------------------------------------------------
-----------------------------------------------------------------y----------------TT--------------------------------------SSS-------------------------
--------SU-----------2-----#--%---------------tt-----------------##---------------TT------------------%%%%%%------------------------------------------
-----------------K---------#------------------tt----K-----------###---------------TT-----T-------------||||----#--------------------------TT----------
------------B--------------##-----------------tt---------------####-------------T-TT-----T-------------||||----#-------------------tt-----TT-------F--
--M---------b---------kk---##------------g----tt-----------g--#####-------------T-TT---k-T---------g---||||----#----ggg----------#-tt----kTT-------#--
XXXXXXXXXXXXXXXXXXXXXXXXXXXXXX--%%%%--%%XXXXXXXXXXXXXXXXXXXXXXXXXXX---X----XXXXXXXXXXXXXXX-XXXXXXXXX%%-||||-%%-XXXXXXXXXX----XXXXXXXXXXXXXXXXXXXXXXXXX
XXXXXXXXXXXXXXXXXXXXXXXXXXXXXX---||----|XXXXXXXXXXXXXXXXXXXXXXXXXXX---X----XXXXXXXXXXXXXXX-XXXXXXXXX|--||||--|-XXXXXXXXXX----XXXXXXXXXXXXXXXXXXXXXXXXX
