------------------------------------------------------------------------------------------------------------------------------------------------------
------------------------------------------------------------------------------------------------------------------------------------------------------
------------------------------------------------------------------------------------------------------------------------------------------------------
--------------------------------------------------------------------------------SSSSSSSSSS------------------------------------------------------------
------------------------------------------------------------------------------------------------------------------------------------------------------
---------------------------------------------------------------------R----------------------oo--------------------------------------------------------
---------------------LSSS---------------------------------------------------SSSS----------------------------------------------------------------------
------------------------------------------------------------------------------------------------------------------------------------------------------
---------------------------------------------------------B-----------------------------------------%--------------------------------------------------
---------------------------------------------------------b-------------------K---------S--------------------------------------------------------------
---------Q------!----2-----#---------------------------SS#CS-----%%%-------SSSSSSU--------SS----------------------------------------------------------
---------------------------#--------------------------------------|---T-------------TT---t-------------------------------------------TT---------------
---------------------------##------------------------------K------|---T-------------TT---t---%%%%---------*--------------------------TT------------F--
----------------------kk---##-----k-k-------y-y-------------------|---T------------kTT--kt----||----gg----*----k----kkk--k----ggg----TT------------#--
XXXXXXXXXXXXXXXXXXXXXXXXXXXXXXXXXXXXXXX-XXXXXXXXXXXXXXXXXXXX%%%%%-|---XXXXXXXXXXXXXXXXXXXX----||----XXXXXXXXX-XXXXXXXXXXXXXXXXXXXXXXXXXXXXXXXXXXXXXXXX
XXXXXXXXXXXXXXXXXXXXXXXXXXXXXXXXXXXXXXX-XXXXXXXXXXXXXXXXXXXX-|||--|---XXXXXXXXXXXXXXXXXXXX----||----XXXXXXXXX-XXXXXXXXXXXXXXXXXXXXXXXXXXXXXXXXXXXXXXXX
