------------------------------------------------------------------------------------------------------------------------------------------------------
------------------------------------------------------------------------------------------------------------------------------------------------------
------------------------------------------------------------------------------------------------------------------------------------------------------
--------------------------------------------------------------------------------ooo-----------------------------------------------SSSSSSSSSS----------
--------------------------------------------------------------------------------%%%-------------------------------------------------------------------
--------------------------------------------------------------g------------------|--------------------------------------------------------------------
----------------------------------------------QQQQ------------SSSSS--------g-----|---------------------------------oo-----SSC-------------------------
--------------------------------o----ooo-------------------------------%%%%%%----|------------------oo------------------------------------------------
------------------------------------------------------------------------||||-----|--------------------------------------------------------------------
------------------------------------------------k-----------------------||||-----|---%%%%---------------------------------SSS-------------------------
-----SSS--------%%%%------------------%%T-----?QQQ----------------------||||-----|----||---------------------T-%%%%--%%%----------------------#LSS----
-----------------||--------------------|T-----------K-------------------||||----%%%%%%||---------------------T--||----||------------------TT--#-------
-----------------||--------------------|T---------------------TT-----t--||||-----||||-||---------B-----------T--||----||-----------tt-----TT--#-------
-----------------||------ggg---%%%%%%%-|T------------------g--TT-----t--||||-----||||-||---------b--------y--To-||----||---------#-tt----kTTkk#-------
XXXXXXXXXXX--%%%%||%XXXXXXXXXX--|||||--|XXXXXXXXXXXXXXXXXXXXXXXXXXXXXX--||||-----||||-||%%XXXXXXXXXXXXXXXXXXXX%-||----||X----XXXXXXXXXXXXXXXXXXXXXX---
XXXXXXXXXXX---||-||-XXXXXXXXXX--|||||--|XXXXXXXXXXXXXXXXXXXXXXXXXXXXXX--||||-----||||-||-|XXXXXXXXXXXXXXXXXXXX--||----||X----XXXXXXXXXXXXXXXXXXXXXX---
