------------------------------------------------------------------------------------------------------------------------------------------------------
------------------------------------------------------------------------------------------------------------------------------------------------------
------------------------------------------------------------------------------------------------------------------------------------------------------
S-----SSSS------------------------------------------------------------------------------------------SSSSSSSSSS----------SSSSSSSSSS--------------------
S-------------------------------------------?---------------------------------------------------------------------------------------------------------
S-------------------------------------------------------------------------------K---------------------------------------------------------------------
S-------------------------------------------------------------USSS--------------SS----1---------------------------------------------------------------
S---------------------------------------------r-------------------------------------------------------------------------------------------------------
S-----------------------------------------%%%%%%------------------------------------------------------------------------------------------------------
S------------------------------------------||||--------------------------------------------o----------------------------------------------------------
S-------------------SS----------QQQQ----%%-||||ooo----S------S-----TT-----------SS---------------TT--------TT-----------------------------------------
S--------------------K---TT----------K-B|--||||--rTT---------------TT-----------------TT---------TT-----#--TT-------------SS--------------------------
S------------------------TT------------b|%%%%%%%%%TT---------------TT-----------------TT---------TT----##--TT-------------SS-----------------------F--
S---------k---ggg--------TT------------b|-||||||||TT------k--ggg---TT-----------------TT---------TT-kk-##--TT--k----kkk---SS-----------------------#--
XXXXXXXXXXXXXXXXXXXXXXXXXXXXXXXXXXXXXXXX|-||||||||XXXXXXXXXXXXXXXXXXXXX----XXXXXXXXXXXXXXXXXXXXXXXXXXXXXX--XX-XXXXXXXXXX--XX--XXXXXXXXXXXXXXXXXXXXXXXX
XXXXXXXXXXXXXXXXXXXXXXXXXXXXXXXXXXXXXXXX|-||||||||XXXXXXXXXXXXXXXXXXXXX----XXXXXXXXXXXXXXXXXXXXXXXXXXXXXX--XX-XXXXXXXXXX--XX--XXXXXXXXXXXXXXXXXXXXXXXX
