------------------------------------------------------------------------------------------------------------------------------------------------------
------------------------------------------------------------------------------------------------------------------------------------------------------
------------------------------------------------------------------------------------------------------------------------------------------------------
----------------------------------------------------------------------SSSSSSSSSS--------------------SSSSSSSSSS----------SSS-----SS--------------------
--------------------------------------------------?-------------------------SSSS----------------------------------------------------------------------
----------------------ooor--------------%%-------------------------------g--SSSS--g-------------------------------------------------------------k-----
------------------Q--%%%%%--------------|-------------------------------SS------SSSSSSSS--------------------------------US--------!S-----------SQS--SQ
----------------------|||-------o----ooo|----oo---SS--------------------SS--------------------------------------oooo----------------------------------
----------------------|||---------------|-------------------------------SS--------------------------------------------------SSS-----------------------
----------------------|||---------------|-----------------------1-------SC--g-g-----------------------------------------------------------------------
------------------?-%%%%%%%-----------%%|-------------------------------SS--SSSS-----------------tt----------TT---------SSS-------S------#-----SQS--S?
--------------TT----||||||-------------||--------------SSS--------------------------------T------tt----TT----TT-------------------------##------------
--------------TT----||||||--o----------||-------------------------------------------------T------tt----TT----TT------------------------###------------
--------------TT----||||||-%%%-%%%%%%%-||-------------------------------------------------T------tt-g--TT----TT---y-------------------####---k------gg
XXXXXXXXXXXXXXXXXXXX||||||--|---|||||--||----%%%%-----------XXXXXXXXX-XXXXXXXXXXXXXXXX---XXXXXXXXXXXXXXXXXXXXXXXXXXXXXXXXXX------XXXXXXXXXXXXXXXXXXXXX
XXXXXXXXXXXXXXXXXXXX||||||--|---|||||--||-----||------------XXXXXXXXX-XXXXXXXXXXXXXXXX---XXXXXXXXXXXXXXXXXXXXXXXXXXXXXXXXXX------XXXXXXXXXXXXXXXXXXXXX
