------------------------------------------------------------------------------------------------------------------------------------------------------
------------------------------------------------------------------------------------------------------------------------------------------------------
------------------------------------------------------------------------------------------------------------------------------------------------------
----------------------------------------SSSSSSSSSS----------------------------------------------------------------------------------------------------
----------------------------------------SSSSSSSS--?---------------------------------------------------------------------------------------------------
----------------------ooor--------------SSSCSSSS------------------------------------------------------------------------------------------------------
---------------------%%%%%--------------SSSSSSSS---------------------------g--------------SSS------%------------------US-----------------##-----------
----------------------|||-------------------------SS-------------------%%%%%%------------------------------------------------------------##-----------
----------------------|||-----------------------------------------------||||--------------------------------------------------SSS------####-----------
------------Q--?------|||------------------ggg--------------------------||||------o---------------------------------E------------------####-----------
-----SSS-----------S%%%%%%%----TT-------SSSSSSSS---------------------T--||||-----------TT---%%%--------------------TT---%------------######-#---------
--------------------||||||-----TT-------SSSSSSSS-------SSS-----------T--||||-----------TT----|---------------------TT--t-------------######-##--------
--------------------||||||--o--TT-------SSSSSSSS---------------------T--||||-----------TT----|------------*--------TT--t-------------######-###------#
------------------K-||||||-%%%gTT-------SSSSSSSS--------------ggg----T--||||-----------TT----|------gg----*-----g--TT--t---------r---######-####----##
XXXXXXXXXXXXXXXXXXXX||||||--|-XXXXXXXX--XXXXXXXXXX----------XXXXXXXXXX--||||----XXXXXXXXXX---|------XXXXXXXXX-XXXXXXXXXX----XXXXXXXXXXXXXXXXXXXXXXXXXX
XXXXXXXXXXXXXXXXXXXX||||||--|-XXXXXXXX--XXXXXXXXXX----------XXXXXXXXXX--||||----XXXXXXXXXX---|------XXXXXXXXX-XXXXXXXXXX----XXXXXXXXXXXXXXXXXXXXXXXXXX
