------------------------------------------------------------------------------------------------------------------------------------------------------
------------------------------------------------------------------------------------------------------------------------------------------------------
------------------------------------------------------------------------------------------------------------------------------------------------------
------------------------------------------------------------------------------------------SSSSSSSSSS--------------------------------------------------
-------------------------------------------------------------------------o----------------------------------------------------------------------------
-----------------------SSS----------------------------------------------%%%---------------------------------------------------------------------------
-------------------------------------------------------------------------|--o--------------------------------@-----oo----------SSS--------------------
---------------------g---------------------------------------------------|--SSSS--------------------------------------------------oo------------------
--------------------%%%-----------------------------------------------%--|----------------------------------------------------------------------------
--------------------||----SSS--------------------------------------------|--------o---------------------------------------------K---------------------
--------------------||-------------------TT---SU------S--------------#---|-------------TT-----------SU----!--!-%%%%--%%%-------SSS---------Q#---------
--------------------||-------------------TT-------TT----------------##---|-------------TT-----------------------||----||--------------------##--------
--------------------||-------------------TT-------TT--------TT-----###---|-----%-------TT-----------------------||----||-TT-----------------###------#
-M--------k---ggg---||----oo------k-k----TT------kTT------k-TT----####---|-------------TT-------g-g-------k---o-||----||-TT-----------------####----##
XXXXXXXXXXXXXXXXXXXX||---%%%--XXXXXXXXX-XXXXXXXXXXXXXXXXXXXXXXXXXXXXXX%%%%%%----XXXXXXXXXXXXXXXXXXXXXXXXXXXXXX%-||----||XXXXXXXXXXXXXXXXXXXXXXXXXXXXXX
XXXXXXXXXXXXXXXXXXXX||----|---XXXXXXXXX-XXXXXXXXXXXXXXXXXXXXXXXXXXXXXX|||||-----XXXXXXXXXXXXXXXXXXXXXXXXXXXXXX--||----||XXXXXXXXXXXXXXXXXXXXXXXXXXXXXX
