------------------------------------------------------------------------------------------------------------------------------------------------------
------------------------------------------------------------------------------------------------------------------------------------------------------
------------------------------------------------------------------------------------------------------------------------------------------------------
--------------------------------------------------------------------------------SSSSSSSSSL------------------------------------------------------------
--------------------------------------------?---------------------------------------------------------------------------------------------------------
------------------------------------------------------------------------------------------------------------------------------------------------------
-----------------------------U------------------------------------SSoo----SSCSS-----oooooo-------------------R-----oo--------------SSSS---------------
----------------------------------------------r------------------------------------------------------r------------------------------------------------
------------------------------------------%%%%%%------------------------------------SSSSSS----------%%%%%%%-------------------------------------------
------------Q--?---------------------------||||-------------------------------------SSSSSS-o--------||||||-----------------------------SSSS-----------
-----SSS-----------S--------##----------%%-||||ooo----S-----%%%%%%------QQQQ--QQ-----------------TT-||||||-----%%%%--%%%------------------------------
-----------------------y-#####---------T|--||||--rTT---------||||--------------------------------TT-||||||------||----||---------------------------#--
--------------------y-######-----------T|%%%%%%%%%TT---------||||--------------------------------TT-||||||------||----||-----------------------K---#--
------------------K-######-----------kkT|-||||||||TT------k--||||--------------------------------TT-||||||--ooo-||----||--kkk----------------------#--
XXXXXXXXXXXXXXXXXXXXXXXX------XXXXXXXXXX|-||||||||XXXXXXXXXX-||||-----XXXXXXXXXX---XXXXXXXXXXXXXXXXX||||||--%%%-||----||XXXXXXXXXX---------XXXXXX--XXX
XXXXXXXXXXXXXXXXXXXXXXXX------XXXXXXXXXX|-||||||||XXXXXXXXXX-||||-----XXXXXXXXXX---XXXXXXXXXXXXXXXXX||||||---|--||----||XXXXXXXXXX---------XXXXXX--XXX
