------------------------------------------------------------------------------------------------------------------------------------------------------
------------------------------------------------------------------------------------------------------------------------------------------------------
------------------------------------------------------------------------------------------------------------------------------------------------------
----------SSSSSSSSSSSSSSSSSSSS--oo------------------------------------------------------------------SSSSSSSSSS----------------------------------------
---------------------------------------g-------------------------------------------------------------------------------------------------------------o
-----------------------------------%%%%%--------------------------------------------------------------------------------------------------------------
------------------------------------||||---------------------------------------------1-----------------------------------SSS----S!--------------------
------------------------------------||||-------------------------------------------------------------------------SSS----------------------------SSS---
------------------------------------||||----------------------------------------------------------------------------------------------------oo--------
-----------------------------C%%%%%-||||------------------------1-------------------------------------------------------------------------------------
----------@QQQQ--------#-#-----|||--||||---------------ooo-------------------------QQQQ----------tt----------T-------------------S---------#SS--------
---------------------#-#-#-#---|||--||||--------------------------------------------------T------tt----TT----T----------------------------##----------
-----------------g-#-#-#-#-#---|||--||||--------------------------------------------------T------tt----TT----T---------------------------###----------
-M--------------g#-#-#-#-#-#-E-|||--||||------------------------------gg------------yy----T------tt-g--TT----T--------------gg-g-g---y--####----------
XXXXXXXXXXXXXXXXXXXXXXXXXXXXXX-|||--||||X-XX-XX-XX--XXXXXXXXXXXXXXXXX-XXXXXXXXXXXXXXXXXXXXXXXXXXXXXXXXXXXXXXXX%%%%----%%XXXXXXXXXXXXXXXXXXXX----------
XXXXXXXXXXXXXXXXXXXXXXXXXXXXXX-|||--||||X-XX-XX-XX--XXXXXXXXXXXXXXXXX-XXXXXXXXXXXXXXXXXXXXXXXXXXXXXXXXXXXXXXXX|||------|XXXXXXXXXXXXXXXXXXXX----------
