------------------------------------------------------------------------------------------------------------------------------------------------------
------------------------------------------------------------------------------------------------------------------------------------------------------
------------------------------------------------------------------------------------------------------------------------------------------------------
----------------------------------------SSSSSSSSSS----------------------------------------SSSSSSSSSS------------------------------SSSSSSSS------------
------------------------------------------------------------------------------------------------------------------------------------------------------
------------------------------------------------------------------------------------------------------------------------------------------------------
-----------------------------U-----------oooo-----Q----------------------------------SUS----------------------?SSS------------------------------------
-------------------------------------------------------------o---o---o--------------------------------------------------------------------------------
-----------------%%%---------------------SSSS-U-------------%%%-%%%-%%o-------------------------------------------------------SSS---------------------
------------------||--------------------oS--SoS--------------|---|---|--------------------------------------------------------------------------------
------------------||--------##----------SS--SSS---Q----------|---|---|--------------#####---------------------SSSSS-----%--------------g##--#---------
-------------%%%%%||---y-#####--------tt---------------------|---|---|--------#-----#-----------------TT-------------------------------###--##--------
--------------|||-||y-######----------tt---------------------|---|---|-------##----K#-----------------TT----TT-----------------------g####--###------#
-M------------|||-||######------------tt--kk---------gg----k-|---|-r-|--------------#-----------g-g---TT-k--TT--K----------------r---#####--####----##
XXXXXXXXXXX---|||-||XXXX------XXXXXXXXXXXXXXXXXXXXXXXXXXXXXX%%%%%%%%%%XXXXXXXXXXXXXXXXX---XXXXXXXXXXXXXXXXXXXXXXXXXXXXXX----XXXXXXXXXXXXXX--XXXXXXXXXX
XXXXXXXXXXX---|||-||XXXX------XXXXXXXXXXXXXXXXXXXXXXXXXXXXXX-|||||||||XXXXXXXXXXXXXXXXX---XXXXXXXXXXXXXXXXXXXXXXXXXXXXXX----XXXXXXXXXXXXXX--XXXXXXXXXX
