------------------------------------------------------------------------------------------------------------------------------------------------------
------------------------------------------------------------------------------------------------------------------------------------------------------
------------------------------------------------------------------------------------------------------------------------------------------------------
--------------------------------oo------SSSSSSSSSSSSSSSSS---------------------------------------------------------------------------------------------
-------------------------------------g-g--------------------------------------------------------------------------------------------------------------
-----------------------------------%%%%%--------------------------------------------------------------------------------------------------------------
------------------SCUSS-------------||||-oooo-----QQ----------------------SS------------------------------------------------------!S------------------
------------------------------------||||---------------------o---o---o------------------------------------TT------------------------------------------
------------------------------------||||-SSSS-U------------S%%%-%%%-%%------------------------------------TT------------------------------------------
------------------------------%%%%%-||||oS--SoS--------------|---|---|------------o---------------oo------TT-------------------SSS--------------------
--------------TT---2-----------|||--||||SS--SSS---QQ--QQQ----|---|---|SS-----SS--------TT----------------SXXS---------r-%---------S------#------------
--------------TT-----B---------|||--||||---------------------|---|---|-----------------TT------TT-----------------%%%%%%----------------##---------#--
--------------TT-----b-------B-|||--||||---------------------|---|---|-----------------TT------TT---TT-------------|||||---------------###-----K---#--
-M------------TT-----B-------b-|||--||||--kk-----------------|---|-r-|-----------------TT---y--TT---TT-------------|||||---------r----####---------#--
XXXXXXXXXXXXXXXXXXXXXXXXXXXXXX-|||--||||XXXXXXXXXXXXXXXXX---%%%%%%%%%%----------XXXXXXXXXXXXXXXXXXXXXXXXXXXXXX-%%%-|||||----XXXXXXXXXXXXXXXXXXXXX--XXX
XXXXXXXXXXXXXXXXXXXXXXXXXXXXXX-|||--||||XXXXXXXXXXXXXXXXX----|||||||||----------XXXXXXXXXXXXXXXXXXXXXXXXXXXXXX--|--|||||----XXXXXXXXXXXXXXXXXXXXX--XXX
