------------------------------------------------------------------------------------------------------------------------------------------------------
------------------------------------------------------------------------------------------------------------------------------------------------------
------------------------------------------------------------------------------------------------------------------------------------------------------
--------------------------------------------------------------------------------------------------------------SSSSSSSSSSSSS-----SS--------------------
------------------------------------------------------------------------------------------------------------------------------------------------------
----------------------------------------------------------------------------------------oo--oo--------------------------------------------------k-----
--------------------------------------------------------------------------SS----oo--------------------------------------US---------------------SQS--SQ
-------------------------------------------------------------o---o---o--------------------------------------------------------------------------------
---------------------------------------------------------B--%%%-%%%-%%-----------------------------%------------------------SSS-----------------------
---------------------------------------------------------b---|---|---|-----------SS-------------------------------------------------------------------
-------------------%-------------------T------tt-------SS#CS-|---|---|SS-----SS----------SSS------------------T---------SSS----------------#---SQS--S?
---------------------------------------T------tt-------------|---|---|--------------------------------------g-T---------------------------##----------
---------------------------------------T------tt-----------K-|---|---|-----------------------%%%%-----------TTT----TT--------------------###----------
-M-----------%%%%--------ggg----gg-----T-g----tt-------------|---|-r-|------------------------||------------TTT--g-TT----------------y--####-k------gg
XXXXXXXXXXX---||----XXXXXXXXXXXXXXXXXXXXXXXXXXXXXXXXXXXXXXXX%%%%%%%%%%------------------------||------XXXXXXXXXXXXXXXXXXXXX------XXXXXXXXXXXXXXXXXXXXX
XXXXXXXXXXX---||----XXXXXXXXXXXXXXXXXXXXXXXXXXXXXXXXXXXXXXXX-|||||||||------------------------||------XXXXXXXXXXXXXXXXXXXXX------XXXXXXXXXXXXXXXXXXXXX
