------------------------------------------------------------------------------------------------------------------------------------------------------
------------------------------------------------------------------------------------------------------------------------------------------------------
------------------------------------------------------------------------------------------------------------------------------------------------------
--------------------------------------------------------------------------------SSSSSSSSSL--------------------SS-------S------------------------------
------------------------------------------------------------------------------------------------------------------------------------------------------
------------------------------------------------------------------------------------------------------------------------------------------------------
------------------Q-S-------------------------------------------------------SSSS----oooooo--------------SSQSSS---------S-------SSS!S---------QQQQ-----
---------------------------TT-------------------------------------------------------------------------------------------------------------------------
---------------------------TT-------------------------------------------------------SSSSSS-------------------------SSS--------------------------------
---------------------------XX-----------------------------------1------------K------SSSSSS-----oooo-------K---------------------K--------------y------
------------------?----TT------------------------------ooo-----------------SSSSS------------------------SSSSSS---------S-------SSSS------#--Q?SSQQQ---
--------------TT-------TT--------------T-----K---B--------------------T----------------------------------------##-----------------------##------------
--------------TT-------TT--------------T---------b--------------------T----------------------------------------##--------TT------------###------------
---M----------TT----k--TT------------kkT---------B--------------------T----------------------------------------##--------TT-----------####------------
XXXXXXXXXXXXXXXXXXXXXXXXXXXXXXXXXXXXXXXXXXXXXXXXXX--XXXXXXXXXXXXXXXXX-XXXXXXXXXX---XXXXXXX%%%%%%%-%%XXXXXXXXXX-XX------XXXXXXXXXXXXXXXXXXXXXXX--XXXXXX
XXXXXXXXXXXXXXXXXXXXXXXXXXXXXXXXXXXXXXXXXXXXXXXXXX--XXXXXXXXXXXXXXXXX-XXXXXXXXXX---XXXXXXX||||||---|XXXXXXXXXX-XX------XXXXXXXXXXXXXXXXXXXXXXX--XXXXXX
