------------------------------------------------------------------------------------------------------------------------------------------------------
------------------------------------------------------------------------------------------------------------------------------------------------------
------------------------------------------------------------------------------------------------------------------------------------------------------
--------------------------------oo-----------------oo---------------------------SSSSSSSSSS------------------------------------------------------------
---------------------------------------g----------%%%%------------------------------------------------------------------------------------------------
-----------------------------------%%%%%-----------||-------------------------------------------------------------------------------------------------
---------------------LSSS-----------||||-----------||-------------------------------------------------------------------------------------------------
------------------------------------||||-----------||--SSS------------------------------------------------TT------------------------------------------
------------------------------------||||-----------||-----------------------------------------------------TT-----------------SSS----------------------
------------------------------%%%%%-||||-----------||----------------------------------S------------------TT------------------------------------------
---------Q---------%-2-----#---|||--||||-----------||----------------#----------SU---------------tt------SXXS-----------r-----------------------------
---------------------------#---|||--||||-----------||---------------##--------------TT---tT------tt---------------------%%%%%%---------------------#--
---------------------------##--|||--||||----------%||-------TT-----###--------------TT---tT------tt-TT-------------B----|||||------------------K---#--
-M-----------%%%%-----kk---##--|||--||||-------y---||-------TT----####gg-----------kTT--ktT------tt-TT-------------b----|||||----------------------#--
XXXXXXXXXXX---||----XXXXXXXXXX-|||--||||XXXXXXXXXX-||-------XXXXXXXXXXXXXXXXXXXXXXXXXXXXXXXXXXXXXXXXXXXXXXXXXXXXXXXXXXXX|||||-----XXXXXXXXXXXXXXX--XXX
XXXXXXXXXXX---||----XXXXXXXXXX-|||--||||XXXXXXXXXX-||-------XXXXXXXXXXXXXXXXXXXXXXXXXXXXXXXXXXXXXXXXXXXXXXXXXXXXXXXXXXXX|||||-----XXXXXXXXXXXXXXX--XXX
