------------------------------------------------------------------------------------------------------------------------------------------------------
------------------------------------------------------------------------------------------------------------------------------------------------------
------------------------------------------------------------------------------------------------------------------------------------------------------
--------------------------------oo--------------------------------------------------------------------------------------------------------------------
---------------------------------------g--------------------------------------------------------------------------------------------------------------
-----------------------------------%%%%%---------------------------------------------------------------------------k----------------------------------
--------------------USS-------------||||--------------------------SSoo--------------y-------------------------S---SSSSSS-SSS----S!--------------------
------------------------------------||||------------------------------------------#SSS------------oo--------------------------------------------------
------------------------------------||||-----------------B-----------------------##-------------------------------------------------------------------
------------------------------%%%%%-||||-----------------b----------------------###1------------------------------------------------------------------
----------------%%%%-----------|||--||||---------------SS#CS%%%%%%--------------###-------------------%%%%%%---------------------S---------#----------
-----------------||--B---------|||--||||---------------------||||---------------###--SSS--------#------||||-------------------------------##----------
-----------------||--b-------B-|||--||||-------------------K-||||---------------###-------------#------||||---TT-------------------------###-------F--
-M---------------||--B-------b-|||--||||----y-y--------------||||-----gg--------###-------------#------||||---TT------------gg-g-g---y--####-------#--
XXXXXXXXXXX--%%%%||%XXXXXXXXXX-|||--||||XXXXXXXXXXXXXXXXXXXX-||||-----XXXXXXXXXXXXXXXX---XXXXXXXXXXX%%-||||-%%XXXXXXXX--XXXXXXXXXXXXXXXXXXXXXXXXXXXXXX
XXXXXXXXXXX---||-||-XXXXXXXXXX-|||--||||XXXXXXXXXXXXXXXXXXXX-||||-----XXXXXXXXXXXXXXXX---XXXXXXXXXXX|--||||--|XXXXXXXX--XXXXXXXXXXXXXXXXXXXXXXXXXXXXXX
