------------------------------------------------------------------------------------------------------------------------------------------------------
------------------------------------------------------------------------------------------------------------------------------------------------------
------------------------------------------------------------------------------------------------------------------------------------------------------
------------------------------SSSSSSSSSS------------------------------------------------------------SSSSSSSSSS----------------------------------------
------------------------------SSSSSSSSSS--------------------------------------------------------------------------------------------------------------
------------------------------SSSSSSSSSS----------------------------------------------------oo--------------------------------------------------------
------------------Q-USS-------SSSSSSSSSS-----------------------------------g---------SUS---------------------------oo---------------------------------
-------------------------------------------------------------o---o---o-%%%%%%------------------------------------------------------------------y------
------------------------------------------------------------%%%-%%%-%%--||||-----------------------%---------------------------------g#------#SS--o---
-------------------------------------------------------------|---|---|--||||---------------------------------------------------SSS--g##-----##--------
------------------?-----------SSSSSSSSSS---------------ooo---|---|---|--||||--------#####-SS---------------TT--%%%%--%%%%-----------###-----##--SC----
--------------TT-----B--------SSSSSSSSSS---------------------|---|---|--||||--------#-------------------#--TT---||----||-----------####-----##--------
--------------TT-----b-------BSSSSSSSSSS---------------------|---|---|--||||-------K#--------%%%%------##--TT---||----||----------#####-----##---SSS--
-M------------TT-----B-------bSSSSSSSSSS-------y-------------|---|-r-|--||||--------#---------||----kk-##--TT-o-||----||---------r#####-----##--------
XXXXXXXXXXXXXXXXXXXXXXXXXXXXXXXXXXXXXXXXXXXXXXXXXX--XXXXXXXX%%%%%%%%%%--||||----XXXXXXX-------||----XXXXX--XX-%-||----||----XXXXXXXXXXX--XXXXX------XX
XXXXXXXXXXXXXXXXXXXXXXXXXXXXXXXXXXXXXXXXXXXXXXXXXX--XXXXXXXX-|||||||||--||||----XXXXXXX-------||----XXXXX--XX---||----||----XXXXXXXXXXX--XXXXX------XX
