------------------------------------------------------------------------------------------------------------------------------------------------------
------------------------------------------------------------------------------------------------------------------------------------------------------
------------------------------------------------------------------------------------------------------------------------------------------------------
--------------------------------oo------------------------------------------------------------------SSSSSSSSSS----------SSSSSSSSSS--------------------
---------------------------------------g--------------------------------------------------------------------------------------------------------------
-----------------------------------%%%%%--------------------------------------------------------------------------------------------------------------
-----------------------------U------||||---------------------------------------------SSSS----------------------------------------------------------SSS
------------------------------------||||------------------------------------------------------------------------oooo----------------------------------
------------------------------------||||---------------------------------------------------------------------------------------------g#---------------
------------Q--?--------------%%%%%-||||--------------------------------------------------------------------------------------------g##---------------
-------------------S--------##-|||--||||------tt---------------------#----------Q----------------------------TT---------------------###-----------#---
-----------------------y-#####-|||--||||------tt----K---------------##---------------------------------TT----TT-----------SS-------####-----------#---
--------------------y-######---|||--||||------tt------------TT-----###---------------------------B-----TT----TT-----------SS------#####-----------#---
---M--------------K-######-----|||--||||-g----tt-----------gTT----####gg---------ggg-------------b--g--TT----TT---y-------SS------#####------ggg--#---
XXXXXXXXXXXXXXXXXXXXXXXX-------|||--||||XXXXXXXXXXXXXXXXXXXXXXXXXXXXXXXXXXXXXXXXXXXXX----XXXXXXXXXXXXXXXXXXXXXXXXXXXXXXX--XX--XXXXXXXXX--XXXXXXXXXXXXX
XXXXXXXXXXXXXXXXXXXXXXXX-------|||--||||XXXXXXXXXXXXXXXXXXXXXXXXXXXXXXXXXXXXXXXXXXXXX----XXXXXXXXXXXXXXXXXXXXXXXXXXXXXXX--XX--XXXXXXXXX--XXXXXXXXXXXXX
