------------------------------------------------------------------------------------------------------------------------------------------------------
------------------------------------------------------------------------------------------------------------------------------------------------------
------------------------------------------------------------------------------------------------------------------------------------------------------
--------------------------------------------------SSSSSSSSSS------------------------------------------------------------------------------------U-----
------------------------------------------------------SS--SS------------------------------------------------------------------------------------------
------------------------------------------------------SS--SS---------R------------------------------oo------------------------------------------------
--------------------USS-----------------------------SS--------------------SS---------SSSS-----------%%%----------------------------SSSS---------------
--------------------------------o----ooo------------SS----------------------------------------------||--o----R------------------------------------SS--
----------------------------------------------------SS----------------------------------------------||-%%%-------------y------------------------------
----------------------------------------------------SS----oo-----------------------------------oooo-||--|--------------X---------------SSSS---SS------
--------SU------!---------------------%%------------SSSS--SS-----%%%--SS-----SS-Q-------------------||--|-------------XX-----------------------------#
---------------------B-----------------|--------------SS----------|---------------------------------||-o|------------XXX----------------------------##
---------------------b-------B---------|--------------SS----------|---------------------------------||%%%%%---------XXXX---------------------------###
--M------------------B-------b-%%%%%%%-|-------ggg----------------|--------------ggg----------------||-|||---------XXXXX-k----ggg-----------------####
XXXXXXXXXXXXXXXXXXXXXXXXXXXXXX--|||||--|-XXXXXXXXXXXXXXXXXXX%%%%%-|-------------XXXXX----X%%%%%%%-%%||-|||----XXXXXXXXXXXXXXXXXXXX---------XXXXXX-XXXX
XXXXXXXXXXXXXXXXXXXXXXXXXXXXXX--|||||--|-XXXXXXXXXXXXXXXXXXX-|||--|-------------XXXXX----X||||||---|||-|||----XXXXXXXXXXXXXXXXXXXX---------XXXXXX-XXXX
