------------------------------------------------------------------------------------------------------------------------------------------------------
------------------------------------------------------------------------------------------------------------------------------------------------------
------------------------------------------------------------------------------------------------------------------------------------------------------
----------SSSSSSSSSS----------------------------------------------------------------------------------------------------SSSSSSSSSS--------------------
------------------------------------------------------------------------------------------------------------------------------------------------------
----------------------ooor------------ooooooo----------oooo-------------------------------------------------------------------------------------------
---------------------%%%%%---------SSSS----------------%%%%------------------------USS-----------------------------oo--------------------##-----------
----------------------|||-----------------------SS------||----------------------------------------oo-------------------------------------##-----------
----------------------|||----------------SSSS-----------||---------------------g-------------------------------------------------------####-----------
----------------------|||-------------------------SSS---||------1----------------------------------------------------------------------####-----------
----------@QQQQ-----%%%%%%%---%-------------------------||-------------------S@S--#----------------------------%%%%--%%%-------------######-#---------
--------------------||||||----------------------------U-||------------------------#-------------#---------------||----||--SS---------######-##--------
-----------------g-#||||||--o---------------%%%%%-------||------------------------##------------#---------*-----||----||--SS---------######-###------#
-M--------------g#-#||||||-%%%---------------|||--------||------------------------##--gg--------#---gg----*---o-||----||--SS---------######-####----##
XXXXXXXXXXXXXXXXXXXX||||||--|---%%%%--%%%%---|||------%%%%%-XXXXXXXXX--XXXXXXXXX--XXXXXXXXXXXXXXXXXXXXXXXXXXX-%-||----||--XX--XXXXXXXXXXXXXXXXXXXXXXXX
XXXXXXXXXXXXXXXXXXXX||||||--|----||----||----|||-------|||--XXXXXXXXX--XXXXXXXXX--XXXXXXXXXXXXXXXXXXXXXXXXXXX---||----||--XX--XXXXXXXXXXXXXXXXXXXXXXXX
