------------------------------------------------------------------------------------------------------------------------------------------------------
------------------------------------------------------------------------------------------------------------------------------------------------------
------------------------------------------------------------------------------------------------------------------------------------------------------
------------------------------SSSSSSSSSS--------------------------------------------------------------------------------------------------------------
------------------------------SSSSSSSSSS-g------------------------------------------------------------------------------------------------------------
------------------------------SSSSSSSSSS%%--------------------------------------K---------------------------------------------------------------------
------------------------------SSSSSSSSSS|----------------Q-Q--------------------SS----1-----------------------------------SSC-------------------------
----------------------------------------|----oo--------------o---o---o------------------------------------TT------------------------------------------
----------------------------------------|-------------------%%%-%%%-%%------------------------------------TT-------------------------g#---------------
----------------------------------------|--------------------|---|---|------------------------------------TT--------------SSS-------g##---------------
----------------%%%%SS--------SSSSSSSSSS|----------------Q-Q-|---|---|----------SS-----------------------SXXS-----------------------###-------#LSS----
-----------------||--K---TT---SSSSSSSSSS|--------------------|---|---|----------------TT-----------------------#-------------------####-------#-------
-----------------||------TT---SSSSSSSSSS|--------------------|---|---|----------------TT------------TT---------#------------------#####-------#-------
---M-------------||------TT---SSSSSSSSSS|--------------------|---|-r-|gg--------------TT-----------gTT---------#----ggg----------######-----kk#-------
XXXXXXXXXXX--%%%%||%XXXXXXXXXXXXXXXXXXXX|----%%%%-XXXXXXXXXX%%%%%%%%%%XXXXXXXXXXXXXXXXXXXX-XXXXXXXXXXXXXXXXXXX-XXXXXXXXXX----XXXXXXXXXX--XXXXXXXXXX---
XXXXXXXXXXX---||-||-XXXXXXXXXXXXXXXXXXXX|-----||--XXXXXXXXXX-|||||||||XXXXXXXXXXXXXXXXXXXX-XXXXXXXXXXXXXXXXXXX-XXXXXXXXXX----XXXXXXXXXX--XXXXXXXXXX---
