------------------------------------------------------------------------------------------------------------------------------------------------------
------------------------------------------------------------------------------------------------------------------------------------------------------
------------------------------------------------------------------------------------------------------------------------------------------------------
------------------------------SSSSSSSSSS----------------------------------------------------------------------SSSSSSSSSSSSS-----SS--------------------
------------------------------SSSSSSSSSS--------------------------------------------------------------------------------------------------------------
-----------------------SSS----SSSSSSSSSS----------------------g---------------------------------------------------------------------------------------
------------------Q-----------SSSSSSSSSS----------------------SSSSS--------g-------o--o---------------------------------US-------------US-------------
---------------------g-------------------------------------------------%%%%%%------------------------------------------------------------------y------
--------------------%%%-------------------------------------------------||||------------------------------------------------SSS--------------#SS--o---
--------------------||----SSS----------------------------o--------------||||-------SSSS-----------oo---------------------------------SS-----##--------
------------------?-||--------SSSSSSSSSS--------------------------------||||----------------------------------T---------SSS----------------S##--SC----
--------------TT----||--------SSSSSSSSSS--------------------------------||||-------------------TT-----------g-T-----------------------------##--------
--------------TT----||--------SSSSSSSSSS----------------------TT-----t--||||----%%%------------TT-----------TTT----TT-------------TT--------##---SSS--
-M------------TT----||----oo--SSSSSSSSSS------------k---------TT-----t--||||----||----------y--TT-----------TTT--g-TT-------------TT--------##--------
XXXXXXXXXXXXXXXXXXXX||---%%%--XXXXXXXXXXX-XX-XX-XX-XXXXXXXXXXXXXXXXXXX--||||----||--------XXXXXXXXXX--XXXXXXXXXXXXXXXXXXXXX------XXXXXXX-X-XXX------XX
XXXXXXXXXXXXXXXXXXXX||----|---XXXXXXXXXXX-XX-XX-XX-XXXXXXXXXXXXXXXXXXX--||||----||--------XXXXXXXXXX--XXXXXXXXXXXXXXXXXXXXX------XXXXXXX-X-XXX------XX
