------------------------------------------------------------------------------------------------------------------------------------------------------
------------------------------------------------------------------------------------------------------------------------------------------------------
------------------------------------------------------------------------------------------------------------------------------------------------------
S-----SSSS----------SSSSSSSSSS----------------------------------------SSSSSSSSSS------------------------------SS-------S------------------------------
S-------------------SSSSSSSSSS------------------------------------------------------------------------------------------------------------------------
S-------------------SSSSSSSSSS--------oo------------------------------------------g-------------------------------------------------------------------
S-------------------SSSSSSSSSS-----SSSS------------------Q-Q--------------------SSSSSSSS-------------------------------SSS-------------------QQQQ-----
S-----------------------------------------------------------------------------TT------------------oo------TT------------------------------------------
S--------------------------------------------------------------------o--------TT--------------------------TT-------SSS--------------------------------
S----------------------------------------------------------------y------------TT--------------------------TT---------------TT------------------y------
S---------Q-----------SSSSSS?-%----------TT---SU---------Q-Q-----##---------SCTT-------------------------SXXS----------S---TT---------------Q?SSQQQ---
S---------------------SSSSS--------------TT---------------------###-----TT----TT----------------#--------------##-------t--TT-------------------------
S---------------------SSSSS--------------TT--------------------####-----TT----TT----------------#---TT---------##-------t--TT-------------------------
S--M---------------#-------ooo-----------TT------k------------#####-----TT---kTT----------------#---TT---------##-------t--TT-------------------------
XXXXXXXXXXXXX--XXXXX-XXXXXXXXX--%%%%--%%XXXXXXXXXXXXXXXXXXXXXXXXXXX---XXXXXXXXXXXXXXXX---XXXXXXXXXXXXXXXXXXXXX-XX------XXXXXXXXXXXXXXXXXXXXXXX--XXXXXX
XXXXXXXXXXXXX--XXXXX-XXXXXXXXX---||----|XXXXXXXXXXXXXXXXXXXXXXXXXXX---XXXXXXXXXXXXXXXX---XXXXXXXXXXXXXXXXXXXXX-XX------XXXXXXXXXXXXXXXXXXXXXXX--XXXXXX
