------------------------------------------------------------------------------------------------------------------------------------------------------
------------------------------------------------------------------------------------------------------------------------------------------------------
------------------------------------------------------------------------------------------------------------------------------------------------------
--------------------------------oo---------------------------------SSS--------------------------------------------------------------------------------
-------------------------------------g-g----?---------------------------------------------------------------------------------------------------------
-----------------------------------%%%%%----------------------------------------------------oo--------------------------------------------------------
--------------------USS-------------||||----------Q-------------CSS----------------USS--------------------------------US------------------------------
------------------------------------||||------r-----------------------------------------------------------TT------------------------------------------
------------------------------------||||--%%%%%%------------SS--2--------------g-------------------%------TT------------------------------------------
------------------------------%%%%%-||||---||||----------------2-2----------------------------------------TT--------E---------------------------------
--------SU---------%-----------|||--||||%%-||||oooQ---------------2----------S@S--#-------SS-------------SXXS------TT---------------------------------
---------------------B---------|||--|||||--||||--r--------------------------------#--------------------------------TT--t------------------------------
---------------------b-------B-|||--|||||%%%%%%%%%--------------------------------##---------%%%%---TT-------------TT--t---------------------------F--
--M----------%%%%----B-------b-|||--|||||-||||||||---gg----k----------------------##--gg------||----TT----------g--TT--t-k----ggg------------------#--
XXXXXXXXXXX---||----XXXXXXXXXX-|||--|||||-||||||||XXXXXXXXXX---XXXXXXX-XXXXXXXXX--XXXXXXXX----||----XXXXXXXXXXXXXXXXXXXXXXXXXXXXXXXXXXXXXXXXXXXXXXXXXX
XXXXXXXXXXX---||----XXXXXXXXXX-|||--|||||-||||||||XXXXXXXXXX---XXXXXXX-XXXXXXXXX--XXXXXXXX----||----XXXXXXXXXXXXXXXXXXXXXXXXXXXXXXXXXXXXXXXXXXXXXXXXXX
