------------------------------------------------------------------------------------------------------------------------------------------------------
------------------------------------------------------------------------------------------------------------------------------------------------------
------------------------------------------------------------------------------------------------------------------------------------------------------
--------------------SSSSSSSSSS--------------------------------------------------ooo---------------------------------------------------------SSSSSSSSSS
--------------------SSSSSSSSSS--------------------------------------------------%%%-------------------------------------------------------------------
--------------------SSSSSSSSSS---------------------------------------------------|--------------------------------------------------------------------
--------------------SSSSSSSSSS---------------------------------------------g-----|---------------------------------oo---------------------------------
-----------------------------------------------------------------------%%%%%%----|----------------------------------------------oo--------------------
------------------------------------------------------------------------||||-----|--------------------------------------------------------------------
------------------------------------------------------------------------||||-----|---%%%%-------g-----------------------------------------------------
---------Q------------SSSSSS?----------------------------tt-------------||||-----|----||--------TT-------------%%%%--%%%-----TT------------#--TT------
-----------------K----SSSSS-----------tt-----K---B-------tt-------------||||----%%%%%%||--------TT----TT--------||----||-----TT-----------##--TT------
------------B---------SSSSS-----------tt---------b-------tt-------------||||-----||||-||--------TT----TT----TT--||----||-----TT----------###--TT------
-M----------b--------------ooo--------tt---------B---g-g-tt-gg-------g--||||-----||||-||--------TT----TT-k--TTo-||----||-y---TT------y--####--TT------
XXXXXXXXXXXXXXXXXXXX-XXXXXXXXXXXXXXXXXXXXXXXXXXXXXXXXXXXXXXXXXXXXXXXXX--||||-----||||-||%%XXXXXXXXX-XXXXXXXXXX%-||----||XXXXXXXXXXXXXXXXXXXXXXXX--XXXX
XXXXXXXXXXXXXXXXXXXX-XXXXXXXXXXXXXXXXXXXXXXXXXXXXXXXXXXXXXXXXXXXXXXXXX--||||-----||||-||-|XXXXXXXXX-XXXXXXXXXX--||----||XXXXXXXXXXXXXXXXXXXXXXXX--XXXX
