------------------------------------------------------------------------------------------------------------------------------------------------------
------------------------------------------------------------------------------------------------------------------------------------------------------
------------------------------------------------------------------------------------------------------------------------------------------------------
----------------------------------------SSSSSSSSSS-----------------SSS--------------------------------------------------------------------------------
------------------------------------------------------------------------------------------------------------------------------------------------------
-----------------------SSS-----------------------------------------------------------------------------------------k----------------------------------
-----------------------------------------oooo-------------------CSS-------SS--------y-------------------SSQSSSS---SSSSSS-------SSS%-------------------
---------------------g------------------------------------------------------------#SSS---------------------------------------------------------y------
--------------------%%%------------------SSSS-U-------------SS--2----------------##-----------------------------------------------------SSS--#SS--o---
--------------------||----SSS-----------oS--SoS----------------2-2--------------###1--------------oo------K---------------------K-----------##--------
---------Q----------||------------------SS--SSS-------------------2---SS-----SS-###---------------------SSSSSS-----------------SSS%%%%%-----##--SC----
--------------------||----------------K-------------K---------------------------###--SSS-------TT----------------------------------|||------##--------
--------------------||--------TTTT----------------------------------------------###------------TT-------------TT---------TT--------|||------##---SSS--
--------------k-ggg-||----oo--TTTT--------kk---------------g--------------------###---------y--TT-------------TT---------TT--------|||------##--------
XXXXXXXXXXXXXXXXXXXX||---%%%--XXXXXXXXXXXXXXXXXXXXXXXXXXXXXX---XXXXXXX----------XXXXXX---XXXXXXXXXXXXXXXXXXXXXXXXXXXXX--XXXXXXXXXX%|||------XX------XX
XXXXXXXXXXXXXXXXXXXX||----|---XXXXXXXXXXXXXXXXXXXXXXXXXXXXXX---XXXXXXX----------XXXXXX---XXXXXXXXXXXXXXXXXXXXXXXXXXXXX--XXXXXXXXXX-|||------XX------XX
