------------------------------------------------------------------------------------------------------------------------------------------------------
------------------------------------------------------------------------------------------------------------------------------------------------------
------------------------------------------------------------------------------------------------------------------------------------------------------
----------------------------------------SSSSSSSSSS----------------------------------------------------------------------------------------------------
------------------------------------------------------------------------------------------------------------------------------------------------------
-----------------------SSS----------------------------------------------------------------------------------------------------------------------k-----
-----------------------------------------oooo-------------------------------SSSS-----SUS---SSS!-----------2--------------------SSS-------------SQS--SQ
---------------------g-------------------------------------------------------------------------------------------SSS----------------------------------
--------------------%%%------------------SSSS-U-------------------------------------------------------------------------------------------------------
--------------------||----SSS-----------oS--SoS----------o-------------------K----------------------o---------------------------K---------------------
-------------------%||------------------SS--SSS----------------------#-----SSSSS----#####-----C-----------2--------------------SSS---------#---SQS--S?
--------------------||----------------------------------------------##T-------------#-----------------------------------------------------##----------
--------------------||--------------------------------------TT-----###T------------K#------------------------------------TT--------------###----------
-M-----------%%%%---||----oo------k-k-----kk--------k-------TT----####T-------------#----------g-g------y--y-------------TT----------y--####-k------gg
XXXXXXXXXXX---||----||---%%%--XXXXXXXXX-XXXXXXXXXX-XXXXXXXXXXXXXXXXXXXXXXXXXXXXXXXXXXXX---XXXXXXXXXXXXXXXXXXXX%%%%----%%XXXXXXXXXXXXXXXXXXXXXXXXXXXXXX
XXXXXXXXXXX---||----||----|---XXXXXXXXX-XXXXXXXXXX-XXXXXXXXXXXXXXXXXXXXXXXXXXXXXXXXXXXX---XXXXXXXXXXXXXXXXXXXX|||------|XXXXXXXXXXXXXXXXXXXXXXXXXXXXXX
