------------------------------------------------------------------------------------------------------------------------------------------------------
------------------------------------------------------------------------------------------------------------------------------------------------------
------------------------------------------------------------------------------------------------------------------------------------------------------
--------------------------------------------------------------------------------------------------------------SS-------S------------------------------
--------------------------------------------?---------------------------------------------------------------------------------------------------------
-----------------------SSS------------------------------------------------------------------oo--------------------------------------------------------
-------------------------------------------------------------------------------------1-----------------------R---------SSS-------------------QQQQ-----
---------------------g------------------------r------------------------------------------------------r------------------------------------------------
--------------------%%%-------------------%%%%%%---------B-----------------------------------------%%%%%%%%--------SSS---------------g#---------------
--------------------||----SSS--------------||||----------b---------------1--------------------------||||||-----------------TT-------g##--------y------
--------------------||------------------%%-||||ooo-----SS#CS----------T------------QQQQ---S---------||||||-------------S---TT-------###-----Q?SSQQQ---
--------------------||------------------|--||||--r--------------------T----TT-----------------------||||||-----##-------t--TT------####---------------
--------------------||------------------|%%%%%%%%%---------K----------T----TT----------------%%%%---||||||-----##-------t--TT-----#####---------------
-M--------k---ggg---||----oo------k-k---|-||||||||-----------y--------T---kTT-------yy--------||----||||||--oo-##-------t--TT-----#####---------------
XXXXXXXXXXXXXXXXXXXX||---%%%--XXXXXXXXX-|-||||||||XXXXXXXXXXXXXXXXXXXXXXXXXXXXXXXXXXXXXXXX----||----||||||--%%-XX------XXXXXXXXXXXXXXXX--XXXXX--XXXXXX
XXXXXXXXXXXXXXXXXXXX||----|---XXXXXXXXX-|-||||||||XXXXXXXXXXXXXXXXXXXXXXXXXXXXXXXXXXXXXXXX----||----||||||---|-XX------XXXXXXXXXXXXXXXX--XXXXX--XXXXXX
