------------------------------------------------------------------------------------------------------------------------------------------------------
------------------------------------------------------------------------------------------------------------------------------------------------------
------------------------------------------------------------------------------------------------------------------------------------------------------
---------------------------------------------------oo-------------------------------------------------------------------------------------------------
--------------------------------------------------%%%%------------------------------------------------------------------------------------------------
-----------------------SSS--------------%%---------||---------g---------------------------------------------------------------------------------------
----------------------------------------|----------||---------SSSSS-------SS----------------------------------------------------------------SSS-------
---------------------g------------------|----oo----||--SSS----------------------------------------------------------------------oo--------------------
--------------------%%%-----------------|----------||-------------------------------------------------------------------------------------------------
------------Q--?----||----SSS-----------|----------||-----------------------------o------------oooo----------------------------------------------SSSSS
-------------------S||---------TT-------|----------||-----------------SS-----SS--------TT------------------------------------TT-----------------------
--------------------||---------TT-------|----------||----------------------------------TT------------------------------------TT-----------------------
--------------------||---------TT-------|---------%||---------TT-----t-----------------TT-----------------*--------B---------TT-------------SSS-------
-M----------------K-||----oo--gTT-------|----------||---------TT-----t-----------------TT-----------gg----*--------b-----y---TT--------------------r--
XXXXXXXXXXXXXXXXXXXX||---%%%--XXXXXXXX--|----%%%%--||-------XXXXXXXXXX----------XXXXXXXXXX%%%%%%%-%%XXXXXXXXX-XXXXXXXXXXXXXXXXXXXXXXXXXXXXXX-----XXXXX
XXXXXXXXXXXXXXXXXXXX||----|---XXXXXXXX--|-----||---||-------XXXXXXXXXX----------XXXXXXXXXX||||||---|XXXXXXXXX-XXXXXXXXXXXXXXXXXXXXXXXXXXXXXX-----XXXXX
