------------------------------------------------------------------------------------------------------------------------------------------------------
------------------------------------------------------------------------------------------------------------------------------------------------------
------------------------------------------------------------------------------------------------------------------------------------------------------
------------------------------SSSSSSSSSS----------SSSSSSSSSS--------------------------------------------------SSSSSSSSSS------------------------------
------------------------------SSSSSSSSSS--------------SS--SS------------------------------------------------------------------------------------------
----------------------ooor----SSSSSSSSSS--------------SS--SS------------------------------------------------------------------------------------------
---------------------%%%%%----SSSSSSSSSS------------SS------------------SSSSS-------y--------------------------------------------------US-------------
----------------------|||---------------------------SS----------------------------#SSS--------------oo------------------------------------------------
-----------------%%%--|||---------------------------SS---------------------------##-------------------------------------------------------------------
------------------||--|||---------------------------SS----oo--------------------###1------------g-----------------------SS-?Q--------SS---------------
------------------||%%%%%%%---SSSSSSSSSS------------SSSS--SS---------T-------2--###-------------TT-----------TT----------------------------S----------
-------------%%%%%||||||||----SSSSSSSSSS--------------SS-------------T-----TT---###--SSS--------TT-----------TT---------------------------------------
--------------|||-||||||||--o-SSSSSSSSSS--------------SS-------------Tt----TT--T###-------------TT-----------TT----TT----------y--TT---------------F--
-M------------|||-||||||||-%%%SSSSSSSSSS-------ggg------------ggg----Tt----TT--T###-------------TT--------y--TT--g-TT------SSSSS--TT---------------#--
XXXXXXXXXXX---|||-||||||||--|-XXXXXXXXXX-XXXXXXXXXXXXXXXXXXXXXXXXXXXXXXXXXXXXXXXXXXXXX---XXXXXXXXXX-XXXXXXXXXXXXXXXXXXXX-------XX-XXXXXX-X-XXXXXXXXXXX
XXXXXXXXXXX---|||-||||||||--|-XXXXXXXXXX-XXXXXXXXXXXXXXXXXXXXXXXXXXXXXXXXXXXXXXXXXXXXX---XXXXXXXXXX-XXXXXXXXXXXXXXXXXXXX-------XX-XXXXXX-X-XXXXXXXXXXX
