------------------------------------------------------------------------------------------------------------------------------------------------------
------------------------------------------------------------------------------------------------------------------------------------------------------
------------------------------------------------------------------------------------------------------------------------------------------------------
-----------------------oo-------oo--------------------------------------------------------SSSSSSSSSS--------------------------------------------------
---------------------------------------g--------------------------------------------------------------------------------------------------------------
-----------------------------------%%%%%ooooo---------------------------------------------------------------------------------------------------------
----------------------SSSS----------||||--------------------------------------------y-------------------------------------SSC-----%-------------------
------------------------------------||||--------SS--------------------------------#SSS----------------------------------------------------------------
------------------------------------||||-SSSS------------TT----------------------##-----------------------------------------------------SSS-----------
------------------------------%%%%%-||||-----------TT----TT-----1---------------###1--------------------------------------SSS-------------------------
----------------%%%%------%%%%-|||--||||-----------TT----XX---------------------###-------------------%%%%%%----------------------%%%%%-------#LSS----
-----------------||--------|||-|||--||||-----------TT---------------------------###--SSS---------------||||----#-------------------|||--------#-------
-----------------||--------|||-|||--||||----%%%%%--TT---------------------------###--------------------||||----#-------------------|||--------#-------
-M---------------||--------|||-|||--||||-----|||---TT---------------------------###-------------g-g----||||----#----ggg----------#-|||------kk#-------
XXXXXXXXXXX--%%%%||%%%%----|||-|||--||||%%---|||--XXXXXXXXXXXXXXXXXXX-X----XXXXXXXXXXX---XXXXXXXXXXX%%-||||-%%-XXXXXXXXXX----XXXXX%|||------XXXXXXX---
XXXXXXXXXXX---||-||-||-----|||-|||--|||||----|||--XXXXXXXXXXXXXXXXXXX-X----XXXXXXXXXXX---XXXXXXXXXXX|--||||--|-XXXXXXXXXX----XXXXX-|||------XXXXXXX---
