------------------------------------------------------------------------------------------------------------------------------------------------------
------------------------------------------------------------------------------------------------------------------------------------------------------
------------------------------------------------------------------------------------------------------------------------------------------------------
----------SSSSSSSSSSSSSSSSSSSS--oo------SSSSSSSSSS----------------------------------------------------------------------------------------------------
--------------------SSSSSSSSSS---------g--------------------------------------------------------------------------------------------------------------
--------------------SSSSSSSSSS-----%%%%%-----------------------------R------------------------------oo------------------------------------------k-----
--------------------SSSSSSSSSS------||||-oooo---------------------------SSSSS------o--o-------------%%%---------------US-SSS----S!-------------SQS--SQ
------------------------------------||||------------------------------------------------------------||--o----R----------------------------------------
------------------------------------||||-SSSS-U-----------------------------------------------------||-%%%--------------------------------------------
------------------------------%%%%%-||||oS--SoS------------------------------------SSSS---------g---||--|-----------E---------------------------------
----------------------SSSSSS?--|||--||||SS--SSS----------tt------%%%---------2------------------TT--||--|----------TT------------S---------#---SQS--S?
----------------------SSSSS----|||--||||-----------------tt-------|--------TT-------------------TT--||-o|----------TT--t------------------##----------
----------------------SSSSS----|||--||||-----------------tt-------|---t----TT--T%%%-------------TT--||%%%%%--------TT--t-----------------###----------
-M-------------------------ooo-|||--||||--kk---------g-g-tt-------|---t----TT--T||--------------TT--||-|||------g--TT--t----gg-g-g---y--####-k------gg
XXXXXXXXXXX--XX--X---XXXXXXXXX-|||--||||XXXXXXXXXXXXXXXXXXXX%%%%%-|---XXXXXXXXXX||--------XXXXXXXXX-||-|||----XXXXXXXXXXXXXXXXXXXXXXXXXXXXXXXXXXXXXXXX
XXXXXXXXXXX--XX--X---XXXXXXXXX-|||--||||XXXXXXXXXXXXXXXXXXXX-|||--|---XXXXXXXXXX||--------XXXXXXXXX-||-|||----XXXXXXXXXXXXXXXXXXXXXXXXXXXXXXXXXXXXXXXX
