------------------------------------------------------------------------------------------------------------------------------------------------------
------------------------------------------------------------------------------------------------------------------------------------------------------
------------------------------------------------------------------------------------------------------------------------------------------------------
--------------------------------------------------SSSSSSSSSS----------SSSSSSSSSSSSSSSSSSSS------------------------------SSS-----SSSSSSSSSSSS----------
------------------------------------------------------SS--SS------------------------------------------------------------------------------------------
----------------------ooor----------------------------SS--SS-------------------------------------------------------k----------------------------------
---------------------%%%%%--------------------------SS--------USSS------------------------SSS------%----------S---SSSSSSUS-------------------------SSS
----------------------|||---------------------------SS------------------------TT--------------------oo------------------------------------------------
----------------------|||---------------------------SS------------------------TT--------------------------------------------SSS-----------------------
----------------------|||---------------------------SS----oo------------------TT-------S--------------------------------------------------------------
-----SSS--------%%%%%%%%%%%-----QQQQ----------------SSSS--SS-S-----TT-------SCTTSU----------%%%--------------T----------SSS-----------------------#---
-----------------||-||||||-----------K-B-----K---B----SS-----------TT---TT----TT----TT---t---|---------------T----------------------------TT------#---
-----------------||-||||||--o----------b---------b----SS-----------TT---TT----TT----TT---t---|---------------TTT-------------------tt-----TT------#---
-----------------||-||||||-%%%---------b---------B-----------ggg---TT---TT---kTT---kTT--kt---|------------y--TTT-------------------tt----kTT-ggg--#---
XXXXXXXXXXX--%%%%||%||||||--|-XXXXXXXXXXXXXXXXXXXXXXXXXXXXXXXXXXXXXXXXXXXXXXXXXXXXXXXXXXXX---|------XXXXXXXXXXXXXXXXXX--XXX------XXXXXXXXXXXXXXXXXXXXX
XXXXXXXXXXX---||-||-||||||--|-XXXXXXXXXXXXXXXXXXXXXXXXXXXXXXXXXXXXXXXXXXXXXXXXXXXXXXXXXXXX---|------XXXXXXXXXXXXXXXXXX--XXX------XXXXXXXXXXXXXXXXXXXXX
