------------------------------------------------------------------------------------------------------------------------------------------------------
------------------------------------------------------------------------------------------------------------------------------------------------------
------------------------------------------------------------------------------------------------------------------------------------------------------
--------------------------------------------------SSSSSSS---------------------------------------------------------------------------------------------
-----------------------------------------g------------------------------------------------------------------------------------------------------------
----------------------------------------%%---------------------------R------------g-------------------------------------------------------------------
---------------------LSSS---------------|---------QQ--------------------SSSSS---SSSSSSSS---------------------R---------------------------##-----------
----------------------------------------|----oo----------------------------------------------------------r-------SSS---------------------##-----------
----------------------------------------|------------------S----------------------------------------%%%%%%%----------------------------####-----------
----------------------------------------|------------------------------------------------------oooo-||||||---------------------SSS-----####-----------
----------------!----2-----#-----------T|---------QQ--QQQ--------%%%---------2----------------------||||||--------------%------------######-----------
---------------------------#-----------T|-------------------------|--------TT-----------------------||||||---------------------------######-----------
---------------------------##----------T|-------------------------|---t----TT--T--------------------||||||---------------------------######--------F--
-M--------------------kk---##---gg-----T|-------------------------|---t----TT--T--------------------||||||--oo-------------------r---######--------#--
XXXXXXXXXXXXXXXXXXXXXXXXXXXXXXXXXXXXXXXX|----%%%%-XXXXXXX---%%%%%-|---XXXXXXXXXXXXXXXX---X%%%%%%%-%%||||||--%%%%%%----%%----XXXXXXXXXXXXXXXXXXXXXXXXXX
XXXXXXXXXXXXXXXXXXXXXXXXXXXXXXXXXXXXXXXX|-----||--XXXXXXX----|||--|---XXXXXXXXXXXXXXXX---X||||||---|||||||---||||------|----XXXXXXXXXXXXXXXXXXXXXXXXXX
