------------------------------------------------------------------------------------------------------------------------------------------------------
------------------------------------------------------------------------------------------------------------------------------------------------------
------------------------------------------------------------------------------------------------------------------------------------------------------
----------SSSSSSSSSS----------SSSSSSSSSS----------------------------------------SSSSSSSSSL------------------------------SSSSSSSSSS----------SSSSSSSSSS
-------------------------------------------------------------------------o----------------------------------------------------------------------------
------------------------------------------------------------------------%%%---------------------------------------------------------------------------
-----------------------------U-------------------------------------------|--o-------oooooo------------------------------------------------------------
-------------------------------------------------------------------------|--SSSS--------------------------------oooo----------------------------------
---------------------------------------S-----------------------------o%--|----------SSSSSS------------------------------------------------------------
---------------------------------------S-------------------------y-------|----------SSSSSS-----oooo---------------------------------------------------
----------@QQQQ-------------##---------S------tt-------ooo-------##------|------------------------------------T-------------------------------TT------
-----------------------y-#####-#--------------tt----------------###------|------------------------------------T-----------SS---------TT-------TT------
-----------------g-#y-######---#-#------------tt---------------####------|-----%--------------------------*---T-----------SS---------TT-------TT------
-M--------------g#-#######-----#-#-------g----tt--------------#####------|--------------------------gg----*---T---y-------SS---------TT-------TT------
XXXXXXXXXXXXXXXXXXXXXXXX------XXXXXXXXXXXXXXXXXXXX--XXXXXXXXXXXXXXX---%%%%%%-------XXXXXXX%%%%%%%-%%XXXXXXXXX-XXXXXXXXXX--XX--XXXXXXXXXXXXXXXXXX--XXXX
XXXXXXXXXXXXXXXXXXXXXXXX------XXXXXXXXXXXXXXXXXXXX--XXXXXXXXXXXXXXX---|||||--------XXXXXXX||||||---|XXXXXXXXX-XXXXXXXXXX--XX--XXXXXXXXXXXXXXXXXX--XXXX
