------------------------------------------------------------------------------------------------------------------------------------------------------
------------------------------------------------------------------------------------------------------------------------------------------------------
------------------------------------------------------------------------------------------------------------------------------------------------------
----------SSSSSSSSSS----------------------------------------------------------------------------------------------------------------------------------
------------------------------------------------------------------------------------------------------------------------------------------------------
----------------------------------------------------------------------------------g---------oo--------------------------------------------------------
----------------------!----------------------------------------------------g----SSSSSSSS-------------------------------------------------##-----------
-----------------------------------------------------------------------%%%%%%------------------------------------------------------------##-----------
------------------------------------------------------------------------||||-----------------------%--------------------------SSS------####-----------
---------------------------------------------------------o--------------||||-----------------------------------------------------------####-----------
--------SU@QQQQ-----S@S!S------TT-------------tt---------------------#--||||--------------SS----------%%%%%%------------%------------######-----------
-------------------------------TT-------------tt--------------------##--||||---------------------------||||--------------------------######-----------
-----------------g-#--------tt-TT-------------tt------------TT-----###--||||-----------------%%%%------||||--------B-----------------######--------F--
--M-------------g#-#-g------ttgTT--------g----tt----k-------TT----####--||||------------------||-------||||--------b-------------r---######--------#--
XXXXXXXXXXXXXXXXXXXXXXXXXXXXXXXXXXXXXX--XXXXXXXXXX-XXXXXXXXXXXXXXXXXXX--||||----XXXXXX---X----||----%%-||||-%%XXXXXXXXXX----XXXXXXXXXXXXXXXXXXXXXXXXXX
XXXXXXXXXXXXXXXXXXXXXXXXXXXXXXXXXXXXXX--XXXXXXXXXX-XXXXXXXXXXXXXXXXXXX--||||----XXXXXX---X----||----|--||||--|XXXXXXXXXX----XXXXXXXXXXXXXXXXXXXXXXXXXX
