------------------------------------------------------------------------------------------------------------------------------------------------------
------------------------------------------------------------------------------------------------------------------------------------------------------
------------------------------------------------------------------------------------------------------------------------------------------------------
----------------------------------------------------------------------SSSSSSSSSS----------SSSSSSSSSS------------------------------SSSSSSSS------------
------------------------------------------------------------------------------------------------------------------------------------------------------
-------------------------------------------------------oooo-------------------------------------------------------------------------------------------
--------------------S----------------------------------%%%%------------------------o--o------------------------------------------------------------SSS
---------------------------TT---------------------SSSS--||--------------------TT--------------------oo----------oooo------------oo--------------------
---------------------------TT---------------------------||-----------o--------TT----------------------------------------------------------------------
---------------------------XX---------------------------||-------y------------TT---SSSS---------------------------------------------------------------
---------Q---------%---TT-------------------------------||-------##---------SCTT-----------------------------TT--------------TT--------g##--------#---
-----------------------TT-----------------------------U-||------###-----TT----TT----------t------------------TT--------------TT--------###--------#---
-----------------------TT-------------------------------||-----####-----TT----TT%%%-------t------------------TT--------------TT------g####--------#---
-M-----------%%%%---k--TT---------k-k----------y--------||----#####-----TT---kTT||--------t---------------y--TT---y------y---TT------#####---ggg--#---
XXXXXXXXXXX---||----XXXXXXXXXXXXXXXXXXX-XXXXXXXXXX----%%%%%-XXXXXXX---XXXXXXXXXX||--------XXXXXXXXXXXXXXXXXXXXXXXXXXXXXXXXXXXXXXXXXXXXXXXX--XXXXXXXXXX
XXXXXXXXXXX---||----XXXXXXXXXXXXXXXXXXX-XXXXXXXXXX-----|||--XXXXXXX---XXXXXXXXXX||--------XXXXXXXXXXXXXXXXXXXXXXXXXXXXXXXXXXXXXXXXXXXXXXXX--XXXXXXXXXX
