------------------------------------------------------------------------------------------------------------------------------------------------------
------------------------------------------------------------------------------------------------------------------------------------------------------
------------------------------------------------------------------------------------------------------------------------------------------------------
--------------------SSSSSSSSSS--------------------------------------------------SSSSSSSSSL----------SSSSSSSSSS----------------------------------------
--------------------SSSSSSSSSS--------------?---------------------------------------------------------------------------------------------------------
--------------------SSSSSSSSSS-------------------------------------------------------------------------------------k----------------------------------
--------------------SSSSSSSSSSS--------------------------Q-Q------------SSSSS-------oooooo--------------------S---SSSSSS--oo---%%%--------------------
----------------------------------------------r---------------------------------------------------------------------------SS----||--------------------
------------------------------------------%%%%%%------------------------------------SSSSSS--------------------------------------||---g#---------------
-------------------------------------------||||-------------------------------------SSSSSS-o------------------------------------||--g##---------------
---------Q------------SSSSSS?-##--SSC---%%-||||ooo-------Q-Q-----------------2-------------------TT--------TT----------------SS-||--###-----#---------
-----------------K----SSSSS-------------|--||||--r-------------------------TT--------------------TT-----#--TT-------------------||-####-----##--------
------------B---------SSSSS-------------|%%%%%%%%%--------------------t----TT--T-----------------TT----##--TT-TT----------------||#####-----###------#
------------b--------------ooo----------|-||||||||-----------y--------t----TT--T-----------------TT-kk-##--TT-TT----------------||#####-----####----##
XXXXXXXXXXXXXXXXXXXX-XXXXXXXXXXX--XXXXXX|-||||||||XXXXXXXXXXXXXXXXXXXXXXXXXXXXXX---XXXXXXXXXXXXXXXXXXXXXX--XX-XXXXXXXX--%%-----%%%XXXXX--XXXXXXXXXXXXX
XXXXXXXXXXXXXXXXXXXX-XXXXXXXXXXX--XXXXXX|-||||||||XXXXXXXXXXXXXXXXXXXXXXXXXXXXXX---XXXXXXXXXXXXXXXXXXXXXX--XX-XXXXXXXX--|-------||XXXXX--XXXXXXXXXXXXX
