------------------------------------------------------------------------------------------------------------------------------------------------------
------------------------------------------------------------------------------------------------------------------------------------------------------
------------------------------------------------------------------------------------------------------------------------------------------------------
------------------------------------------------------------------------------------------SSSSSSSSSS----------SS-------S------------------------------
------------------------------------------------------------------------------------------------------------------------------------------------------
------------------------------------------------------------------------------------------------------------------------------------------------------
-------------------------------------------------------------------------------------SSSS--------------------@---------S-------SSSSS--------SSS-------
-------------------------------------------------------------o---o---o--------------------------------------------------------------------------------
-----------------%%%-------------------------------------TT-%%%-%%%-%%---------g-----------------------------------SSS--------------------------------
------------------||-------------------------------TT----TT--|---|---|----------------------------------------------------------K----------------SSSSS
-----SSS----------||-------------------------------TT----XX--|---|---|-------S@SQ-------------------SU----!--!---------S-------SSSSS------------------
-------------%%%%%||-------------------T-----------TT--------|---|---|-----------------------------------------##-----------------K---#----B----------
--------------|||-||-------------------T-----------TT--------|---|---|-----------------------------------------##--------TT-----------#----bSSS-------
--------------|||-||-----------------kkT-------y---TT--------|---|-r-|-----------ggg------------g-g-------k----##--------TT-----------#----B-------r--
XXXXXXXXXXX---|||-||XXXXX--XXXXXXXXXXXXXXXXXXXXXXXXXXXXXXXXX%%%%%%%%%%-XXXXXXXXXXXXXX----XXXXXXXXXXXXXXXXXXXXX-XX------XXXXXXXXXXXXXXXXXXXXX-----XXXXX
XXXXXXXXXXX---|||-||XXXXX--XXXXXXXXXXXXXXXXXXXXXXXXXXXXXXXXX-|||||||||-XXXXXXXXXXXXXX----XXXXXXXXXXXXXXXXXXXXX-XX------XXXXXXXXXXXXXXXXXXXXX-----XXXXX
