------------------------------------------------------------------------------------------------------------------------------------------------------
------------------------------------------------------------------------------------------------------------------------------------------------------
------------------------------------------------------------------------------------------------------------------------------------------------------
------------------------------SSSSSSSSSS--------------------------------------------------------------------------------------------------------------
------------------------------------------------------------------------------------------------------------------------------------------------------
-----------------------SSS------------------------------------------------------K---------------------------------------------------------------------
--------------------------------------------------------------------------------SS----1-----------------SSQSSS--------------------%-------------------
---------------------g----------------------------------------------------------------------------oo--------------------------------------------------
-----------------%%%%%%----------------S-----------------TT-----------------------------------------------------------------------------SSS-----------
------------------||||----SSS----------S-----------TT----TT-----1--------1--------------------------------K-------------------------------------------
---------Q--------||||-----------------S-----------TT----XX-----------T---------SS----------------------SSSSSS--------------------%%%%%-----#---------
-------------%%%%%||||---------#--------T-----TT---TT-----------------T----TT---------TT--------#----------------------------------|||------##--------
--------------|||-||||---------#-#------T-----TT---TT-----------------T----TT---------TT--------#----------------------------------|||------###------#
-M------------|||-||||----oo---#-#------T-----TT---TT-----------------T---kTT---------TT--------#--------------k----kkk---kkk------|||------####----##
XXXXXXXXXXX---|||-||||---%%%--XXXXXXXXXXXXXX--XXXXXXXXXXXXXXXXXXXXXXX-XXXXXXXXXXXXXXXXXXXXXXXXXXXXXXXXXXXXXXXXXXXXXXXXXXXXXXXXXXXX%|||------XXXXXXXXXX
XXXXXXXXXXX---|||-||||----|---XXXXXXXXXXXXXX--XXXXXXXXXXXXXXXXXXXXXXX-XXXXXXXXXXXXXXXXXXXXXXXXXXXXXXXXXXXXXXXXXXXXXXXXXXXXXXXXXXXX-|||------XXXXXXXXXX
