------------------------------------------------------------------------------------------------------------------------------------------------------
------------------------------------------------------------------------------------------------------------------------------------------------------
------------------------------------------------------------------------------------------------------------------------------------------------------
----------SSSSSSSSSS--------------------SSSSSSSSSS-oo-------------------------------------------------------------------------------------------------
----------------------------------------SSSSSSSS--%%%%-------------------o----------------------------------------------------------------------------
--------------------------------------ooSSSCSSSS---||-------------------%%%-------------------------oo------------------------------------------------
----------------------!------------SSSS-SSSSSSSS---||-------------SSoo---|--o-----------------------%%%------------------SSS----S!-----------------SSS
---------------------------------------------------||--SSS---------------|--SSSS--------------------||--o----R----------------------------------------
---------------------------------------------------||-----------------%--|--------TT----------------||-%%%--------------------------------------------
-------------------------------------------ggg-----||--------------------|--------TT----------------||--|---------------------------------------------
----------@QQQQ-----S@S!S-----%---------SSSSSSSS---||-------%%%%%%-------|--------TT----------------||--|-------------r----------S---------#------#---
----------------------------------------SSSSSSSS---||--------||||--------|--------TT-----T----------||-o|---------%%%%%%------------------##------#---
-----------------g-#--------tt----------SSSSSSSS--%||--------||||--------|-----%T-TT-----T-------B--||%%%%%--------|||||-----------------###------#---
---M------------g#-#-g------tt----------SSSSSSSS---||--------||||--------|------T-TT---k-T-------b--||-|||---------|||||----gg-g-g---y--####-ggg--#---
XXXXXXXXXXXXXXXXXXXXXXXXXXXXXX--%%%%--%%XXXXXXXXXX-||--------||||-----%%%%%%----XXXXXXXXXXXXXXXXXXXX||-|||-----%%%-|||||XXXXXXXXXXXXXXXXXXXXXXXXXXXXXX
XXXXXXXXXXXXXXXXXXXXXXXXXXXXXX---||----|XXXXXXXXXX-||--------||||-----|||||-----XXXXXXXXXXXXXXXXXXXX||-|||------|--|||||XXXXXXXXXXXXXXXXXXXXXXXXXXXXXX
