------------------------------------------------------------------------------------------------------------------------------------------------------
------------------------------------------------------------------------------------------------------------------------------------------------------
------------------------------------------------------------------------------------------------------------------------------------------------------
--------------------------------------------------------------------------------ooo-----------------SSSSSSSSSS----------------------------------------
--------------------------------------------------------------------------------%%%-------------------------------------------------------------------
---------------------------------------------------------------------------------|--------------------------------------------------------------------
----------------------------------------------------------------------------SSSS-|--------------------------------------------------------------------
---------------------------------------------------------------------------------|------------------------------------------------oo------------------
---------------------------------------------------------B-----------------------|-------------------------------------y------------------------------
---------------------------------------------------------b-------------------K---|---%%%%------------------------------X-------SSS--------------------
---------Q---------%--------TT-------------------------SS#CS---------------SSSSS-|----||---------------------T--------XX%------------------Q----------
----------------------------TT--------K-------------------------------T---------%%%%%%||---------------TT----T-------XXX---------------------------#--
----------------------------TTTTTT-------------------------K----------T----------||||-||---------------TT----T------XXXX-----------------------K---#--
-------------%%%%-------ggg-TTTTTT-------------ggg----------gg-------gT----------||||-||-----------gg--TT----T-----XXXXX---------r-----------------#--
XXXXXXXXXXX---||----XXXXXXXXXXXXXXXXXXXX-XXXXXXXXXXXXXXXXXXXXXXXXXXXXXXXXXXXXXXX-||||-||%%-XXXXXXXXXXXXXXXXXXXXXXXXXXXXX----XXXXXXXXXXXXXXXXXXXXX--XXX
XXXXXXXXXXX---||----XXXXXXXXXXXXXXXXXXXX-XXXXXXXXXXXXXXXXXXXXXXXXXXXXXXXXXXXXXXX-||||-||-|-XXXXXXXXXXXXXXXXXXXXXXXXXXXXX----XXXXXXXXXXXXXXXXXXXXX--XXX
