------------------------------------------------------------------------------------------------------------------------------------------------------
------------------------------------------------------------------------------------------------------------------------------------------------------
------------------------------------------------------------------------------------------------------------------------------------------------------
----------------------------------------------------------------------SSSSSSSSSS----------------------------------------------------------------------
-----------------------------------------g------------------------------------------------------------------------------------------------------------
----------------------ooor--------------%%------------------------------------------------------------------------------------------------------k-----
---------------------%%%%%--------------|----------------Q-Q-------------------------------------------------R---------------------------------SQS--SQ
----------------------|||---------------|----oo-------------------------------TT---------------------r----------oooo----------------------------------
----------------------|||---------------|----------------------------o--------TT--------------------%%%%%%%-------------------SSS---------------------
------------Q--?------|||---------------|------------------------y------------TT--o---------------oo||||||--------------------------------------------
---------Q---------S%%%%%%%-------------|----------------Q-Q-----##---------SCTT-------TT-----------||||||----T---------%------------------#---SQS--S?
--------------------||||||-------------T|-----------------------###-----TT----TT-------TT------TT---||||||----T---------------------------##----------
--------------------||||||--o----------T|----------------------####-----TT----TT-------TT------TT---||||||----T--------------------------###----------
------------------K-||||||-%%%-------kkT|---------------------#####-----TT---kTT-------TT---y--TT---||||||--ooT---y--------------r---y--####-k------gg
XXXXXXXXXXXXXXXXXXXX||||||--|-XXXXXXXXXX|----%%%%-XXXXXXXXXXXXXXXXX---XXXXXXXXXXXXXXXXXXXXXXXXXXXXXX||||||--%%XXXXXXXXXX----XXXXXXXXXXXXXXXXXXXXXXXXXX
XXXXXXXXXXXXXXXXXXXX||||||--|-XXXXXXXXXX|-----||--XXXXXXXXXXXXXXXXX---XXXXXXXXXXXXXXXXXXXXXXXXXXXXXX||||||---|XXXXXXXXXX----XXXXXXXXXXXXXXXXXXXXXXXXXX
