------------------------------------------------------------------------------------------------------------------------------------------------------
------------------------------------------------------------------------------------------------------------------------------------------------------
------------------------------------------------------------------------------------------------------------------------------------------------------
----------------------------------------------------------------------------------------------------SSSSSSSSSSSS-------SSSSSSSSSSS--------------------
------------------------------------------------------------------------------------------------------------------------------------------------------
------------------------------------------------------------------------------------------------------------------------------------------------------
------------------SCS-----------------------------Q----------------------------------SSSS-SSS------%-------------------S----------%----------------SSS
---------------------------TT-------------------------------------------------------------------------------------------------------------------------
---------------------------TT-----------------------------------------o--------------------------------------------SSS------------------SSS-----------
---------------------------XX-------------------------------------------------------------------------------------------------------------------------
--------------TT---2---TT--------------T-TT---SU--Q-----------------------------Q-----------%%%------------TT----------S----------%%%%%-----------#---
--------------TT-------TT--------------T-TT--------------------------T--------#--------------|----------#--TT--##---------SS-------|||------------#---
--------------TT-------TT--------------T-TT------------------B-------T-------##--------------|---------##--TT--##---------SS-------|||------------#---
-M------------TT----k--TT-------gg-----T-TT------k---gg----k-b-------T-----------ggg---------|------kk-##--TT--##---------SS-------|||-------ggg--#---
XXXXXXXXXXXXXXXXXXXXXXXXXXXXXXXXXXXXXXXXXXXXXXXXXXXXXXXXXXXXXXXXXX--XXXXXXXXXXXXXXXXX----X---|------XXXXX--XX--XX------X--XX--XXXX%|||------XXXXXXXXXX
XXXXXXXXXXXXXXXXXXXXXXXXXXXXXXXXXXXXXXXXXXXXXXXXXXXXXXXXXXXXXXXXXX--XXXXXXXXXXXXXXXXX----X---|------XXXXX--XX--XX------X--XX--XXXX-|||------XXXXXXXXXX
