------------------------------------------------------------------------------------------------------------------------------------------------------
------------------------------------------------------------------------------------------------------------------------------------------------------
------------------------------------------------------------------------------------------------------------------------------------------------------
--------------------------------------------------SSSSSSS-------------------------------------------SSSSSSSSSS----------------------------------------
------------------------------------------------------------------------------------------------------------------------------------------------------
--------------------------------------------------------------g-------------------------oo------------------------------------------------------------
-----------------------------U--------------------QQ----------SSSSS--------g----oo-------------------------------------------------------##-SSS-------
-----------------------------------------------------------------------%%%%%%------------------------------------------------------------##-----------
-----------------%%%---------------------------------------S------------||||--------------------------------------------------SSS------####-----------
------------------||----------------------------------------------------||||-----SSS---------------------------------------------------####------SSSSS
------------------||--------##---------T------tt--QQ--QQQ---------------||||-------------S------TT-----------T----------%------------######-----------
-------------%%%%%||---y-#####---------T------tt------------------------||||--------------------TT-----TT----T-#---------------------######-----------
--------------|||-||y-######-----------T------tt--------------TT-----t--||||--------------------TT-----TT----T-#---------------------######-SSS-------
-M------------|||-||######------gg-----T-g----tt--------------TT-----t--||||----------------k---TT--g--TT----T-#----ggg----------r---######--------r--
XXXXXXXXXXX---|||-||XXXX------XXXXXXXXXXXXXXXXXXXXXXXXXXX---XXXXXXXXXX--||||--------------XXXXXXXXXXXXXXXXXXXX-XXXXXXXXX----XXXXXXXXXXXXXXXX-----XXXXX
XXXXXXXXXXX---|||-||XXXX------XXXXXXXXXXXXXXXXXXXXXXXXXXX---XXXXXXXXXX--||||--------------XXXXXXXXXXXXXXXXXXXX-XXXXXXXXX----XXXXXXXXXXXXXXXX-----XXXXX
