------------------------------------------------------------------------------------------------------------------------------------------------------
------------------------------------------------------------------------------------------------------------------------------------------------------
------------------------------------------------------------------------------------------------------------------------------------------------------
------------------------------SSSSSSSSSS--------------------------------------------------SSSSSSSSSS--------------------SSSSSSSSSS--------------------
-----------------------------------------------------------------------------------------------------------------------------------------------------o
-----------------------SSS----------------------------------------------------------------------------------------------------------------------------
--------------------------------------------------Q------------------------g-------USS-----------------------R--------------------%-------------------
---------------------g-------------------------------------------------%%%%%%----------------------------r--------------------------------------SSS---
--------------------%%%----------------S--------------------------------||||------------------------%%%%%%%-----------------------------SSS-oo--------
--------------------||----SSS----------S--------------------------------||||------------------------||||||--------------------------------------------
----------------%%%%||-----------------S----------Q---------------------||||------#-----------------||||||------------------------%%%%%-----SS--------
-----------------||-||---------#----------------------------------------||||------#-------t---------||||||-----#----------SS-------|||----------------
-----------------||-||---------#-#--------------------------------------||||------##------t---------||||||-----#----------SS-------|||----------------
-M---------------||-||----oo---#-#-------------y-----gg----kgg-------g--||||------##--gg--t---------||||||--oo-#----ggg---SS-------|||----------------
XXXXXXXXXXX--%%%%||%||---%%%--XXXXXXXXXXXXXXXXXXXXXXXXXXXXXXXXXXXXXXXX--||||------XXXXXXXXXXXXXXXXXX||||||--%%-XXXXXXXXX--XX--XXXX%|||----------------
XXXXXXXXXXX---||-||-||----|---XXXXXXXXXXXXXXXXXXXXXXXXXXXXXXXXXXXXXXXX--||||------XXXXXXXXXXXXXXXXXX||||||---|-XXXXXXXXX--XX--XXXX-|||----------------
