------------------------------------------------------------------------------------------------------------------------------------------------------
------------------------------------------------------------------------------------------------------------------------------------------------------
------------------------------------------------------------------------------------------------------------------------------------------------------
-----------------------oo-------------------------------------------------------ooo-------------------------------------------------------------------
-----------------------------------------g--------------------------------------%%%-------------------------------------------------------------------
----------------------------------------%%-------------oooo----------------------|--------------------------------------------------------------------
------------------Q---SSSS--------------|--------------%%%%----------------------|---------------------------R---------------------SSSS---------------
----------------------------------------|----oo---SSSS--||-----------------------|-------------------r----------oooo----------------------------------
----------------------------------------|---------------||-----------------------|------------------%%%%%%%-------------------------------------------
----------------------------------------|---------------||---------------1-------|---%%%%-----------||||||-----------------------------SSSS-----------
------------------?-------%%%%---------T|---------------||------------T----------|----||---------tt-||||||----T---------------------------------------
--------------TT-----------|||---------T|-------------U-||-----------TT----TT---%%%%%%||--T------tt-||||||----T---------------------------------------
--------------TT-----------|||---------T|---------------||---B-------TT----TT----||||-||--T------tt-||||||----T------------------------------------F--
--------------TT-----------|||--gg-----T|---------------||---b-------TT---kTT----||||-||--T------tt-||||||--ooT---y------k----ggg------------------#--
XXXXXXXXXXXXXXXXXXXX%%%----|||XXXXXXXXXX|----%%%%-----%%%%%-XXXXXX--XXXXXXXXXXXX-||||-||%%XXXXXXXXXX||||||--%%XXXXXXXXXXXXXXXXXXXX---------XXXXXXXXXXX
XXXXXXXXXXXXXXXXXXXX||-----|||XXXXXXXXXX|-----||-------|||--XXXXXX--XXXXXXXXXXXX-||||-||-|XXXXXXXXXX||||||---|XXXXXXXXXXXXXXXXXXXX---------XXXXXXXXXXX
