------------------------------------------------------------------------------------------------------------------------------------------------------
------------------------------------------------------------------------------------------------------------------------------------------------------
------------------------------------------------------------------------------------------------------------------------------------------------------
--------------------SSSSSSSSSS---------------------oo-----------------------------------------------------------------------------SSSSSSSS--SSSSSSSSSS
--------------------SSSSSSSSSS--------------------%%%%------------------------------------------------------------------------------------------------
--------------------SSSSSSSSSS---------------------||-------------------------------------------------------------------------------------------------
--------------------SSSSSSSSSS---------------------||--------------------------------SUS--------------------------------------------------------------
---------------------------------------------------||--SSS--------------------------------------------------------------------------------------------
---------------------------------------------------||----------------o--------------------------------------------------------------------------------
---------------------------------------------------||------------y-------1----------------------g------------------------------SSS--------------------
----------------!-----SSSSSS?-----------------tt---||------------##---T-------------#####-------TT----------------------%--------------g##----TT------
----------------------SSSSS------------T------tt---||-----------###---T----TT-------#-----------TT----TT-------------------------------###----TT------
----------------------SSSSS------------T------tt--%||----------####---T----TT------K#-----------TT----TT----TT-----------------------g####----TT------
-M-------------------------ooo-------kkT-g----tt---||---------#####---T---kTT-------#-----------TT----TT-k--TT-k----kkk----------r---#####----TT------
XXXXXXXXXXXXXXXXXXXX-XXXXXXXXXXXXXXXXXXXXXXXXXXXXX-||-------XXXXXXX---XXXXXXXXXXXXXXXXX---XXXXXXXXX-XXXXXXXXXXXXXXXXXXXX----XXXXXXXXXXXXXX--XXXX--XXXX
XXXXXXXXXXXXXXXXXXXX-XXXXXXXXXXXXXXXXXXXXXXXXXXXXX-||-------XXXXXXX---XXXXXXXXXXXXXXXXX---XXXXXXXXX-XXXXXXXXXXXXXXXXXXXX----XXXXXXXXXXXXXX--XXXX--XXXX
