------------------------------------------------------------------------------------------------------------------------------------------------------
------------------------------------------------------------------------------------------------------------------------------------------------------
------------------------------------------------------------------------------------------------------------------------------------------------------
---------------------------------------------------oo-------------------------------------SSSSSSSSSS--------------------------------------------------
--------------------------------------------------%%%%------------------------------------------------------------------------------------------------
----------------------ooor--------------ooooo------||---------------------------K---------------------------------------------------------------k-----
---------------------%%%%%----S--------------------||---------------------------SS----1----------------------R-----oo-----SSC------------------SQS--SQ
----------------------|||-----------------------SS-||--SSS-------------------------------------------r------------------------------------------------
----------------------|||----------------SSSS------||-----------------o-----------------------------%%%%%%%-------------------------------------------
----------------------|||--------------------------||-----------------------------------------------||||||----------------SSS-------------------------
----------------!---%%%%%%%---##--SSC--------------||---------------------------SS------------------||||||-----%%%%--%%%-----------------------SQS--S?
--------------------||||||-------------------------||-------------------------#-------TT------------||||||------||----||-------------TT---------------
--------------------||||||--o---------------%%%%%-%||------------------------##-------TT------------||||||------||----||-------------TT---------------
--------------------||||||-%%%---------------|||---||--------y------------------------TT--------g-g-||||||--ooo-||----||---------#---TT------k------gg
XXXXXXXXXXXXXXXXXXXX||||||--|-XX--XXXXXX%%---|||---||-------XXXXXXXXXXXXXXXXXXXXXXXXXXXXXXXXXXXXXXXX||||||--%%%-||----||X----XXXXXXXXXXXXXXXXXXXXXXXXX
XXXXXXXXXXXXXXXXXXXX||||||--|-XX--XXXXXX|----|||---||-------XXXXXXXXXXXXXXXXXXXXXXXXXXXXXXXXXXXXXXXX||||||---|--||----||X----XXXXXXXXXXXXXXXXXXXXXXXXX
