------------------------------------------------------------------------------------------------------------------------------------------------------
------------------------------------------------------------------------------------------------------------------------------------------------------
------------------------------------------------------------------------------------------------------------------------------------------------------
--------------------SSSSSSSSSS----------SSSSSSSSSS--------------------SSSSSSSSSS----------------------------------------------------------------------
--------------------SSSSSSSSSS----------------------------------------------SSSS----------------------------------------------------------------------
--------------------SSSSSSSSSS-------------------------------------------g--SSSS--g-------------------------------------------------------------k-----
------------------Q-SSSSSSSSSS-----------oooo---------------------------SS------SSSSSSSS---------------------------oo--------------------------SQS--SQ
--------------------------------o----ooo--------------------------------SS----------------------------------------------------------------------------
-----------------------------------------SSSS-U-------------------------SS----------------------------------------------------------------------------
----------------------------------------oS--SoS----------o--------------SC--g-g-----------------g-----------------------------------------------------
------------------?---SSSSSS?---------%%SS--SSS-------------------------SS--SSSS----------------TT-------------%%%%--%%%-----------------------SQS--S?
--------------TT------SSSSS------------|--------------------------------------------------------TT--------------||----||-------------TT---------------
--------------TT------SSSSS------------|--------------------------------------------------------TT--------*-----||----||-------------TT---------------
-M------------TT-----------ooo-%%%%%%%-|--kk--------k-------gg-------g--------------------------TT--gg----*---o-||----||--kkk--------TT------k------gg
XXXXXXXXXXXXXXXXXXXX-XXXXXXXXX--|||||--|XXXXXXXXXX-XXXXXXXXXXXXXXXXXXXXXXXXXXXXXXXXXXX---XXXXXXXXXX-XXXXXXXXX-%-||----||XXXXXXXXXXXXXXXXXXXXXXXXXXXXXX
XXXXXXXXXXXXXXXXXXXX-XXXXXXXXX--|||||--|XXXXXXXXXX-XXXXXXXXXXXXXXXXXXXXXXXXXXXXXXXXXXX---XXXXXXXXXX-XXXXXXXXX---||----||XXXXXXXXXXXXXXXXXXXXXXXXXXXXXX
