------------------------------------------------------------------------------------------------------------------------------------------------------
------------------------------------------------------------------------------------------------------------------------------------------------------
------------------------------------------------------------------------------------------------------------------------------------------------------
--------------------------------------------------------------------------------------------------------------SS-------S------------------------------
--------------------------------------------?---------------------------------------------------------------------------------------------------------
----------------------ooor----------------------------------------------------------------------------------------------------------------------------
---------------------%%%%%-------------------------------Q-Q-------------------------SSSS--SSS!------------------------SSSS-------SS---------QQQQ-----
----------------------|||---------------------r-------------------------------------------------------------------------------------------------------
----------------------|||-----------------%%%%%%---------------------o---------g-----------------------------------SSS--------------------------------
----------------------|||------------------||||------------------y-----------------------------------------------------------------------------y------
--------------------%%%%%%%------------T%%-||||ooo-------Q-Q-----##----------S@SQ-------------C-------%%%%%%-----------S----------SS--------Q?SSQQQ---
--------------------||||||-------------T|--||||--r--------------###------------------------------------||||----##-----------------K---#----B----------
--------------------||||||--o----------T|%%%%%%%%%-------------####------------------------------------||||----##-------------TT------#----b----------
-M--------k---ggg---||||||-%%%--gg-----T|-||||||||------------#####--------------ggg-----------g-g-----||||----##-------------TT------#----B----------
XXXXXXXXXXXXXXXXXXXX||||||--|-XXXXXXXXXX|-||||||||XXXXXXXXXXXXXXXXX----XXXXXXXXXXXXXX----XXXXXXXXXXX%%-||||-%%-XX------X----XXXXXXXXXXXXXXXXXX--XXXXXX
XXXXXXXXXXXXXXXXXXXX||||||--|-XXXXXXXXXX|-||||||||XXXXXXXXXXXXXXXXX----XXXXXXXXXXXXXX----XXXXXXXXXXX|--||||--|-XX------X----XXXXXXXXXXXXXXXXXX--XXXXXX
