------------------------------------------------------------------------------------------------------------------------------------------------------
------------------------------------------------------------------------------------------------------------------------------------------------------
------------------------------------------------------------------------------------------------------------------------------------------------------
--------------------SSSSSSSSSSSSSSSSSSSS--------------------------------------------------------------------------------SSSSSSSSSS--------------------
-------------------------------------------------------------------------o----------------------------------------------------------------------------
------------------------------------------------------------------------%%%---------------------------------------------------------------------------
-------------------------------------------------------------------------|--o------USS-----------------------R----------------------------------------
-------------------------------------------------------------------------|--SSSS------------------oo-r------------------------------------------------
-----------------g---------------------S-----------------TT----------o%--|--------------------------%%%%%%%-------------------------------------------
-----------------#-----------C---------S-----------TT----TT------y-------|--------------------------||||||--------------------------------------------
----------S-----##-----#-#-------------S-----------TT----XX------##------|--------#-----------------||||||------!-----S-------------------------------
---------------###---#-#-#-#---#-------------------TT-----------###------|--------#-------------#---||||||----------------SS-----------------------#--
--------------####---#-#-#-#---#-#-----------------TT----------####------|-----%--##------------#---||||||----------------SS-------------------K---#--
-M-----------#####---#-#-#-#-E-#-#-------------y---TT---------#####------|--------##--gg--------#---||||||--oo------------SS------k----------------#--
XXXXXXXXXXXXXXXXXXXXXXXXXXXXXXXXXXXXXXXXXXXXXXXXXXXXXXXXXXXXXXXXXXX---%%%%%%------XXXXXXXXXXXXXXXXXX||||||--%%XXXXXXXXXX--XX--XXXXXX---XXXXXXXXXX--XXX
XXXXXXXXXXXXXXXXXXXXXXXXXXXXXXXXXXXXXXXXXXXXXXXXXXXXXXXXXXXXXXXXXXX---|||||-------XXXXXXXXXXXXXXXXXX||||||---|XXXXXXXXXX--XX--XXXXXX---XXXXXXXXXX--XXX
