------------------------------------------------------------------------------------------------------------------------------------------------------
------------------------------------------------------------------------------------------------------------------------------------------------------
------------------------------------------------------------------------------------------------------------------------------------------------------
----------------------------------------SSSSSSSSSS----------------------------------------------------------------------------------------------------
----------------------------------------SSSSSSSS------------------------------------------------------------------------------------------------------
----------------------------------------SSSCSSSS----------------------------------g-------------------------------------------------------------------
--------------------S-------------------SSSSSSSS------------------SSoo----------SSSSSSSS---------------------R------------SSC-------------------------
---------------------------TT------------------------------------------------------------------------r------------------------------------------------
---------------------------TT-----------------------------------------------------------------------%%%%%%%-------------------------------------------
---------------------------XX--------------ggg---------------------------1-----------------o--------||||||----------------SSS-------------------------
---------Q-------------TT------TT-------SSSSSSSS------S-----%%%%%%----T--------------------------TT-||||||------!-----S--------------------#----------
-----------------------TT------TT-------SSSSSSSS--TT---------||||-----T----TT--------------------TT-||||||--------------------------------##----------
-----------------------TT------TT-------SSSSSSSS--TT---------||||-----T----TT--------------------TT-||||||-------------------------------###-------F--
--------------k-ggg-k--TT-----gTT-------SSSSSSSS--TT------k--||||-----T---kTT--------------------TT-||||||--oo-------------------#---y--####-------#--
XXXXXXXXXXXXXXXXXXXXXXXXXXXXXXXXXXXXXX--XXXXXXXXXXXXXXXXXXXX-||||-----XXXXXXXXXXXXXXXX---XXXXXXXXXXX||||||--%%XXXXXXXXXXX----XXXXXXXXXXXXXXXXXXXXXXXXX
XXXXXXXXXXXXXXXXXXXXXXXXXXXXXXXXXXXXXX--XXXXXXXXXXXXXXXXXXXX-||||-----XXXXXXXXXXXXXXXX---XXXXXXXXXXX||||||---|XXXXXXXXXXX----XXXXXXXXXXXXXXXXXXXXXXXXX
