------------------------------------------------------------------------------------------------------------------------------------------------------
------------------------------------------------------------------------------------------------------------------------------------------------------
------------------------------------------------------------------------------------------------------------------------------------------------------
----------SSSSSSSSSS----------SSSSSSSSSS--------------------------------------------------------------------------------------------------------------
------------------------------SSSSSSSSSS--------------------------------------------------------------------------------------------------------------
------------------------------SSSSSSSSSS--------------------------------------------------------------------------------------------------------------
------------------------------SSSSSSSSSS-----------------------------------g-------------------------------------------------------------##-SSS-------
-------------------------------------------------------------o---o---o-%%%%%%------------------------------------------------------------##-----------
------------------------------------------------------------%%%-%%%-%%--||||-----------------------------------------------------------####-----------
-------------------------------------------------------------|---|---|--||||------o----------------------------------------------------####------SSSSS
----------@QQQQ-------------TTSSSSSSSSSS--------------S------|---|---|--||||-----------TT--------------------------------------------######-----------
----------------------------TTSSSSSSSSSS----------TT---------|---|---|--||||-----------TT-------------------g------------------------######-----------
-----------------g-#--------TTSSSSSSSSSS----------TT---------|---|---|--||||-----------TT-------------------TT-----------------------######-SSS-------
-M--------------g#-#----ggg-TTSSSSSSSSSS-------y--TT------k--|---|-r-|--||||-----------TT----------g--------TT-k----kkk--k----ggg----######--------r--
XXXXXXXXXXXXXXXXXXXXXXXXXXXXXXXXXXXXXXXXXXXXXXXXXXXXXXXXXXXX%%%%%%%%%%--||||----XXXXXXXXXX-XXXXXXXXX--XXXXXXXXXXXXXXXXXXXXXXXXXXXXXXXXXXXXXX-----XXXXX
XXXXXXXXXXXXXXXXXXXXXXXXXXXXXXXXXXXXXXXXXXXXXXXXXXXXXXXXXXXX-|||||||||--||||----XXXXXXXXXX-XXXXXXXXX--XXXXXXXXXXXXXXXXXXXXXXXXXXXXXXXXXXXXXX-----XXXXX
