------------------------------------------------------------------------------------------------------------------------------------------------------
------------------------------------------------------------------------------------------------------------------------------------------------------
------------------------------------------------------------------------------------------------------------------------------------------------------
--------------------------------------------------------------------------------------------------------------SSSSSSSSSSSSSSSSSSSS--------------------
--------------------------------------------?----------------------------o----------------------------------------------------------------------------
------------------------------------------------------------------------%%%-----------------oo--------------------------------------------------------
---------------------------------------------------------Q-Q------SSoo---|--o------USS------------------SSQSSS------------------------------SSS-------
--------------------------------o----ooo------r--------------------------|--SSSS----------------------------------------------------------------------
------------------------------------------%%%%%%----------------------%--|-------------------------%--------------------------------------------------
-------------------------------------------||||--------------------------|--------------------------------K--------------------------------------SSSSS
---------Q---------%--------TT--------%%%%-||||ooo-------Q-Q%%%%%%-------|--------#-------S-------------SSSSSST---------------------------------------
----------------------------TT---------||--||||--r-----------||||--------|--------#---------------------------T-----------SS---------TT---------------
----------------------------TT---------||%%%%%%%%%-----------||||--------|-----%--##---------%%%%-------------T----TT-----SS---------TT-----SSS-------
-M-----------%%%%-------ggg-TT-%%%%%%%-||-||||||||-----------||||--------|--------##--gg------||--------------T--g-TT-----SS---------TT------------r--
XXXXXXXXXXX---||----XXXXXXXXXX--|||||--||-||||||||XXXXXXXXXX-||||-----%%%%%%------XXXXXXXX----||----XXXXXXXXXXXXXXXXXXXX--XX--XXXXXXXXXXXXXX-----XXXXX
XXXXXXXXXXX---||----XXXXXXXXXX--|||||--||-||||||||XXXXXXXXXX-||||-----|||||-------XXXXXXXX----||----XXXXXXXXXXXXXXXXXXXX--XX--XXXXXXXXXXXXXX-----XXXXX
