------------------------------------------------------------------------------------------------------------------------------------------------------
------------------------------------------------------------------------------------------------------------------------------------------------------
------------------------------------------------------------------------------------------------------------------------------------------------------
------------------------------SSSSSSSSSS--------------------------------------------------------------------------------------------------------------
------------------------------SSSSSSSSSS--------------------------------------------------------------------------------------------------------------
------------------------------SSSSSSSSSS--------------------------------------------------------------------------------------------------------k-----
-----------------------------USSSSSSSSSS---------------------------------------------1-----SSS!--------------R?SSS--------SSC------------------SQS--SQ
-----------------------------------------------------------------------------------------------------r------------------------------------------------
---------------------------------------------------------TT--------------------g--------------------%%%%%%%-------------------------------------------
---------------------------------------------------TT----TT-----------------------------------------||||||----------------SSS-------------------------
----------------------------##SSSSSSSSSS-----------TT----XX------------------S@S---QQQQ-------C-----||||||----SSSSS----------------------------SQS--S?
-----------------------y-#####SSSSSSSSSS-----------TT-----------------------------------------------||||||--------------------------------------------
--------------------y-######--SSSSSSSSSS-----------TT-----------------------------------------------||||||--------------------------------------------
---M----------k-ggg-######----SSSSSSSSSS-------ggg-TT-------gg-------g--------------yy---------g-g--||||||--oo--K----------------#k----------k------gg
XXXXXXXXXXXXXXXXXXXXXXXX------XXXXXXXXXX-XXXXXXXXXXXXXXXXXXXXXXXXXXXXX-XXXXXXXXXXXXXXXXXXXXXXXXXXXXX||||||--%%XXXXXXXXXXX----XXXXXXX---XXXXXXXXXXXXXXX
XXXXXXXXXXXXXXXXXXXXXXXX------XXXXXXXXXX-XXXXXXXXXXXXXXXXXXXXXXXXXXXXX-XXXXXXXXXXXXXXXXXXXXXXXXXXXXX||||||---|XXXXXXXXXXX----XXXXXXX---XXXXXXXXXXXXXXX
