------------------------------------------------------------------------------------------------------------------------------------------------------
------------------------------------------------------------------------------------------------------------------------------------------------------
------------------------------------------------------------------------------------------------------------------------------------------------------
----------------------------------------------------------------------SSSSSSSSSS----------------------------------------------------------------U-----
----------------------------------------------------------------------------SSSS----------------------------------------------------------------------
-------------------------------------------------------------------------g--SSSS------------oo--------------------------------------------------------
----------------------!---------------------------------------USSS------SS---------USS--------------------2-----------USSSS---------------------------
------------------------------------------------------------------------SS--------------------------------------------------------oo--------------SS--
------------------------------------------------------------------------SS-------------------------%--------------------------------------------------
------------Q--?--------------------------------------------------------SC--g-g---------------------o---------------E-------------------------SS------
-------------------SS@S!S------TT---------------------S------S-----TT---SS--SSSS--#-------SS--------------2--------TT----------------------Q---------#
-------------------------------TT-----------------TT---------------TT-------------#--------------------------------TT--t----------------------------##
----------------------------tt-TT-----------------TT---------------TT-------------##---------%%%%------------------TT--t------TT-------------------###
-M----------------K--g------ttgTT--------------y--TT------k--ggg---TT-------------##--gg------||--------y--y----g--TT--t------TT------------------####
XXXXXXXXXXXXXXXXXXXXXXXXXXXXXXXXXXXXXX--XXXXXXXXXXXXXXXXXXXXXXXXXXXXXXXXXXXXXXXX--XXXXXXXX----||----XXXXXXXXXXXXXXXXXXXX----XXXXXXXXXXXXXXXXXXXXX-XXXX
XXXXXXXXXXXXXXXXXXXXXXXXXXXXXXXXXXXXXX--XXXXXXXXXXXXXXXXXXXXXXXXXXXXXXXXXXXXXXXX--XXXXXXXX----||----XXXXXXXXXXXXXXXXXXXX----XXXXXXXXXXXXXXXXXXXXX-XXXX
