------------------------------------------------------------------------------------------------------------------------------------------------------
------------------------------------------------------------------------------------------------------------------------------------------------------
------------------------------------------------------------------------------------------------------------------------------------------------------
----------------------------------------SSSSSSSSSS------------------------------SSSSSSSSSS------------------------------------------------------U-----
----------------------------------------SSSSSSSS------------------------------------------------------------------------------------------------------
----------------------ooor--------------SSSCSSSS------------------------------------------------------------------------------------------------------
---------------------%%%%%--------------SSSSSSSS----------------------------SSSS------------------------------------------oo---%%%-------##-----------
----------------------|||---------------------------------------------------------------------------oo--------------------SS----||-------##-------SS--
-----------------g----|||-------------------------------------------------------------------------------------------------------||-----####-----------
-----------------#----|||------------------ggg-------------------------------K---------S-------oooo-----------------------------||-----####---SS------
----------S-----##--%%%%%%%-------------SSSSSSSS---------------------------SSSSSSU---------------------------T--------r------SS-||---######----------#
---------------###--||||||--------------SSSSSSSS----K-----------------T-------------TT---t-------------------T----%%%%%%--------||---######---------##
--------------####--||||||--o-----------SSSSSSSS----------------------T-------------TT---t-------------------T-----|||||--------||---######--------###
-M-----------#####--||||||-%%%----k-k---SSSSSSSS-----------ggg-------gT------------kTT--kt----------------y--T-----|||||--------||---######-------####
XXXXXXXXXXXXXXXXXXXX||||||--|-XXXXXXXXX-XXXXXXXXXXXXXXXXXXXXXXXXXXXXXXXXXXXXXXXXXXXXXXXXXX%%%%%%%-%%XXXXXXXXXX-%%%-|||||%%-----%%%XXXXXXXXXXXXXXX-XXXX
XXXXXXXXXXXXXXXXXXXX||||||--|-XXXXXXXXX-XXXXXXXXXXXXXXXXXXXXXXXXXXXXXXXXXXXXXXXXXXXXXXXXXX||||||---|XXXXXXXXXX--|--||||||-------||XXXXXXXXXXXXXXX-XXXX
