------------------------------------------------------------------------------------------------------------------------------------------------------
------------------------------------------------------------------------------------------------------------------------------------------------------
------------------------------------------------------------------------------------------------------------------------------------------------------
----------------------------------------------------------------------------------------------------SSSSSSSSSS----------------------------------------
-----------------------------------------------------------------------------------------------------------------------------------------------------o
------------------------------------------------------------------------------------------------------------------------------------------------------
-------------------------------------------------------------------------------------------------------------------------------SSS--------------------
-----------------------------------------------------------------------------------------------------------------SSS----------------------------SSS---
----------------------------------------------------------------------o---------------------------------------------------------------------oo--------
----------------------------------------------------------------------------------o------------oooo-----------------------------K---------------------
----------Q-----------------------------------tt---------------------------------------TT--------------------T-----------------SSS----------SS--------
---------------------------------------T------tt----K----------------T--------#--------TT--------------TT----T----------------------------------------
---------------------------------------T------tt-------------B-------T-------##--------TT--------------TT----T-----------TT---------------------------
-M-----------------#-----ggg---------kkT-g----tt-----------g-b-------T-----------------TT-----------g--TT----T-----------TT---------------------------
XXXXXXXXXXXXX--XXXXXXXXXXXXXXXXXXXXXXXXXXXXXXXXXXXXXXXXXXXXXXXXXXX--XXXXXXXXXXXXXXXXXXXXXX%%%%%%%-%%XXXXXXXXXX%%%%----%%XXXXXXXXXXXXXXXXXXXX----------
XXXXXXXXXXXXX--XXXXXXXXXXXXXXXXXXXXXXXXXXXXXXXXXXXXXXXXXXXXXXXXXXX--XXXXXXXXXXXXXXXXXXXXXX||||||---|XXXXXXXXXX|||------|XXXXXXXXXXXXXXXXXXXX----------
