------------------------------------------------------------------------------------------------------------------------------------------------------
------------------------------------------------------------------------------------------------------------------------------------------------------
------------------------------------------------------------------------------------------------------------------------------------------------------
----------SSSSSSSSSSSSSSSSSSSSSSSSSSSSSS----------------------------------------SSSSSSSSSLSSSSSSSSSSSSSSSSSSSS----------------------------------------
------------------------------SSSSSSSSSS--------------------------------------------------------------------------------------------------------------
------------------------------SSSSSSSSSS---------------oooo-------------------------------------------------------------------------------------k-----
------------------------------SSSSSSSSSS---------------%%%%-------------------------oooooo--------------------------------SSC-----SS-----------SQS--SQ
--------------------------------------------------------||--------------------------------------------------------------------------------------------
--------------------------------------------------------||---------------------g----SSSSSS------------------------------------------------------------
-----------------------------C--------------------SSS---||--------------------------SSSSSS--------------------------------SSS-------------------------
----------@QQQQ--------#-#----SSSSSSSSSS------tt--------||-----------T-------S@S-----------------------------T--------------------SS-----------SQS--S?
---------------------#-#-#-#--SSSSSSSSSS------tt------U-||-----------T---------------------------------TT----T--------------------K---#----B----------
-----------------g-#-#-#-#-#--SSSSSSSSSS------tt--------||-----------T---------------------------------TT----T------------------------#----b----------
-M--------------g#-#-#-#-#-#-ESSSSSSSSSS-g----tt--------||----ggg----T--------------------------g-g-g--TT----T-k----kkk----------#----#----B-k------gg
XXXXXXXXXXXXXXXXXXXXXXXXXXXXXXXXXXXXXXXXXXXXXXXXXX----%%%%%-XXXXXXXXXX-XXXXXXXXX---XXXXXXXXXXXXXXXXXXXXXXXXXXXXXXXXXXXXXX----XXXXXXXXXXXXXXXXXXXXXXXXX
XXXXXXXXXXXXXXXXXXXXXXXXXXXXXXXXXXXXXXXXXXXXXXXXXX-----|||--XXXXXXXXXX-XXXXXXXXX---XXXXXXXXXXXXXXXXXXXXXXXXXXXXXXXXXXXXXX----XXXXXXXXXXXXXXXXXXXXXXXXX
