------------------------------------------------------------------------------------------------------------------------------------------------------
------------------------------------------------------------------------------------------------------------------------------------------------------
------------------------------------------------------------------------------------------------------------------------------------------------------
S-----SSSS----------------------oo----------------SSSSSSSSSS----------------------------------------SSSSSSSSSS--------------------SSSSSSSSSS----------
S------------------------------------g-g--------------SS--SS------------------------------------------------------------------------------------------
S---------------------ooor---------%%%%%--------------SS--SS------------------------------------------------------------------------------------------
S--------------------%%%%%----------||||------QQQQ--SS-----------------------------USS------------------------?SSS---------------------------------SSS
S---------------------|||-----------||||------------SS------------------------------------------------------------------------------------------------
S---------------------|||-----------||||------------SS------------------------------------------------------------------------------------------------
S---------------------|||-----%%%%%-||||--------k---SS----oo-------------------------------------------------------------------SSS--------------------
S---------------%%%%%%%%%%%----|||--||||T-----?QQQ--SSSS--SS---------T------------#-------------TT---------TT-SSSSS-----%-------------------------#---
S----------------||-||||||-----|||--||||T-------------SS-------------T------------#-------------TT------#--TT-----------------------------TT------#---
S----------------||-||||||--o--|||--||||T-------------SS-------------T------------##------------TT-----##--TT----------------------tt-----TT------#---
S----------------||-||||||-%%%-|||--||||T---------------------ggg----T------------##--gg----k---TT--kk-##--TT---K----------------r-tt----kTT-ggg--#---
XXXXXXXXXXX--%%%%||%||||||--|--|||--||||XXXXXXXXXXXXXXXXXXXXXXXXXXXXXXX----XXXXX--XXXXXXXXXXXXXXXXXXXXXXX--XX-XXXXXXXXXX----XXXXXXXXXXXXXXXXXXXXXXXXXX
XXXXXXXXXXX---||-||-||||||--|--|||--||||XXXXXXXXXXXXXXXXXXXXXXXXXXXXXXX----XXXXX--XXXXXXXXXXXXXXXXXXXXXXX--XX-XXXXXXXXXX----XXXXXXXXXXXXXXXXXXXXXXXXXX
