------------------------------------------------------------------------------------------------------------------------------------------------------
------------------------------------------------------------------------------------------------------------------------------------------------------
------------------------------------------------------------------------------------------------------------------------------------------------------
------------------------------------------------------------------------------------------------------------------------------------------------------
------------------------------------------------------------------------------------------------------------------------------------------------------
----------------------------------------ooooo----------oooo-------------------------------------------------------------------------------------------
-----------------------------U-------------------------%%%%--------------------------SSSS--------------------R-----oo-----SSC------SSSS---------------
------------------------------------------------SSSSSS--||-----------------------------------------------r--------------------------------------------
-----------------g-----------------------SSSS-----------||-----------o------------------------------%%%%%%%-------------------------------------------
-----------------#--------------------------------------||-------y-------1--------------------------||||||----------------SSS----------SSSS-----------
----------S-----##----------##--------------------------||-------##---T---------Q---------------TT--||||||-----%%%%--%%%--------------------#---------
---------------###-----y-#####---------T--------------U-||------###---T----TT-------------------TT--||||||------||----||--------------------##--------
--------------####--y-######-----------T----%%%%%-------||-----####---T----TT-------------------TT--||||||------||----||--------------------###------#
-M-----------#####--######-----------kkT-----|||--------||----#####---T---kTT----ggg--------k---TT--||||||--ooo-||----||---------#----------####----##
XXXXXXXXXXXXXXXXXXXXXXXX------XXXXXXXXXX%%---|||------%%%%%-XXXXXXX---XXXXXXXXXXXXXXX----XXXXXXXXXXX||||||--%%%-||----||X----XXXXX---------XXXXXXXXXXX
XXXXXXXXXXXXXXXXXXXXXXXX------XXXXXXXXXX|----|||-------|||--XXXXXXX---XXXXXXXXXXXXXXX----XXXXXXXXXXX||||||---|--||----||X----XXXXX---------XXXXXXXXXXX
