------------------------------------------------------------------------------------------------------------------------------------------------------
------------------------------------------------------------------------------------------------------------------------------------------------------
------------------------------------------------------------------------------------------------------------------------------------------------------
----------SSSSSSSSSS----------------------------------------------------------------------------------------------------------------------------------
-----------------------------------------------------------------------------------------------------------------------------------------------------o
----------------------ooor------------------------------------------------------------------oo--------------------------------------------------------
---------------------%%%%%----------------------------------------SSoo-----g-------USS------------------------?SSS---------------------US-------------
----------------------|||----------------------------------------------%%%%%%-----------------------oo------------------------------------------SSS---
----------------------|||--------------------------------TT-------------||||-----------------------%----------------------------------------oo--------
----------------------|||--------------------------TT----TT-------------||||---------------------------------------------------SSS---SS---------------
--------------------%%%%%%%------------------------TT----XX-%%%%%%------||||------#-------SS-----------------TSSSSS-----%------------------SSS--------
--------------------||||||------------tt-----------TT--------||||-------||||------#--------------------------T----------------------------------------
--------------------||||||--o---------tt-----------TT--------||||-------||||------##---------%%%%------------T--------------------TT------------------
-M------------------||||||-%%%--------tt-----------TT--------||||-------||||------##--gg------||----------y--T--K----------------rTT------------------
XXXXXXXXXXX--XX--X--||||||--|-XXXXXXXXXXX-XX-XX-XXXXXXXXXXXX-||||-------||||------XXXXXXXX----||----XXXXXXXXXXXXXXXXXXXX----XXXXXXXXXXXX-X-X----------
XXXXXXXXXXX--XX--X--||||||--|-XXXXXXXXXXX-XX-XX-XXXXXXXXXXXX-||||-------||||------XXXXXXXX----||----XXXXXXXXXXXXXXXXXXXX----XXXXXXXXXXXX-X-X----------
