------------------------------------------------------------------------------------------------------------------------------------------------------
------------------------------------------------------------------------------------------------------------------------------------------------------
------------------------------------------------------------------------------------------------------------------------------------------------------
S-----SSSS----------SSSSSSSSSS------------------------------------------------------------------------------------------------------------------------
S-------------------SSSSSSSSSS------------------------------------------------------------------------------------------------------------------------
S-------------------SSSSSSSSSS------------------------------------------------------------------------------------------------------------------------
S-------------------SSSSSSSSSSS-------------------Q------------------------g---------------------------------R-----oo---------------------------------
S----------------------------------------------------------------------%%%%%%---------------------oo-----r--------------------------------------------
S-----------------------------------------------------------------------||||------TT----------------%%%%%%%--------------------------g#---------------
S-----------------------------------------------------------------------||||------TT----------------||||||--------------------------g##---------------
S---------------!-----SSSSSS?-##--SSC-------------Q------------------T--||||------TT----------------||||||-----%%%%--%%%------------###---------------
S---------------------SSSSS------------------------------------------T--||||------TT-----T------#---||||||------||----||-----------####------------#--
S---------------------SSSSS------------------------------------------T--||||----T-TT-----T------#---||||||------||----||----------#####--------K---#--
S--M-----------------------ooo-----------------------gg----k--ggg----T--||||----T-TT---k-T------#---||||||--ooo-||----||--kkk-----#####------------#--
XXXXXXXXXXXXXXXXXXXX-XXXXXXXXXXX--XXXXXXX-XX-XX-XXXXXXXXXXXXXXXXXXXXXX--||||----XXXXXXXXXXXXXXXXXXXX||||||--%%%-||----||XXXXXXXXXXXXXXX--XXXXXXXX--XXX
XXXXXXXXXXXXXXXXXXXX-XXXXXXXXXXX--XXXXXXX-XX-XX-XXXXXXXXXXXXXXXXXXXXXX--||||----XXXXXXXXXXXXXXXXXXXX||||||---|--||----||XXXXXXXXXXXXXXX--XXXXXXXX--XXX
