------------------------------------------------------------------------------------------------------------------------------------------------------
------------------------------------------------------------------------------------------------------------------------------------------------------
------------------------------------------------------------------------------------------------------------------------------------------------------
------------------------------------------------------------------------------------------------------------------------------------------------------
--------------------------------------------?-----?---------------------------------------------------------------------------------------------------
--------------------------------------------------------------g-----------------------------oo--------------------------------------------------------
--------------------------------------------------------------SSSSS------------------SSSS-------------------------------SSS------------US-------------
----------------------------------------------r---SS------------------------------------------------oo-----------SSS----------------------------------
-----------------g------------------------%%%%%%---------------------------------------------------%--------------------------------------------------
-----------------#-------------------------||||--------------------------------------------------------------------------------------SS---------------
---------QS-----##--------------QQQQ----%%-||||ooo------------------------------Q---------SS-----------------T-----------------------------S--#LSS----
---------------###-------------------K-B|--||||--r-----SSS---------------------------------------------------T--------------------------------#-------
--------------####---------------------b|%%%%%%%%%------------TT-----t-----------------------%%%%------------T----------------TT--TT----------#-------
-M-----------#####-------ggg-----------b|-||||||||------------TT-----t-----------ggg----------||----------y--T----------------TT--TT--------kk#-------
XXXXXXXXXXXXXXXXXXXXXXXXXXXXXXXXXXXXXXXX|-||||||||----------XXXXXXXXXXX----XXXXXXXXXX----X----||----XXXXXXXXXX%%%%----%%----XXXXXXXXXXXX-X-XXXXXXXX---
XXXXXXXXXXXXXXXXXXXXXXXXXXXXXXXXXXXXXXXX|-||||||||----------XXXXXXXXXXX----XXXXXXXXXX----X----||----XXXXXXXXXX|||------|----XXXXXXXXXXXX-X-XXXXXXXX---
