------------------------------------------------------------------------------------------------------------------------------------------------------
------------------------------------------------------------------------------------------------------------------------------------------------------
------------------------------------------------------------------------------------------------------------------------------------------------------
------------------------------SSSSSSSSSSSSSSSSSSSS-oo---------------------------SSSSSSSSSS------------------------------------------------------------
------------------------------SSSSSSSSSS----------%%%%-----------------------------------------------------------------------------------------------o
------------------------------SSSSSSSSSS-----------||-------------------------------------------------------------------------------------------------
-----------------------------USSSSSSSSSS-oooo------||---------USSS----------SSSS------------------------SSQSSS-----oo--------------SSSS---------------
---------------------------------------------------||--SSS--------------------------------------------------------------------------------------SSS---
-----------------------------------------SSSS-U----||-------------------------------------------------------------------------SSS-----------oo--------
------------Q--?------------------------oS--SoS----||------------------------K---------S----------oo------K----------------------------SSSS-----------
-----SSS-----------S--------##SSSSSSSSSSSS--SSS----||--------S-----TT------SSSSSSU----------------------SSSSSS-%%%%--%%%%-------------------SS--------
-----------------------y-#####SSSSSSSSSS-----------||--------------TT-T-------------TT---t-----TT---------------||----||------------------------------
--------------------y-######--SSSSSSSSSS----------%||--------------TT-T-------------TT---t-----TT---------------||----||------------------------------
------------------K-######----SSSSSSSSSS--kk-------||--------ggg---TT-T------------kTT--kt--y--TT-------------o-||----||---------r--------------------
XXXXXXXXXXXXXXXXXXXXXXXX------XXXXXXXXXXXXXXXXXXXX-||-------XXXXXXXXXXXXXXXXXXXXXXXXXXXXXXXXXXXXXXXXXXXXXXXXXX%-||----||----XXXXXX---------X----------
XXXXXXXXXXXXXXXXXXXXXXXX------XXXXXXXXXXXXXXXXXXXX-||-------XXXXXXXXXXXXXXXXXXXXXXXXXXXXXXXXXXXXXXXXXXXXXXXXXX--||----||----XXXXXX---------X----------
