------------------------------------------------------------------------------------------------------------------------------------------------------
------------------------------------------------------------------------------------------------------------------------------------------------------
------------------------------------------------------------------------------------------------------------------------------------------------------
--------------------------------------------------------------------------------SSSSSSSSSLSSSSSSSSSS------------------------------SSSSSSSSSS----------
------------------------------------------------------------------------------------------------------------------------------------------------------
----------------------------------------%%------------------------------------------------------------------------------------------------------------
------------------------------S---------|---------Q-------------------------SSSS----oooooo----------------2--------oo-----oo---%%%--------------------
----------------------------------------|----oo---------------------------------------------------------------------------SS----||--------------------
----------------------------------------|-------------------------------------------SSSSSS--------------------------------------||--------------------
----------------------------------------|-----------------------1------------K------SSSSSS----------o---------------------------||--------------------
-------------------%----------##--SSC---|---------Q------------------------SSSSS--------------------------2----%%%%--%%%-----SS-||--------------------
----------------------------------------|-----------------------------T-------------------t---------------------||----||--------||--------TT----------
----------------------------------------|-----------------------------T-------------------t---------------------||----||--------||-tt-----TT-------F--
-M-----------%%%%--------ggg------------|------------gg----k----------T-------------------t-------------y--y--o-||----||--------||-tt----kTT-------#--
XXXXXXXXXXX---||----XXXXXXXXXXXX--XXXXXX|----%%%%-XXXXXXXXXXXXXXXXXXX-XXXXXXXXXX---XXXXXXXXXXXXXXXXXXXXXXXXXXX%-||----||%%-----%%%XXXXXXXXXXXXXXXXXXXX
XXXXXXXXXXX---||----XXXXXXXXXXXX--XXXXXX|-----||--XXXXXXXXXXXXXXXXXXX-XXXXXXXXXX---XXXXXXXXXXXXXXXXXXXXXXXXXXX--||----|||-------||XXXXXXXXXXXXXXXXXXXX
