------------------------------------------------------------------------------------------------------------------------------------------------------
------------------------------------------------------------------------------------------------------------------------------------------------------
------------------------------------------------------------------------------------------------------------------------------------------------------
--------------------------------------------------------------------------------------------------------------------------------------------SSSSSSSSSS
------------------------------------------------------------------------------------------------------------------------------------------------------
----------------------------------------ooooo----------oooo-------------------------------------------------------------------------------------------
---------------------LSSS------------------------------%%%%----------------g-------USS----SSS------%------------------------------%-------------------
------------------------------------------------SS------||-------------%%%%%%-------------------------------------------------------------------------
-----------------------------------------SSSS-----------||--------------||||-------------------------------------------y----------------SSS-----------
--------------------------------------------------SSS---||--------------||||-------------------------------------------XSS-?Q-------------------------
---------------------2-----#-----------T----------------||-----------#--||||------#---------%%%-------%%%%%%----------XX----------%%%%%-------TT------
-----------------K---------#-----------T--------------U-||----------##--||||------#----------|---------||||----------XXX-----------|||--------TT------
------------B--------------##----------T----%%%%%-------||--TT-----###--||||------##---------|---------||||---------XXXX-------y---|||--------TT------
-M----------b---------kk---##---gg-----T-----|||--------||--TT----####--||||------##--gg-----|---------||||--------XXXXX---SSSSS---|||--------TT------
XXXXXXXXXXXXXXXXXXXXXXXXXXXXXXXXXXXXXXXX%%---|||------%%%%%-XXXXXXXXXX--||||------XXXXXXXX---|------%%-||||-%%XXXXXXXXXX-------XX-%|||------XXXX--XXXX
XXXXXXXXXXXXXXXXXXXXXXXXXXXXXXXXXXXXXXXX|----|||-------|||--XXXXXXXXXX--||||------XXXXXXXX---|------|--||||--|XXXXXXXXXX-------XX--|||------XXXX--XXXX
