------------------------------------------------------------------------------------------------------------------------------------------------------
------------------------------------------------------------------------------------------------------------------------------------------------------
------------------------------------------------------------------------------------------------------------------------------------------------------
------------------------------SSSSSSSSSS--------------------------------------------------------------------------------------------------------------
------------------------------------------------------------------------------------------------------------------------------------------------------
----------------------------------------%%----------------------------------------------oo------------oo----------------------------------------------
---------------------LSSS---------------|---------------------USSS------SSSSS---oo---------------------------------oo-------------!S------------------
----------------------------------------|----oo-------------------------------------------------------------------------------------------------------
-----------------%%%-------------------S|------------------------------------------------------------------------------------SSS----------------------
------------------||-------------------S|----------------------------------------SSS------------------------------------------------------------------
------------------||-2-----#-----------S|--------------ooo---S-----TT--------2-----------S---------------------%%%%--%%%r---------S------#----#LSS----
-------------%%%%%||-------#---#--------|--------------------------TT------TT-----------------------------------||----||%%%%%%----------##----#-------
--------------|||-||-------##--#-#------|--------------------------TT-t----TT--T----------------------------tt--||----|||||||----------###----#-------
-M------------|||-||--kk---##--#-#------|--------------------ggg---TT-t----TT--T-------------------g--ggg---tto-||----|||||||---------####--kk#-------
XXXXXXXXXXX---|||-||XXXXXXXXXXXXXXXXXXXX|----%%%%---XXXXXXXXXXXXXXXXXXXXXXXXXXXX-----------XXXXXXXXXXXXXXXXXXX%-||----|||||||-----XXXXXXXXXXXXXXXXX---
XXXXXXXXXXX---|||-||XXXXXXXXXXXXXXXXXXXX|-----||----XXXXXXXXXXXXXXXXXXXXXXXXXXXX-----------XXXXXXXXXXXXXXXXXXX--||----|||||||-----XXXXXXXXXXXXXXXXX---
