------------------------------------------------------------------------------------------------------------------------------------------------------
------------------------------------------------------------------------------------------------------------------------------------------------------
------------------------------------------------------------------------------------------------------------------------------------------------------
--------------------------------oo-----------------oo-------------------------------------------------------------------------------------------------
-------------------------------------g-g----------%%%%------------------------------------------------------------------------------------------------
-----------------------------------%%%%%-----------||-------------------------------------------------------------------------------------------------
------------------Q-----------------||||-----------||--------------------------------SUS------------------------------US------------------------------
------------------------------------||||-----------||--SSS------------------------------------------------TT----------------------oo------------------
------------------------------------||||-----------||-----------------------------------------------------TT------------------------------------------
------------------------------%%%%%-||||-----------||-----------1--------1--------------------------------TT--------E----------SSS--------------------
------------------?------------|||--||||-----------||-----------------T-------------#####----------------SXXS------TT---%------------------Q#---------
--------------TT---------------|||--||||-----------||-----------------T----TT-------#------------------------------TT--t--------------------##--------
--------------TT---------------|||--||||----------%||-----------------T----TT------K#---------------TT-------------TT--t--------------------###------#
-M------------TT---------ggg---|||--||||-------ggg-||-----------------T---kTT-------#--------------gTT----------g--TT--t---------r----------####----##
XXXXXXXXXXXXXXXXXXXXXXXXXXXXXX-|||--||||-XXXXXXXXX-||-------XXXXXXXXX-XXXXXXXXXXXXXXXXX----XXXXXXXXXXXXXXXXXXXXXXXXXXXXX----XXXXXXXXXXXXXXXXXXXXXXXXXX
XXXXXXXXXXXXXXXXXXXXXXXXXXXXXX-|||--||||-XXXXXXXXX-||-------XXXXXXXXX-XXXXXXXXXXXXXXXXX----XXXXXXXXXXXXXXXXXXXXXXXXXXXXX----XXXXXXXXXXXXXXXXXXXXXXXXXX
