------------------------------------------------------------------------------------------------------------------------------------------------------
------------------------------------------------------------------------------------------------------------------------------------------------------
------------------------------------------------------------------------------------------------------------------------------------------------------
--------------------------------------------------------------------------------SSSSSSSSSS------------------------------------------------------------
------------------------------------------------------------------------------------------------------------------------------------------------------
--------------------------------------------------------------g-----------------------------oo--------------------------------------------------------
-----------------------------U--------------------------------SSSSS-----------------------------------------------------SSS--------------##-----------
-----------------------------------------------------------------------------------------------------------------------------------------##-----------
---------------------------------------------------------------------------------------------------%-----------------------------------####-----------
-----------------------------------oo--------------------------------------------------S-----------------------------------------------####-----------
-------------------%--------##----o--o----------------S-------------------------SU--------S---------------------!-----S--------------######-----------
-----------------------y-#####--------------------TT--------------------------------TT---t------------TT-----------------------------######-----------
--------------------y-######----------------------TT----------TT-----t--------------TT---t---%%%%-----TT----TT----------------TT-----######--------F--
-M-----------%%%%---######------------------------TT------k---TT-----tgg-----------kTT--kt----||------TT-k--TT----------------TT-----######--------#--
XXXXXXXXXXX---||----XXXX------XXXXXXXXXXX-XX-XX-XXXXXXXXXXXXXXXXXXXXXXXXXXXXXXXXXXXXXXXXXX----||----XXXXXXXXXXXXXXXXXXXX----XXXXXXXXXXXXXXXXXXXXXXXXXX
XXXXXXXXXXX---||----XXXX------XXXXXXXXXXX-XX-XX-XXXXXXXXXXXXXXXXXXXXXXXXXXXXXXXXXXXXXXXXXX----||----XXXXXXXXXXXXXXXXXXXX----XXXXXXXXXXXXXXXXXXXXXXXXXX
