------------------------------------------------------------------------------------------------------------------------------------------------------
------------------------------------------------------------------------------------------------------------------------------------------------------
------------------------------------------------------------------------------------------------------------------------------------------------------
--------------------------------------------------SSSSSSS-----------------------------------------------------SS-------S------------------------------
------------------------------------------------------------------------------------------------------------------------------------------------------
-----------------------SSS--------------%%--------------------g---------------------------------------------------------------------------------------
----------------------------------------|---------QQ----------SSSSS--------1--------y------------------------R---------S-SSS----S!-------##-SSS-------
---------------------g------------------|----oo-----------------------------------#SSS---------------r-----------------------------------##-----------
--------------------%%%-----------------|------------------S---------------------##-----------------%%%%%%%--------SSS-----------------####-----------
--------------------||----SSS-----------|----------------------------------ggg--###1--------------oo||||||-----------------------------####------SSSSS
-------------------%||----------QQQQ----|---------QQ--QQQ-------------#########-###-----------------||||||-------------S---------S---######-----------
--------------------||---------------K-B|-------------------------------------#-###--SSS-------TT---||||||-----##--------------------######-----------
--------------------||-----------------b|---------------------TT-----t--------#-###------------TT---||||||-----##--------------------######-SSS-------
---M---------%%%%---||----oo-----------b|---------------------TT-----t--------#-###---------y--TT---||||||--oo-##-----------gg-g-g---######--------r--
XXXXXXXXXXX---||----||---%%%--XXXXXXXXXX|----%%%%-XXXXXXX---XXXXXXXXXX--------X-XXXXXX---XXXXXXXXXXX||||||--%%-XX------XXXXXXXXXXXXXXXXXXXXX-----XXXXX
XXXXXXXXXXX---||----||----|---XXXXXXXXXX|-----||--XXXXXXX---XXXXXXXXXX--------X-XXXXXX---XXXXXXXXXXX||||||---|-XX------XXXXXXXXXXXXXXXXXXXXX-----XXXXX
