------------------------------------------------------------------------------------------------------------------------------------------------------
------------------------------------------------------------------------------------------------------------------------------------------------------
------------------------------------------------------------------------------------------------------------------------------------------------------
----------SSSSSSSSSS------------------------------SSSSSSS---------------------------------------------------------------------------------------------
------------------------------------------------------------------------------------------------------------------------------------------------------
------------------------------------------------------------------------------------------------------------------------------------------------------
--------------------S-----------------------------QQ--------------------------------y-----------------------------------------------------------------
---------------------------TT-----------------------------------------------------#SSS---------------------------SSS----------------------------------
---------------------------TT------------------------------S-------------------g-##-------------------------------------------------------------------
---------------------------XX---------------------------------------------------###1-----------oooo---------------------SS-?Q-------------------------
----------@QQQQ--------TT-------------------------QQ--QQQ--------------------S@S###-------------------------------------------------------------------
-----------------------TT--------------------------------------------T----------###--SSS--------------TT----------------------------------------------
-----------------g-#---TT------------------------------------B-------T----------###-------------------TT----TT-----------------y-------------------F--
-M--------------g#-#k--TT---------k-k----------y-------------b-------T----------###-------------------TT-k--TT-------------SSSSS-------------------#--
XXXXXXXXXXXXXXXXXXXXXXXXXXXXXXXXXXXXXXX-XXXXXXXXXXXXXXXXX---XXXXXX--XX-XXXXXXXXXXXXXXX---X%%%%%%%-%%XXXXXXXXXX%%%%----%%-------XX-XXXXXXXXXXXXXXXXXXXX
XXXXXXXXXXXXXXXXXXXXXXXXXXXXXXXXXXXXXXX-XXXXXXXXXXXXXXXXX---XXXXXX--XX-XXXXXXXXXXXXXXX---X||||||---|XXXXXXXXXX|||------|-------XX-XXXXXXXXXXXXXXXXXXXX
