------------------------------------------------------------------------------------------------------------------------------------------------------
------------------------------------------------------------------------------------------------------------------------------------------------------
------------------------------------------------------------------------------------------------------------------------------------------------------
----------SSSSSSSSSS-------------------------------oo-----------------SSSSSSSSSS----------------------------------------------------------------------
--------------------------------------------------%%%%----------------------SSSS----------------------------------------------------------------------
---------------------------------------------------||----------------R---g--SSSS--------oo-------------------------k----------------------------------
---------------------------------------------------||-------------------SS------oo---------------------------RS---SSSSSS---------------------QQQQ-----
---------------------------------------------------||--SSS--------------SS-------------------------------r--------------------------------------------
---------------------------------------------------||-------------------SS--------------------------%%%%%%%-------------------------------------------
---------------------------------------------------||-------------------SC--g-g--SS---------------oo||||||-------------------------------------y------
-----SSS-------------------------------------------||------------%%%----SS--SSSS---------S----------||||||----------------------------------Q?SSQQQ---
---------------------------------------TT-----TT---||-------------|----------------------------TT---||||||--------------------------------------------
---------------------------------------TT-----TT--%||-------------|----------------------------TT---||||||----TT--------------------------------------
-------------------------------------kkTT-----TT---||-------------|-------------------------y--TT---||||||--ooTT---------k----ggg-k-------------------
XXXXXXXXXXX--XX--X--XXXXX--XXXXXXXXXXXXXXXXX--XXXX-||-------%%%%%-|---XXXXXXXXXX----------XXXXXXXXXX||||||--%%XXXXXXXX--XXXXXXXXXXXX---XXXXXXX--XXXXXX
XXXXXXXXXXX--XX--X--XXXXX--XXXXXXXXXXXXXXXXX--XXXX-||--------|||--|---XXXXXXXXXX----------XXXXXXXXXX||||||---|XXXXXXXX--XXXXXXXXXXXX---XXXXXXX--XXXXXX
