------------------------------------------------------------------------------------------------------------------------------------------------------
------------------------------------------------------------------------------------------------------------------------------------------------------
------------------------------------------------------------------------------------------------------------------------------------------------------
S-----SSSS--------------------------------------------------------------------------------------------------------------------------------------------
S-----------------------------------------------------------------------------------------------------------------------------------------------------
S------------------------------------------------------oooo-----------------------------oo----------oo------------------------------------------------
S--------------------LSSS------------------------------%%%%---------------SS----oo------------------%%%-------------------SSC----------------QQQQ-----
S-------------------------------o----ooo----------SSSS--||------------------------------------------||--o----R--------------------oo------------------
S-------------------------------------------------------||------------------------------------------||-%%%--------------------------------------------
S-------------------------------------------------------||-----------------------SS-----------------||--|-----------------SSS------------------y------
S------------------%-2-----#----------%%----------------||-----------TSS-----SS----------S------TT--||--|-------------r--------------------QQ?SSQQQ---
S--------------------------#-----------|-----K---B----U-||-----------T--------------------------TT--||-o|---------%%%%%%------------------------------
S--------------------------##----------|---------b------||-----------T--------------------------TT--||%%%%%--------|||||------------------------------
S--M---------%%%%-----kk---##--%%%%%%%-|---------B------||----ggg----T----------------------k---TT--||-|||---------|||||---------#--------------------
XXXXXXXXXXX---||----XXXXXXXXXX--|||||--|XXXXXXXXXX----%%%%%-XXXXXXXXXX--------------------XXXXXXXXXX||-|||-----%%%-|||||X----XXXXXXXXXXXXXXXXX--XXXXXX
XXXXXXXXXXX---||----XXXXXXXXXX--|||||--|XXXXXXXXXX-----|||--XXXXXXXXXX--------------------XXXXXXXXXX||-|||------|--|||||X----XXXXXXXXXXXXXXXXX--XXXXXX
