------------------------------------------------------------------------------------------------------------------------------------------------------
------------------------------------------------------------------------------------------------------------------------------------------------------
------------------------------------------------------------------------------------------------------------------------------------------------------
------------------------------------------------------------------------------------------------------------------------------------------------------
------------------------------------------------------------------------------------------------------------------------------------------------------
------------------------------------------------------------------------------------------------------------------------------------------------k-----
-----------------------------U---------------------------------------------1----------------------------------------------oo---%%%%------------SQS--SQ
--------------------------------o----ooo-------------------------------------------------------------------------SSS------SS----||--------------------
----------------------------------------------------------------------------------TT--------------------------------------------||------SSS-----------
---------------------------------------------------------------------------ggg----TT--------------------------------------------||--------------------
-------------------%--------##--------%%------tt------S---------------#########---TT------------------%%%%%%-----------------SS-||%%%%%--------SQS--S?
-----------------------y-#####---------|------tt--TT--------------------------#---TT-----T-------------||||---------------------||-|||----------------
--------------------y-######-----------|------tt--TT--------------------------#-T-TT-----T-------------||||---------------------||-|||----------------
-M-----------%%%%---######-----%%%%%%%-|-g----tt--TT------k--y----------------#-T-TT---k-T---------g---||||---------------------||-|||-------k------gg
XXXXXXXXXXX---||----XXXX--------|||||--|XXXXXXXXXXXXXXXXXXXXXXXXXXXXXX--------X-XXXXXXXXXX-XXXXXXXXX%%-||||-%%%%%%----%%%%-----%%%%|||------XXXXXXXXXX
XXXXXXXXXXX---||----XXXX--------|||||--|XXXXXXXXXXXXXXXXXXXXXXXXXXXXXX--------X-XXXXXXXXXX-XXXXXXXXX|--||||--||||------||-------||-|||------XXXXXXXXXX
