------------------------------------------------------------------------------------------------------------------------------------------------------
------------------------------------------------------------------------------------------------------------------------------------------------------
------------------------------------------------------------------------------------------------------------------------------------------------------
S-----SSSS----------------------------------------------------------------------------------------------------SSSSSSSSSS------------------------------
S------------------------------------------------------------------------o----------------------------------------------------------------------------
S------------------------------------------------------oooo-------------%%%---------------------------------------------------------------------------
S------------------------------------------------------%%%%--------------|--o-------------SSS------%---------R----------SSS-------!S---------QQQQ-----
S-------------------------------------------------SSSS--||---------------|--SSSS-------------------------r--------------------------------------------
S-------------------------------------------------------||------------%--|--------------------------%%%%%%%-------------------------------------------
S-------------------------------------------------------||---------------|--------o-----------------||||||-------------------------------------y------
S------------------%SS----------------------------------||---------------|-------------TT---%%%-----||||||----T-------------------S------#--Q?SSQQQ---
S--------------------K---TT------------T--------------U-||---------------|-------------TT----|------||||||----T-------------------------##------------
S------------------------TT------------T----------------||---------------|-----%-------TT----|------||||||----T----TT---------TT-------###------------
S------------%%%%--------TT----------kkT----------------||---y-----------|-------------TT----|------||||||--ooT--g-TT---------TT------####------------
XXXXXXXXXXX---||----XXXXXXXXXXXXXXXXXXXXX-XX-XX-XX----%%%%%-XXXXXXXXXX%%%%%%----XXXXXXXXXX---|------||||||--%%XXXXXXXXXX----XXXXXXXXXXXXXXXXXX--XXXXXX
XXXXXXXXXXX---||----XXXXXXXXXXXXXXXXXXXXX-XX-XX-XX-----|||--XXXXXXXXXX|||||-----XXXXXXXXXX---|------||||||---|XXXXXXXXXX----XXXXXXXXXXXXXXXXXX--XXXXXX
