------------------------------------------------------------------------------------------------------------------------------------------------------
------------------------------------------------------------------------------------------------------------------------------------------------------
------------------------------------------------------------------------------------------------------------------------------------------------------
---------------------------------------------------oo-------------------------------------------------------------------------------------------------
--------------------------------------------------%%%%------------------------------------------------------------------------------------------------
---------------------------------------------------||-----------------------------------oo------------------------------------------------------------
------------------SC--!----------------------------||---------------------------oo--------------------------------------SSS-----------------SSS-------
---------------------------------------------------||--SSS--------------------------------------------------------------------------------------------
---------------------------------------------------||-------------------------------------------------------------------------------------------------
---------------------------------------------------||----------------------------SS--------------------------------------------------------------SSSSS
--------------TT---2S@S!S----------------TT---SU---||----------------#-------------------S------TT----%%%%%%----------r-------------------------------
--------------TT-----------------------T-TT--------||---------------##--------------------------TT-----||||-------%%%%%%-------------TT---------------
--------------TT------------tt---------T-TT-------%||-------TT-----###--------------------------TT-----||||--------|||||------TT-----TT-----SSS-------
-M------------TT-----g------tt-------kkT-TT------k-||-------TT----####----------------------k---TT-----||||--------|||||------TT-----TT------------r--
XXXXXXXXXXXXXXXXXXXXXXXXXXXXXXXXXXXXXXXXXXXXXXXXXX-||-------XXXXXXXXXXX----XXXXX----------XXXXXXXXXX%%-||||-%%-%%%-|||||----XXXXXXXXXXXXXXXX-----XXXXX
XXXXXXXXXXXXXXXXXXXXXXXXXXXXXXXXXXXXXXXXXXXXXXXXXX-||-------XXXXXXXXXXX----XXXXX----------XXXXXXXXXX|--||||--|--|--|||||----XXXXXXXXXXXXXXXX-----XXXXX
