------------------------------------------------------------------------------------------------------------------------------------------------------
------------------------------------------------------------------------------------------------------------------------------------------------------
------------------------------------------------------------------------------------------------------------------------------------------------------
----------SSSSSSSSSS----------SSSSSSSSSS----------------------------------------------------------------------SSSSSSSSSS------------------------------
------------------------------SSSSSSSSSS--------------------------------------------------------------------------------------------------------------
----------------------ooor----SSSSSSSSSS------------------------------------------------oo------------------------------------------------------------
---------------------%%%%%----SSSSSSSSSS----------------------------------------oo---------------------------R------------SSC-------------------------
----------------------|||-------------------------------------------------------------------------oo-r------------------------------------------------
----------------------|||---------------------------------------------o-----------------------------%%%%%%%-------------------------------------------
----------------------|||--------------------------------------------------------SSS----------------||||||----------------SSS-------------------------
--------SU----------%%%%%%%---SSSSSSSSSS-TT---SU-------ooo-------------------------------S----------||||||----T---------------------------------------
--------------------||||||----SSSSSSSSSS-TT-----------------------------------#-----------------#---||||||----T----------------------TT---------------
--------------------||||||--o-SSSSSSSSSS-TT----------------------------------##-----------------#---||||||----T----TT----------------TT------------F--
--M-----------------||||||-%%%SSSSSSSSSS-TT------k----------gg-------g--------------------------#---||||||--ooT--g-TT------------#---TT------------#--
XXXXXXXXXXX--XX--X--||||||--|-XXXXXXXXXXXXXXXXXXXX--XXXXXXXXXXXXXXXXXXXXXXXXXXXX----------XXXXXXXXXX||||||--%%XXXXXXXXXXX----XXXXXXXXXXXXXXXXXXXXXXXXX
XXXXXXXXXXX--XX--X--||||||--|-XXXXXXXXXXXXXXXXXXXX--XXXXXXXXXXXXXXXXXXXXXXXXXXXX----------XXXXXXXXXX||||||---|XXXXXXXXXXX----XXXXXXXXXXXXXXXXXXXXXXXXX
