------------------------------------------------------------------------------------------------------------------------------------------------------
------------------------------------------------------------------------------------------------------------------------------------------------------
------------------------------------------------------------------------------------------------------------------------------------------------------
---------------------------------------------------oo-----------------SSSSSSSSSS----------SSSSSSSSSS------------------------------SSSSSSSSSSSSSSSSSSSS
--------------------------------------------------%%%%------------------------------------------------------------------------------------------------
---------------------------------------------------||-----------------------------------oo------------------------------------------------------------
---------------------------------------------------||---------------------------oo---------------------------------oo----------SSS--------------------
---------------------------------------------------||--SSS--------------------TT----------------------------------------------------------------------
---------------------------------------------------||-------------------------TT----------------------------------------------------------------------
-----------------------------------oo--------------||-------------------------TT-SSS--------------------------------------------K---------------------
----------------!-----------------o--o-------------||----------------T------SCTT---------S---------------------%%%%--%%%-------SSS------------TT------
---------------------------------------------------||----------------T--TT----TT----------t-----------------g---||----||------------------TT--TT------
--------------------------------------------------%||----------------T--TT----TT----------t-----------------TT--||----||-TT--------tt-----TT--TT------
-M-------------------------------------------------||---------ggg----T--TT---kTT----------t-----------------TTo-||----||-TT--------tt----kTT--TT------
XXXXXXXXXXXXXXXXXXXXXXXXX--XXXXXXXXXXXXXX-XX-XX-XX-||-------XXXXXXXXXXXXXXXXXXXX----------XXXXXXXXXX--XXXXXXXX%-||----||XXXXXXXXXXXXXXXXXXXXXXXX--XXXX
XXXXXXXXXXXXXXXXXXXXXXXXX--XXXXXXXXXXXXXX-XX-XX-XX-||-------XXXXXXXXXXXXXXXXXXXX----------XXXXXXXXXX--XXXXXXXX--||----||XXXXXXXXXXXXXXXXXXXXXXXX--XXXX
