------------------------------------------------------------------------------------------------------------------------------------------------------
------------------------------------------------------------------------------------------------------------------------------------------------------
------------------------------------------------------------------------------------------------------------------------------------------------------
----------SSSSSSSSSS----------SSSSSSSSSS--------------------------------------------------------------------------------------------------------------
------------------------------------------------------------------------------------------------------------------------------------------------------
---------------------------------------------------------------------R------------g---------oo--------------------------------------------------------
---------------------------------------------------------Q-Q--------------SSCSS-SSSSSSSS---------------------R----------SS---------------##-----------
-----------------------------------------------------------------------------------------------------r----------oooo---------------------##-----------
---------------------------------------S-----------------------------------------------------------%%%%%%%%----------------------------####-----------
---------------------------------------S------------------------------------------------------------||||||-----------------TT----------####-----------
---------------------------------------S-----------------Q-Q-----%%%----QQQQ--QQ----------SS--------||||||----T------------TT--------######---#LSS----
-------------------------------#----------------------------------|---------------------------------||||||----T---------t--TT--------######---#-------
-------------------------------#-#--------------------------------|--------------------------%%%%---||||||----T---------t--TT--------######---#-------
-M-----------------------ggg---#-#----------y-y-------------------|---------------------------||----||||||--ooT---y-----t--TT--------######-kk#-------
XXXXXXXXXXX--XX--X--XXXXXXXXXXXXXXXXXXXXXXXXXXXXXXXXXXXXXXXX%%%%%-|---XXXXXXXXXXXXXXXX---X----||----||||||--%%XXXXXXXXXXXXXXXXXXXXXXXXXXXXXXXXXXXXX---
XXXXXXXXXXX--XX--X--XXXXXXXXXXXXXXXXXXXXXXXXXXXXXXXXXXXXXXXX-|||--|---XXXXXXXXXXXXXXXX---X----||----||||||---|XXXXXXXXXXXXXXXXXXXXXXXXXXXXXXXXXXXXX---
