------------------------------------------------------------------------------------------------------------------------------------------------------
------------------------------------------------------------------------------------------------------------------------------------------------------
------------------------------------------------------------------------------------------------------------------------------------------------------
----------------------------------------SSSSSSSSSS-----------------SSS--------------------------------------------------SSS-----SSSSSSSSSS------------
------------------------------------------------------------------------------------------------------------------------------------------------------
------------------------------------------------------------------------------------------------------------------------------------------------k-----
-----------------------------------------oooo-------------------CSS-------SS---------------------------------R-----oo---US---------------------SQS--SQ
-----------------------------------------------------------------------------------------------------r------------------------------------------------
-----------------------------------------SSSS-U-------------SS--2-----------------------------------%%%%%%%-----------------SSS-----------------------
-----------------------------------oo---oS--SoS----------------2-2----------------o-----------------||||||--------------------------------------------
---------Q---------%--------TT----o--o--SS--SSS--------ooo--------2---SS-----SS--------TT-------TT--||||||-----%%%%--%%%SSS------------g##-----SQS--S?
----------------------------TT---------------------------------------------------------TT-------TT--||||||------||----||---------------###------------
----------------------------TT---------------------------------------------------------TT-------TT--||||||------||----||-------------g####------------
-M-----------%%%%-------ggg-TT------------kk-------------------------------------------TT---k---TT--||||||--ooo-||----||-------------#####---k------gg
XXXXXXXXXXX---||----XXXXXXXXXXXXXXXXXXXXXXXXXXXXXX--XXXXXXXX---XXXXXXX----------XXXXXXXXXXXXXXXXXXXX||||||--%%%-||----||XXX------XXXXXXXXX--XXXXXXXXXX
XXXXXXXXXXX---||----XXXXXXXXXXXXXXXXXXXXXXXXXXXXXX--XXXXXXXX---XXXXXXX----------XXXXXXXXXXXXXXXXXXXX||||||---|--||----||XXX------XXXXXXXXX--XXXXXXXXXX
