------------------------------------------------------------------------------------------------------------------------------------------------------
------------------------------------------------------------------------------------------------------------------------------------------------------
------------------------------------------------------------------------------------------------------------------------------------------------------
------------------------------------------------------------------------------------------------------------------------------------------------U-----
-------------------------------------------------------------------------o----------------------------------------------------------------------------
------------------------------------------------------------------------%%%-------------------------oo------------------------------------------------
------------------SC---------U-------------------------------------------|--o--------SUS------------%%%-------?SSS-------SSS----S!--------------------
--------------------------------o----ooo---------------------------------|--SSSS--------------------||--o----R------------------------------------SS--
---------------------------------------------------------B------------%--|--------------------------||-%%%--------------------------------------------
---------------------------------------------------------b---------------|--------------------------||--|-------------------------------------SS------
---------Q----TT---2--------##--------%%------tt-------SS#CS-------------|----------#####-----------||--|-----SSSSS--------------S-------------------#
--------------TT-------y-#####---------|------tt-------------------------|----------#---------------||-o|----------------------------TT-------------##
--------------TT----y-######-----------|------tt-----------K-------------|-----%---K#---------------||%%%%%--------------------------TT------------###
--------------TT----######-----%%%%%%%-|-g----tt-------------y-----------|----------#--------------g||-|||------K-----------gg-g-g---TT-----------####
XXXXXXXXXXXXXXXXXXXXXXXX--------|||||--|XXXXXXXXXXXXXXXXXXXXXXXXXXXXXX%%%%%%----XXXXXXX----XXXXXXXXX||-|||----XXXXXXXXXXXXXXXXXXXXXXXXXXXXXXXXXXX-XXXX
XXXXXXXXXXXXXXXXXXXXXXXX--------|||||--|XXXXXXXXXXXXXXXXXXXXXXXXXXXXXX|||||-----XXXXXXX----XXXXXXXXX||-|||----XXXXXXXXXXXXXXXXXXXXXXXXXXXXXXXXXXX-XXXX
