------------------------------------------------------------------------------------------------------------------------------------------------------
------------------------------------------------------------------------------------------------------------------------------------------------------
------------------------------------------------------------------------------------------------------------------------------------------------------
--------------------------------------------------------------------------------ooo-----------------------------------------------SSSSSSSSSS----U-----
--------------------------------------------------------------------------------%%%-------------------------------------------------------------------
-------------------------------------------------------oooo----------------------|--------------------------------------------------------------------
--------------------S----------------------------------%%%%-----------------SSSS-|--------------------------------------------------------------------
---------------------------TT---o----ooo----------------||-----------------------|------------------oo-----------SSS------------------------------SS--
---------------------------TT---------------------------||-----------------------|--------------------------------------------------------------------
---------------------------XX---------------------SSS---||-------------------K---|---%%%%-------g------------------------------SSS------------SS------
----------Q------------TT-------------%%----------------||-----------#-----SSSSS-|----||--------TT-----------T----------%----------------------------#
-----------------------TT--------------|--------------U-||----------##T---------%%%%%%||--------TT-----------T----------------------------TT--------##
-----------------------TT--------------|----------------||--TT-----###T----------||||-||--------TT-----------T---------------------tt-----TT-------###
-M-----------------#k--TT------%%%%%%%-|----------------||--TT----####T----------||||-||--------TT--------y--T-------------------r-tt----kTT------####
XXXXXXXXXXXXX--XXXXXXXXXXXXXXX--|||||--|X-XX-XX-XX----%%%%%-XXXXXXXXXXXXXXXXXXXX-||||-||%%XXXXXXXXX-XXXXXXXXXX%%%%----%%----XXXXXXXXXXXXXXXXXXXXX-XXXX
XXXXXXXXXXXXX--XXXXXXXXXXXXXXX--|||||--|X-XX-XX-XX-----|||--XXXXXXXXXXXXXXXXXXXX-||||-||-|XXXXXXXXX-XXXXXXXXXX|||------|----XXXXXXXXXXXXXXXXXXXXX-XXXX
