------------------------------------------------------------------------------------------------------------------------------------------------------
------------------------------------------------------------------------------------------------------------------------------------------------------
------------------------------------------------------------------------------------------------------------------------------------------------------
--------------------SSSSSSSSSS----------SSSSSSSSSS----------------------------------------SSSSSSSSSSSSSSSSSSSS----------SSS-----SS--------------------
----------------------------------------SSSSSSSS------------------------------------------------------------------------------------------------------
--------------------------------------ooSSSCSSSS------------------------------------------------------------------------------------------------------
-----------------------------------SSSS-SSSSSSSS-------------------------------------SUS----------------------?SSS------US-------------------QQQQ-----
----------------------------------------------------------------------------------------------------------------------------------oo------------------
---------------------------------------------------------------------o---------g--------------------------------------------SSS-----------------------
-----------------------------C-------------ggg-------------------y-----------------------------------------------------------------------------y------
-----SSS--------!------#-#----%---------SSSSSSSS---------tt------##----------S@S----#####------------------TT-SSSSS-----SSS----------------QQ?SSQQQ---
---------------------#-#-#-#------------SSSSSSSS---------tt-----###-----------------#-----t-------------#--TT-----------------------------------------
---------------------#-#-#-#------------SSSSSSSS---------tt----####----------------K#-----t------------##--TT-----------------------------------------
---------------------#-#-#-#-E----------SSSSSSSS-----g-g-tt---#####-----------------#-----t---------kk-##--TT---K-------------------------------------
XXXXXXXXXXXXXXXXXXXXXXXXXXXXXX--%%%%--%%XXXXXXXXXXXXXXXXXXXXXXXXXXX----XXXXXXXXXXXXXXXX---XXXXXXXXXXXXXXX--XX-XXXXXXXXXXXXX------XXXXXXXXXXXXX--XXXXXX
XXXXXXXXXXXXXXXXXXXXXXXXXXXXXX---||----|XXXXXXXXXXXXXXXXXXXXXXXXXXX----XXXXXXXXXXXXXXXX---XXXXXXXXXXXXXXX--XX-XXXXXXXXXXXXX------XXXXXXXXXXXXX--XXXXXX
