------------------------------------------------------------------------------------------------------------------------------------------------------
------------------------------------------------------------------------------------------------------------------------------------------------------
------------------------------------------------------------------------------------------------------------------------------------------------------
--------------------------------------------------------------------------------ooo-----------------------------------------------SSSSSSSS--SSSSSSSSSS
--------------------------------------------------?-----------------------------%%%-------------------------------------------------------------------
---------------------------------------------------------------------R-----------|--------------------------------------------------------------------
---------------------------------------------------------------------------------|---------------------------R------------oo---%%%--------------------
--------------------------------o----ooo----------SS-----------------------------|-----------------------r----------------SS----||--------------------
---------------------------------------------------------------------------------|------------------%%%%%%%---------------------||--------------------
---------------------------------------------------------------------------------|---%%%%---------oo||||||----------------------||--------------------
-----SSS------------------------------%%------tt-----------------%%%-------------|----||------------||||||------------r------SS-||-----g##----TT------
---------------------------------------|------tt-------SSS--------|-------------%%%%%%||-------TT---||||||--------%%%%%%--------||-----###----TT------
---------------------------------------|------tt------------------|--------------||||-||-------TT---||||||---------|||||--------||---g####----TT------
--------------k-ggg------------%%%%%%%-|-g----tt------------------|--------------||||-||----y--TT---||||||--oo-----|||||--------||---#####----TT------
XXXXXXXXXXXXXXXXXXXXXXXXX--XXX--|||||--|XXXXXXXXXX----------%%%%%-|---X----XXXXX-||||-||%%XXXXXXXXXX||||||--%%-%%%-|||||%%-----%%%XXXXXXXX--XXXX--XXXX
XXXXXXXXXXXXXXXXXXXXXXXXX--XXX--|||||--|XXXXXXXXXX-----------|||--|---X----XXXXX-||||-||-|XXXXXXXXXX||||||---|--|--||||||-------||XXXXXXXX--XXXX--XXXX
