------------------------------------------------------------------------------------------------------------------------------------------------------
------------------------------------------------------------------------------------------------------------------------------------------------------
------------------------------------------------------------------------------------------------------------------------------------------------------
----------SSSSSSSSSS------------oo-----------------oo-------------------------------------------------------------------------------------------------
---------------------------------------g----------%%%%------------------------------------------------------------------------------------------------
-----------------------------------%%%%%-----------||-------------------------------------------------------------------------------------------------
--------------------USS-------------||||-----------||-------------SSoo--------------------SSS------%---------@---------------------------##-SSS-------
------------------------------------||||-----------||--SSS-------------------------------------------------------------------------------##-----------
------------------------------------||||-----------||-----------------o------------------------------------------------------SSS-------####-----------
------------------------------%%%%%-||||-----------||-----------------------------o----------------------------------------------------####------SSSSS
--------SU@QQQQ----------------|||--||||-----------||-------%%%%%%---------------------TT---%%%-----SU----!--!--------r-r------------######-----------
---------------------B---------|||--||||-----------||--------||||-------------#--------TT----|--------------------%%%%%%%%%%%%-------######-----------
-----------------g-#-b-------B-|||--||||----------%||--------||||------------##--------TT----|---------------------||||||||||--------######-SSS-------
--M-------------g#-#-B-------b-|||--||||-------ggg-||--------||||----------------------TT----|------------k--------||||||||||--------######--------r--
XXXXXXXXXXXXXXXXXXXXXXXXXXXXXX-|||--||||-XXXXXXXXX-||--------||||-----XXXXXXXXXXXXXXXXXXXX---|------XXXXXXXXXX-%%%-||||||||||-----XXXXXXXXXX-----XXXXX
XXXXXXXXXXXXXXXXXXXXXXXXXXXXXX-|||--||||-XXXXXXXXX-||--------||||-----XXXXXXXXXXXXXXXXXXXX---|------XXXXXXXXXX--|--||||||||||-----XXXXXXXXXX-----XXXXX
