------------------------------------------------------------------------------------------------------------------------------------------------------
------------------------------------------------------------------------------------------------------------------------------------------------------
------------------------------------------------------------------------------------------------------------------------------------------------------
-----------------------oo-----SSSSSSSSSS---------------------------SSS----------SSSSSSSSSL--------------------SS-------SSSSSSSSSSS--------------------
------------------------------------------------------------------------------------------------------------------------------------------------------
-------------------------------------------------------oooo-----------------------------------------oo------------------------------------------------
----------------------SSSS-----------------------------%%%%-----CSS-----------------oooooo----------%%%----------------S------------------------------
--------------------------------------------------SSSS--||------------------------------------------||--o----R----------------------------------------
---------------------------------------S----------------||--SS--2--------------g----SSSSSS----------||-%%%---------SSS--------------------------------
---------------------------------------S----------------||-----2-2------------------SSSSSS------g---||--|---------------------------------------------
--------SU---------%------%%%%---------S----------------||--------2----------S@S----------------TT--||--|--------------S------------------------------
---------------------------|||-#--------T-----TT------U-||--------------------------------------TT--||-o|------##---------SS--------------------------
---------------------------|||-#-#------T-----TT--------||--------------------------------------TT--||%%%%%----##---------SS-----------------------F--
--M----------%%%%----------|||-#-#------T-----TT--------||--------------------------------------TT--||-|||-----##---------SS------k----------------#--
XXXXXXXXXXX---||----%%%----|||XXXXXXXXXXXXXX--XXXX----%%%%%----XXXXXXX-XXXXXXXXX---XXXXXXXXXXXXXXXX-||-|||-----XX------X--XX--XXXXXX---XXXXXXXXXXXXXXX
XXXXXXXXXXX---||----||-----|||XXXXXXXXXXXXXX--XXXX-----|||-----XXXXXXX-XXXXXXXXX---XXXXXXXXXXXXXXXX-||-|||-----XX------X--XX--XXXXXX---XXXXXXXXXXXXXXX
