------------------------------------------------------------------------------------------------------------------------------------------------------
------------------------------------------------------------------------------------------------------------------------------------------------------
------------------------------------------------------------------------------------------------------------------------------------------------------
--------------------SSSSSSSSSS--------------------SSSSSSSSSS-------SSS----------------------------------------SS-------SSSSSSSSSSS--------------------
------------------------------------------------------SS--SS------------------------------------------------------------------------------------------
------------------------------------------------------SS--SS----------------------g---------oo--------------------------------------------------------
----------------------------------------------------SS----------CSS--------1----SSSSSSSS-------------------------------S----------%-------------------
----------------------------------------------------SS----------------------------------------------------TT------------------------------------------
----------------------------------------------------SS------SS--2----------------------------------%------TT-------SSS------------------SSS-----------
------------Q--?-------------C----------------------SS----oo---2-2---------ggg----------------------------TT------------------------------------------
-------------------S---#-#-----TT-------------tt----SSSS--SS------2---#########-----------SS-------------SXXS----------S----------%%%%%---------------
---------------------#-#-#-#---TT-------------tt------SS----------------------#--------------------------------##---------SS-------|||----------------
---------------------#-#-#-#---TT-------------tt------SS----------------------#--------------%%%%---TT---------##---------SS-------|||-------------F--
-M----------------K--#-#-#-#-EgTT--------g----tt------------------------------#---------------||----TT---------##---------SS-------|||-------------#--
XXXXXXXXXXXXXXXXXXXXXXXXXXXXXXXXXXXXXX--XXXXXXXXXXXXXXXXXXXX---XXXXXXX--------X-XXXXXX---X----||----XXXXXXXXXX-XX------X--XX--XXXX%|||------XXXXXXXXXX
XXXXXXXXXXXXXXXXXXXXXXXXXXXXXXXXXXXXXX--XXXXXXXXXXXXXXXXXXXX---XXXXXXX--------X-XXXXXX---X----||----XXXXXXXXXX-XX------X--XX--XXXX-|||------XXXXXXXXXX
