------------------------------------------------------------------------------------------------------------------------------------------------------
------------------------------------------------------------------------------------------------------------------------------------------------------
------------------------------------------------------------------------------------------------------------------------------------------------------
------------------------------SSSSSSSSSS------------------------------SSSSSSSSSSSSSSSSSSSL------------------------------------------------------------
--------------------------------------------?-------------------------------SSSS----------------------------------------------------------------------
-----------------------SSS-----------------------------oooo--------------g--SSSS------------oo--------------------------------------------------------
-------------------------------------------------------%%%%-------------SS----------oooooo-------------------------oo-------------SS--------SS--------
---------------------g------------------------r---SSSS--||--------------SS----------------------------------------------------------------------------
--------------------%%%----------------S--%%%%%%--------||-----------o--SS----------SSSSSS---------%--------------------------------------------------
------------Q--?----||----SSS----------S---||||---------||-------y------SC--g-g-----SSSSSS------------------------------------------------------------
-------------------S||-----------------S%%-||||ooo------||-------##-----SS--SSSS----------SS----------%%%%%%---%%%%--%%%----------SS--------SS--------
--------------------||---------#--------|--||||--r----U-||------###------------------------------------||||-----||----||----------K---#----B------#-TT
--------------------||---------#-#------|%%%%%%%%%------||-----####--------------------------%%%%------||||-----||----||--------------#----b-----##-TT
-M----------------K-||----oo---#-#------|-||||||||------||----#####---------------------------||-------||||---o-||----||--kkk---------#----B----###-TT
XXXXXXXXXXXXXXXXXXXX||---%%%--XXXXXXXXXX|-||||||||----%%%%%-XXXXXXX---XXXXXXXXXX---XXXXXXX----||----%%-||||-%%%-||----||XXXXXXXXXXXXXXXXXXXXXXXXXXX-XX
XXXXXXXXXXXXXXXXXXXX||----|---XXXXXXXXXX|-||||||||-----|||--XXXXXXX---XXXXXXXXXX---XXXXXXX----||----|--||||--|--||----||XXXXXXXXXXXXXXXXXXXXXXXXXXX-XX
