------------------------------------------------------------------------------------------------------------------------------------------------------
------------------------------------------------------------------------------------------------------------------------------------------------------
------------------------------------------------------------------------------------------------------------------------------------------------------
----------------------------------------------------------------------------------------------------------------------------------SSSSSSSS------------
-----------------------------------------------------------------------------------------------------------------------------------------------------o
--------------------------------------------------------------------------------------------oo--------------------------------------------------------
------------------------------------------------------------------SSoo------SSSS-----1-----------------------R----------------------------------------
---------------------------------------------------------------------------------------------------------r--------------------------------------SSS---
---------------------------------------------------------B-----------------------------------------%%%%%%%%------------y-----SSS------------oo--------
------------Q--?-----------------------------------------b-------------------K----------------------||||||-------------X------------------------------
---------Q---------SSS------------------------tt-------SS#CS%%%%%%---------SSSSS---QQQQ---SS--------||||||------------XXr--------------g##--SS--------
---------------------K---TT-----------K-------tt-------------||||-----T-----------------------------||||||-----------XXX%%%%%%---------###------------
-------------------------TT---TTTT------------tt-----------K-||||-----T----------------------%%%%---||||||----------XXXX|||||--------g####------------
-M----------------K------TT---TTTT-------g----tt-------------||||-----T-------------yy--------||----||||||--oo-----XXXXX|||||--------#####------------
XXXXXXXXXXXXXXXXXXXXXXXXXXXXXXXXXXXXXXXXXXXXXXXXXXXXXXXXXXXX-||||-----XXXXXXXXXXXXXXXXXXXX----||----||||||--%%XXXXXXXXXX|||||-----XXXXXXXX------------
XXXXXXXXXXXXXXXXXXXXXXXXXXXXXXXXXXXXXXXXXXXXXXXXXXXXXXXXXXXX-||||-----XXXXXXXXXXXXXXXXXXXX----||----||||||---|XXXXXXXXXX|||||-----XXXXXXXX------------
