------------------------------------------------------------------------------------------------------------------------------------------------------
------------------------------------------------------------------------------------------------------------------------------------------------------
------------------------------------------------------------------------------------------------------------------------------------------------------
------------------------------------------------------------SSSSSSSSSS--------------------------------------------------------------------------U-----
------------------------------------------------------------SSSS--SSSS--------------------------------------------------------------------------------
------------------------------------------------------------SSSS--SSSS--------------------------------------------------------------------------------
--------------------------------------------------------------SS---S----SSSSS-------y------------------------------oo---------------------------------
--------------------------------------------------------------SS---S--------------#SSS------------------------------------------------------------SS--
---------------------------------------------------------TT---SS---S-------------##-------------------------------------------SSS----g#---------------
---------------------------------------------------TT----TT-ooSS---SoU----------###1--------------oo--------------------------------g##-------SS------
----------------!---SS-------------------TT---SU---TT----XX-SSSS---SSS-------2--###----------------------------%%%%--%%%%-----------###--------------#
---------------------K---TT------------T-TT--------TT----------------------TT---###--SSS-------TT---------------||----||-----------####-------------##
-------------------------TT------------T-TT--------TT-----------------t----TT--T###------------TT---------*-----||----||----------#####------------###
-M-----------------------TT----------kkT-TT------k-TT-------k--g-g----t----TT--T###---------y--TT---gg----*---o-||----||---------r#####-----------####
XXXXXXXXXXXXXXXXXXXXXXXXXXXXXXXXXXXXXXXXXXXXXXXXXXXXXXXXXXXXXXXXXXXXXXXXXXXXXXXXXXXXXX---XXXXXXXXXXXXXXXXXXXX-%-||----||----XXXXXXXXXXX--XXXXXXXX-XXXX
XXXXXXXXXXXXXXXXXXXXXXXXXXXXXXXXXXXXXXXXXXXXXXXXXXXXXXXXXXXXXXXXXXXXXXXXXXXXXXXXXXXXXX---XXXXXXXXXXXXXXXXXXXX---||----||----XXXXXXXXXXX--XXXXXXXX-XXXX
