------------------------------------------------------------------------------------------------------------------------------------------------------
------------------------------------------------------------------------------------------------------------------------------------------------------
------------------------------------------------------------------------------------------------------------------------------------------------------
------------------------------------------------------------------------------------------------------------------------------------------------------
-----------------------------------------------------------------------------------------------------------------------------------------------------o
----------------------------------------ooooo---------------------------------------------------------------------------------------------------------
-----------------------------US--------------------------Q-Q---------------g---------------------------------@-----------------SSS--------------------
------------------------------------------------SS---------------------%%%%%%-----------------------------------oooo----------------------------SSS---
-----------------------------------------SSSS---------------------------||||---------------------------------------------------------g#-----oo--------
----------------------------------------------------------------1-------||||------o------------oooo-----------------------------K---g##---------------
----------Q-----------------####--SSC--------------------Q-Q------------||||-----------TT-----------SU----!--!T----------------SSS--###-----SS--------
-----------------------y-#####------------------------------------------||||-----------TT---------------------T--------------------####---------------
--------------------y-######----------------%%%%%-----------------------||||-----------TT---------------------T----------TT-------#####---------------
-M-----------------#######-------------------|||------------------------||||-----------TT-----------------k---T---y------TT-------#####---------------
XXXXXXXXXXXXX--XXXXXXXXX------XX--XXXXXX%%---|||--XXXXXXXXXXXXXXXXXXX---||||----XXXXXXXXXX%%%%%%%-%%XXXXXXXXXXXXXXXXXXXXXXXXXXXXXXXXXXX--XXX----------
XXXXXXXXXXXXX--XXXXXXXXX------XX--XXXXXX|----|||--XXXXXXXXXXXXXXXXXXX---||||----XXXXXXXXXX||||||---|XXXXXXXXXXXXXXXXXXXXXXXXXXXXXXXXXXX--XXX----------
