------------------------------------------------------------------------------------------------------------------------------------------------------
------------------------------------------------------------------------------------------------------------------------------------------------------
------------------------------------------------------------------------------------------------------------------------------------------------------
--------------------------------oo----------------SSSSSSSSSS------------------------------------------------------------SSS-----SS--------------------
---------------------------------------g--------------SS--SS------------------------------------------------------------------------------------------
-----------------------------------%%%%%%%------------SS--SS------------------------------------------------------------------------------------------
------------------------------------|||||-----------SS---------------------1------------------------------2-------------US--------SS------------------
------------------------------------|||||----oo-----SS----------------------------------------------------------oooo---------------------------y------
-----------------g------------------|||||-----------SS---------------o------------------------------------------------------SSS--------------#SS--o---
-----------------#------------%%%%%-|||||-----------SS----oo-----y---------ggg----o------------oooo-o---------------------------------------##--------
----------S-----##--SS---------|||--|||||-----------SSSS--SS-----##---#########--------TT-----------------2---T---------SSS-------SS--------##--SC----
---------------###---K---TT----|||--|||||-------------SS--------###-----------#--------TT---------------------T-------------------K---#----B##--------
--------------####-------TT----|||--|||||-------------SS-------####-----------#--------TT---------------------T-----------------------#----b##---SSS--
-M-----------#####-------TT----|||--|||||---------------------#####-----------#--------TT---------------y--y--T---y-------------------#----B##--------
XXXXXXXXXXXXXXXXXXXXXXXXXXXXXX-|||--|||||----%%%%-XXXXXXXXXXXXXXXXX-----------X-XXXXXXXXXX%%%%%%%-%%XXXXXXXXXXXXXXXXXXXXXXX------XXXXXXXXXXXXX------XX
XXXXXXXXXXXXXXXXXXXXXXXXXXXXXX-|||--|||||-----||--XXXXXXXXXXXXXXXXX-----------X-XXXXXXXXXX||||||---|XXXXXXXXXXXXXXXXXXXXXXX------XXXXXXXXXXXXX------XX
