------------------------------------------------------------------------------------------------------------------------------------------------------
------------------------------------------------------------------------------------------------------------------------------------------------------
------------------------------------------------------------------------------------------------------------------------------------------------------
------------------------------------------------------------------------------------------SSSSSSSSSS--------------------------------------------------
------------------------------------------------------------------------------------------------------------------------------------------------------
-----------------------SSS--------------ooooo-------------------------------------g-------------------------------------------------------------------
---------------------------------------------------------------------------g----SSSSSSSS---------------------------------------SSS-----------------SSS
---------------------g--------------------------SS---------------------%%%%%%-------------------------------------------------------------------------
--------------------%%%------------------SSSS---------------------------||||--------------------------------------------------------------------------
------------Q--?----||----SSS-------------------------------------------||||----------------------------------------------------K---------------------
---------Q---------S||---------TT------------------------tt-------------||||------------------------------------------r--------SSS---------#------#---
--------------------||---------TT------------------------tt-------------||||--------------t-----------------------%%%%%%------------------##------#---
--------------------||---------TT-----------%%%%%--------tt-------------||||--------------t---------------*--------|||||-TT--------------###------#---
-M----------------K-||----oo--gTT------------|||-----g-g-tt--y----------||||--------------t---------gg----*--------|||||-TT----------y--####-ggg--#---
XXXXXXXXXXXXXXXXXXXX||---%%%--XXXXXXXX--%%---|||--XXXXXXXXXXXXXXXXXXXX--||||----XXXXXX---XXXXXXXXXXXXXXXXXXXX--%%%-|||||XXXXXXXXXXXXXXXXXXXXXXXXXXXXXX
XXXXXXXXXXXXXXXXXXXX||----|---XXXXXXXX--|----|||--XXXXXXXXXXXXXXXXXXXX--||||----XXXXXX---XXXXXXXXXXXXXXXXXXXX---|--|||||XXXXXXXXXXXXXXXXXXXXXXXXXXXXXX
