------------------------------------------------------------------------------------------------------------------------------------------------------
------------------------------------------------------------------------------------------------------------------------------------------------------
------------------------------------------------------------------------------------------------------------------------------------------------------
--------------------SSSSSSSSSS--------------------------------------------------SSSSSSSSSSSSSSSSSSSS--------------------------------------------------
------------------------------------------------------------------------------------------------------------------------------------------------------
------------------------------------------------------------------------------------------------------------------------------------------------------
--------------------------------------------------------------------------------------------------------SSQSSS--------US-SSS----S!--------------------
------------------------------------------------------------------------------------------------------------------------------------------------------
---------------------------------------------------------B-----------o--------------------------------------------------------------------------------
-----------------------------C---------------------------b-------y---------------------S------------------K---------E---------------------------------
---------QQ------------#-#-----------------------------SS#CS-----##-------------SU----------------------SSSSSS-----TT------------S--------------------
---------------------#-#-#-#----------K-------------------------###-----------------TT---t-------------------------TT--t---------------------------#--
---------------------#-#-#-#--TTTT-------------------------K---####-----------------TT---t-------------------------TT--t-----------------------K---#--
-M-----------------#-#-#-#-#-ETTTT----------------------------#####----------------kTT--kt------g-g-------------g--TT--t----gg-g-gk----------------#--
XXXXXXXXXXXXX--XXXXXXXXXXXXXXXXXXXXXXXXXX-XX-XX-XXXXXXXXXXXXXXXXXXX---X----XXXXXXXXXXXXXXXXXXXXXXXXXXXXXXXXXXXXXXXXXXXXXXXXXXXXXXXXX---XXXXXXXXXX--XXX
XXXXXXXXXXXXX--XXXXXXXXXXXXXXXXXXXXXXXXXX-XX-XX-XXXXXXXXXXXXXXXXXXX---X----XXXXXXXXXXXXXXXXXXXXXXXXXXXXXXXXXXXXXXXXXXXXXXXXXXXXXXXXX---XXXXXXXXXX--XXX
