------------------------------------------------------------------------------------------------------------------------------------------------------
------------------------------------------------------------------------------------------------------------------------------------------------------
------------------------------------------------------------------------------------------------------------------------------------------------------
S-----SSSS---------------------------------------------------------SSS--------------------------------------------------------------------------------
S-----------------------------------------------------------------------------------------------------------------------------------------------------
S---------------------ooor----------------------------------------------------------------------------------------------------------------------------
S--------------------%%%%%--------------------------------------CSS------------------------------------------R-----------------SSS----------SSS-------
S---------------------|||-------o----ooo-----------------------------------------------------------------r-------SSS----------------------------------
S---------------------|||-----------------------------------SS--2-----------------------------------%%%%%%%-------------------------------------------
S---------------------|||--------------------------------o-----2-2-------1--------o-----------------||||||----------------------K----------------SSSSS
S------------------%%%%%%%%-----------%%--------------------------2---T----------------TT-----------||||||---------------------SSS--------------------
S-------------------||||||-------------|T-----TT----------------------T----TT----------TT-----------||||||---------------------------TT---------------
S-------------------||||||--o----------|T-----TT----------------------T----TT----------TT-----------||||||---------------TT----------TT-----SSS-------
S--M---------%%%%---||||||-%%%-%%%%%%%-|T-----TT----k-----------------T---kTT----------TT----------g||||||--oo-----------TT----------TT------------r--
XXXXXXXXXXX---||----||||||--|---|||||--|XXXX--XXXX-XXXXXXXXX---XXXXXXXXXXXXXXXXXXXXXXXXXXX-XXXXXXXXX||||||--%%%%%%----%%XXXXXXXXXXXXXXXXXXXX-----XXXXX
XXXXXXXXXXX---||----||||||--|---|||||--|XXXX--XXXX-XXXXXXXXX---XXXXXXXXXXXXXXXXXXXXXXXXXXX-XXXXXXXXX||||||---||||------|XXXXXXXXXXXXXXXXXXXX-----XXXXX
