------------------------------------------------------------------------------------------------------------------------------------------------------
------------------------------------------------------------------------------------------------------------------------------------------------------
------------------------------------------------------------------------------------------------------------------------------------------------------
----------SSSSSSSSSSSSSSSSSSSS----------------------------------------------------------------------SSSSSSSSSS----------------------------------------
-------------------------------------------------------------------------o----------------------------------------------------------------------------
------------------------------------------------------------------------%%%-----------------oo--------------------------------------------------------
--------------------------------------------------------------USSS-------|--o--------1-------------------------------------------------US----------SSS
-------------------------------------------------------------------------|--SSSS------------------------------------------------oo--------------------
----------------------------------------------------------------------%--|-------------------------%--------------------------------------------------
-----------------------------C-------------------------------------------|-----------------------------------------------------------SS---------------
---------Q-------------#-#--------------------tt-------------S-----TT----|---------QQQQ---SS-----------------T--!-----S------TT------------S------#---
---------------------#-#-#-#-----------T------tt----K--------------TT----|-----------------------------TT----T---------------TT-------------------#---
---------------------#-#-#-#-----------T------tt-------------------TT----|-----%-------------%%%%------TT----T---------------TT---TT--------------#---
---------------------#-#-#-#-E-------kkT-g----tt-----------g-ggg---TT----|----------yy--------||----g--TT----T-----------y---TT---TT---------ggg--#---
XXXXXXXXXXX--XX--X--XXXXXXXXXXXXXXXXXXXXXXXXXXXXXXXXXXXXXXXXXXXXXXXXXX%%%%%%----XXXXXXXXXX----||----XXXXXXXXXXXXXXXXXXXXXXXXXXXXXXXXXXXX-X-XXXXXXXXXXX
XXXXXXXXXXX--XX--X--XXXXXXXXXXXXXXXXXXXXXXXXXXXXXXXXXXXXXXXXXXXXXXXXXX|||||-----XXXXXXXXXX----||----XXXXXXXXXXXXXXXXXXXXXXXXXXXXXXXXXXXX-X-XXXXXXXXXXX
