------------------------------------------------------------------------------------------------------------------------------------------------------
------------------------------------------------------------------------------------------------------------------------------------------------------
------------------------------------------------------------------------------------------------------------------------------------------------------
---------------------------------------------------oo-----------------------------------------------SSSSSSSSSS------------------------------SSSSSSSSSS
-----------------------------------------g--------%%%%------------------------------------------------------------------------------------------------
----------------------------------------%%---------||-------------------------------------------------------------------------------------------------
----------------------------------------|----------||---------------------SSCSS------SUS-------------------------------------------SSSS---------------
----------------------------------------|----oo----||--SSS---o---o---o--------------------------------------------------------------------------------
----------------------------------------|----------||-------%%%-%%%-%%--------------------------------------------------------------------------------
----------------------------------------|----------||--------|---|---|-----------------------------------------------------------------SSSS-----------
-------------------%--------------------|----------||--------|---|---|--QQQQ--QQ----#####--------------------T--------------------------------TT------
----------------------------------------|----------||--------|---|---|--------------#------------------TT----T-#------------------------------TT------
----------------------------------------|---------%||--------|---|---|-------------K#------------B-----TT----T-#------------------------------TT------
-M-----------%%%%--------ggg------k-k---|----------||--------|---|-r-|--------------#------------b--g--TT----T-#----ggg--k----ggg-------------TT------
XXXXXXXXXXX---||----XXXXXXXXXXXXXXXXXXX-|----%%%%--||-------%%%%%%%%%%XXXXXXXXXXXXXXXXX---XXXXXXXXXXXXXXXXXXXX-XXXXXXXXXXXXXXXXXXX---------XXXXX--XXXX
XXXXXXXXXXX---||----XXXXXXXXXXXXXXXXXXX-|-----||---||--------|||||||||XXXXXXXXXXXXXXXXX---XXXXXXXXXXXXXXXXXXXX-XXXXXXXXXXXXXXXXXXX---------XXXXX--XXXX
