------------------------------------------------------------------------------------------------------------------------------------------------------
------------------------------------------------------------------------------------------------------------------------------------------------------
------------------------------------------------------------------------------------------------------------------------------------------------------
----------SSSSSSSSSS--------------------------------------------------------------------------------SSSSSSSSSS----------------------------------------
-------------------------------------------------------------------------o----------------------------------------------------------------------------
---------------------------------------------------------------------R--%%%---------------------------------------------------------------------------
--------------------------------------------------Q----------------------|--o--------------------------------------oo------------------------------SSS
-------------------------------------------------------------------------|--SSSS--------------------------------------------------oo------------------
----------------------------------------------------------------------%--|----------------------------------------------------------------------------
-------------------------------------------------------------------------|--------o-------------------------------------SS-?Q-------------------------
----------@QQQQ-----------------------------------Q--------------%%%-----|-------------TT--------------------T-%%%%--%%%-------------------Q------#---
------------------------------------------------------------------|------|-------------TT--------------TT----T--||----||--------------------------#---
-----------------g-#----------------------------------------------|------|-----%-------TT--------B-----TT----T--||----||-------y------------------#---
-M--------------g#-#-----ggg------k-k----------------gg----k------|------|-------------TT--------b--g--TT----To-||----||---SSSSS-------------ggg--#---
XXXXXXXXXXXXXXXXXXXXXXXXXXXXXXXXXXXXXXX-X-XX-XX-XXXXXXXXXXXX%%%%%-|---%%%%%%----XXXXXXXXXXXXXXXXXXXXXXXXXXXXXX%-||----||-------XX-XXXXXXXXXXXXXXXXXXXX
XXXXXXXXXXXXXXXXXXXXXXXXXXXXXXXXXXXXXXX-X-XX-XX-XXXXXXXXXXXX-|||--|---|||||-----XXXXXXXXXXXXXXXXXXXXXXXXXXXXXX--||----||-------XX-XXXXXXXXXXXXXXXXXXXX
