------------------------------------------------------------------------------------------------------------------------------------------------------
------------------------------------------------------------------------------------------------------------------------------------------------------
------------------------------------------------------------------------------------------------------------------------------------------------------
----------------------------------------------------------------------SSSSSSSSSS----------SSSSSSSSSS------------------------------SSSSSSSSSS----------
----------------------------------------------------------------------------SSSS---------------------------------------------------------------------o
--------------------------------------------------------------g----------g--SSSS--------oo------------------------------------------------------------
----------------------------------------------QQQQ------------SSSSS-----SS------oo--------------------------------------SS----------------------------
------------------------------------------------------------------------SS---------------------------------------SSS----------------------------SSS---
------------------------------------------------------------------------SS------------------------------------------------------------------oo--------
------------------------------------------------k--------o--------------SC--g-g--SSS---------------------------------------TT-------------------------
-----SSS-----------------------TT-------T-----?QQQ----------------------SS--SSSS---------S---------------------------------TT---------------SS--------
-------------------------------TT-------T-------------------------------------------------t-----------------------------t--TT-------------TT----------
-------------------------------TT-------T---------------------TT-----t--------------------t---------------*-------------t--TT------tt-----TT----------
--------------k-ggg-----------gTT-------T-----------k---------TT-----t--------------------t---------gg----*-------------t--TT------tt----kTT----------
XXXXXXXXXXXXXXXXXXXXXXXXX--XXXXXXXXXXX--XXXXXXXXXX-XXXXXXXXXXXXXXXXXXXXXXXXXXXXX----------XXXXXXXXXXXXXXXXXXX-%%%%----%%XXXXXXXXXXXXXXXXXXXX----------
XXXXXXXXXXXXXXXXXXXXXXXXX--XXXXXXXXXXX--XXXXXXXXXX-XXXXXXXXXXXXXXXXXXXXXXXXXXXXX----------XXXXXXXXXXXXXXXXXXX-|||------|XXXXXXXXXXXXXXXXXXXX----------
