------------------------------------------------------------------------------------------------------------------------------------------------------
------------------------------------------------------------------------------------------------------------------------------------------------------
------------------------------------------------------------------------------------------------------------------------------------------------------
--------------------------------------------------------------------------------SSSSSSSSSS------------------------------------------------------------
------------------------------------------------------------------------------------------------------------------------------------------------------
----------------------------------------------------------------------------------------------------oo------------------------------------------------
--------------------------------------------------------------------------SS--------------SSS------%%%%------------oo---SSS-------!S---------QQQQ-----
----------------------------------------------------------------------------------------------------||--o----R----------------------------------------
---------------------------------------------------------TT-----------------------------------------||-%%%--------------------------------------------
---------------------------------------------------TT----TT----------------------------S------------||--|--------------------------------------y------
-------------------------------TT------------------TT----XX-----------SS-----SS-SU----------%%%-----||--|------%%%%--%%%----------S------#--Q?SSQQQ---
-------------------------------TT------------------TT-------------------------------TT---t---|------||-o|-------||----||----------------##------------
-------------------------------TT------------------TT-------------------------------TT---t---|------||%%%%%-----||----||------TT-------###------------
--------------k-ggg------ggg--gTT--------------y---TT--------y---------------------kTT--kt---|------||-|||----o-||----||------TT------####------------
XXXXXXXXXXXXXXXXXXXXXXXXXXXXXXXXXXXXXX--XXXXXXXXXXXXXXXXXXXXXXXXXXXXXX----------XXXXXXXXXX---|------||-|||----%-||----||----XXXXXXXXXXXXXXXXXX--XXXXXX
XXXXXXXXXXXXXXXXXXXXXXXXXXXXXXXXXXXXXX--XXXXXXXXXXXXXXXXXXXXXXXXXXXXXX----------XXXXXXXXXX---|------||-|||------||----||----XXXXXXXXXXXXXXXXXX--XXXXXX
