------------------------------------------------------------------------------------------------------------------------------------------------------
------------------------------------------------------------------------------------------------------------------------------------------------------
------------------------------------------------------------------------------------------------------------------------------------------------------
----------------------------------------------------------------------------------------------------------------------------------SSSSSSSS------U-----
------------------------------------------------------------------------------------------------------------------------------------------------------
----------------------ooor--------------------------------------------------------------oo-------------------------k----------------------------------
---------------------%%%%%----S-------------------Q-----------------------SSCSS-oo----------------------------S---SSSSSS-SSS----S!--------------------
----------------------|||------------------------------------o---o---o----------------------------------------------------------------------------SS--
----------------------|||-----------------------------------%%%-%%%-%%--------------------------------------------------------------------------------
----------------------|||------------------------------------|---|---|-----------SS-------------g---------------------------------------------SS------
-------------------%%%%%%%%---##--SSC-------------Q----------|---|---|--QQQQ--QQ---------S------TT----%%%%%%---------------------S-----g##-----------#
--------------------||||||-----------------------------------|---|---|--------------------------TT-----||||----------------------------###----------##
--------------------||||||--o--------------------------------|---|---|--------------------------TT-----||||---TT---------------------g####---------###
-M-----------%%%%---||||||-%%%-----------------ggg---gg----k-|---|-r-|--------------------------TT-----||||---TT------------gg-g-g---#####--------####
XXXXXXXXXXX---||----||||||--|-XX--XXXXXX-XXXXXXXXXXXXXXXXXXX%%%%%%%%%%XXXXXXXXXX----------XXXXXXXXX-%%-||||-%%XXXXXXXX--XXXXXXXXXXXXXXXXXX--XXXXX-XXXX
XXXXXXXXXXX---||----||||||--|-XX--XXXXXX-XXXXXXXXXXXXXXXXXXX-|||||||||XXXXXXXXXX----------XXXXXXXXX-|--||||--|XXXXXXXX--XXXXXXXXXXXXXXXXXX--XXXXX-XXXX
