------------------------------------------------------------------------------------------------------------------------------------------------------
------------------------------------------------------------------------------------------------------------------------------------------------------
------------------------------------------------------------------------------------------------------------------------------------------------------
------------------------------------------------------------------------------------------------------------------------SSS-----SS--------------------
-----------------------------------------g-----------------------------------------------------------------------------------------------------------o
----------------------------------------%%------------------------------------------------------------------------------------------------------------
----------------------------------------|-------------------------------------------------------------------------------US----------------------------
----------------------------------------|----oo-----------------------------------------------------------------------------------oo------------SSS---
----------------------------------------|-----------------------------o-----------TT----------------------------------------SSS-------------oo--------
----------------------------------------|----------------o------1-----------------TT------------------------------------------------------------------
-------------------%--------TT----------|-----------------------------------------TT-------------tt---------------------SSS----------------QSS--------
----------------------------TT--------tt|-------------------------------------#---TT-----TT------tt---TT-------#--------------------------------------
----------------------------TT--------tt|------------------------------------##-T-TT-----TT------tt---TT----TT-#--------------------------------------
-M-----------%%%%-------ggg-TT--------tt|-----------k---------------------------T-TT---k-TT------tt---TT-k--TT-#----ggg-------------------------------
XXXXXXXXXXX---||----XXXXXXXXXXXXXXXXXXXX|----%%%%--XXXXXXXXXXXXXXXXXX-XXXXXXXXXXXXXXXXXXXXXXXXXXXXXXXXXXXXXXXX-XXXXXXXXXXXX------XXXXXXXXXXX----------
XXXXXXXXXXX---||----XXXXXXXXXXXXXXXXXXXX|-----||---XXXXXXXXXXXXXXXXXX-XXXXXXXXXXXXXXXXXXXXXXXXXXXXXXXXXXXXXXXX-XXXXXXXXXXXX------XXXXXXXXXXX----------
