------------------------------------------------------------------------------------------------------------------------------------------------------
------------------------------------------------------------------------------------------------------------------------------------------------------
------------------------------------------------------------------------------------------------------------------------------------------------------
------------------------------SSSSSSSSSS--------------------------------------------------------------------------------------------------------U-----
------------------------------------------------------------------------------------------------------------------------------------------------------
----------------------------------------%%------------------------------------------------------------------------------------------------------------
------------------SC--------------------|-------------------------SSoo-----1-------USS----------------------------------------------------------------
----------------------------------------|----oo---------------------------------------------------------------------------------------------------SS--
---------------------------------------S|--------------------------------------------------------------------------------------------g#---------------
---------------------------------------S|----------------------------------ggg------------------------------------------------------g##-------SS------
---------Q----TT---2-------------------S|-------------------%%%%%%----#########---#--------------tt---------------------------------###--------------#
--------------TT---------------#--------|-----------K--------||||-------------#---#-------T------tt---------g--#-------------------####-------------##
--------------TT---------------#-#------|--------------------||||-------------#---##------T------tt---------TT-#------------------#####------------###
-M------------TT---------------#-#------|------------------g-||||-------------#---##--gg--T------tt---------TT-#----ggg--k----ggg-#####-----------####
XXXXXXXXXXXXXXXXXXXXXXXXX--XXXXXXXXXXXXX|----%%%%-XXXXXXXXXX-||||-------------X---XXXXXXXXXXXXXXXXXX--XXXXXXXX-XXXXXXXXXXXXXXXXXXXXXXXX--XXXXXXXX-XXXX
XXXXXXXXXXXXXXXXXXXXXXXXX--XXXXXXXXXXXXX|-----||--XXXXXXXXXX-||||-------------X---XXXXXXXXXXXXXXXXXX--XXXXXXXX-XXXXXXXXXXXXXXXXXXXXXXXX--XXXXXXXX-XXXX
