------------------------------------------------------------------------------------------------------------------------------------------------------
------------------------------------------------------------------------------------------------------------------------------------------------------
------------------------------------------------------------------------------------------------------------------------------------------------------
------------------------------------------------------------SSSSSSSSSS--------------------------------------------------------------------------------
------------------------------------------------------------SSSS--SSSS--------------------------------------------------------------------------------
--------------------------------------oo--------------------SSSS--SSSS--------------------------------------------------------------------------------
-----------------------------U-----SSSS------------------Q-Q--SS---S----------------------SSS------%--------------------------------------------------
--------------------------------------------------------------SS---S----------------------------------------------------------------------------------
--------------------------------------------------------------SS---S--o------------------------------------------------y------------------------------
------------------------------------------------------------ooSS---SoU------------o------------------------------------X-------SSS--------------------
----------------!-----------##%--------------------------Q-QSSSS---SSS-----------------TT---%%%-------%%%%%%----------XX%-----------------------------
-----------------------y-#####---------------K---B----------------------------#--------TT----|---------||||----------XXX-------------TT---------------
--------------------y-######---------------------b---------------------------##--------TT----|---------||||---------XXXX-------------TT------------F--
--------------------######-----------------------B----------k--g-g---------------------TT----|---------||||--------XXXXX---------r---TT------------#--
XXXXXXXXXXXXXXXXXXXXXXXX--------%%%%--%%XXXXXXXXXXXXXXXXXXXXXXXXXXXXXXXXXXXXXXXXXXXXXXXXXX---|------%%-||||-%%XXXXXXXXXX----XXXXXXXXXXXXXXXXXXXXXXXXXX
XXXXXXXXXXXXXXXXXXXXXXXX---------||----|XXXXXXXXXXXXXXXXXXXXXXXXXXXXXXXXXXXXXXXXXXXXXXXXXX---|------|--||||--|XXXXXXXXXX----XXXXXXXXXXXXXXXXXXXXXXXXXX
