------------------------------------------------------------------------------------------------------------------------------------------------------
------------------------------------------------------------------------------------------------------------------------------------------------------
------------------------------------------------------------------------------------------------------------------------------------------------------
------------------------------------------------------------------------------------------SSSSSSSSSS--------------------SSS-----SS----------SSSSSSSSSS
-----------------------------------------g------------------------------------------------------------------------------------------------------------
----------------------ooor--------------%%-------------oooo-----------------------g-------------------------------------------------------------------
---------------------%%%%%--------------|--------------%%%%---USSS----------SSSSSSSSSSSS--------------------------------US-------------US-------------
----------------------|||---------------|----oo---SSSS--||--------------------------------------------------------------------------------------------
----------------------|||---------------|---------------||------------------------------------------------------------------SSS-----------------------
----------------------|||----------oo---|---------------||-------------------K-------------------------------------------------------SS---------------
--------SU----------%%%%%%%-------o--o--|---------------||---S-----TT------SSSSS----------------------------------------SSS----------------S--TT------
-----------------K--||||||--------------|-------------U-||---------TT-T-------------------------------TT--------------------------------------TT------
------------B-------||||||--o-----------|---------------||---------TT-T-------------------------------TT----TT--------------------TT----------TT------
--M---------b-------||||||-%%%----------|---------------||---ggg---TT-T-------------------------g-g---TT-k--TT-k----kkk-----------TT----------TT------
XXXXXXXXXXXXXXXXXXXX||||||--|-XXXXXXXXXX|----%%%%-----%%%%%-XXXXXXXXXXXXXXXXXXXXXXXXXX---XXXXXXXXXXXXXXXXXXXXXXXXXXXXXXXXXX------XXXXXXX-X-XXXXX--XXXX
XXXXXXXXXXXXXXXXXXXX||||||--|-XXXXXXXXXX|-----||-------|||--XXXXXXXXXXXXXXXXXXXXXXXXXX---XXXXXXXXXXXXXXXXXXXXXXXXXXXXXXXXXX------XXXXXXX-X-XXXXX--XXXX
