------------------------------------------------------------------------------------------------------------------------------------------------------
------------------------------------------------------------------------------------------------------------------------------------------------------
------------------------------------------------------------------------------------------------------------------------------------------------------
--------------------------------------------------------------------------------------------------------------------------------------------SSSSSSSSSS
------------------------------------------------------------------------------------------------------------------------------------------------------
-------------------------------------------------------------------------------------------------------------------k----------------------------------
----------------------!-------------------------------------------SSoo------SSSS-----SUS---------------------RS---SSSSSS----------!S------------------
-----------------------------------------------------------------------------------------------------r------------------------------------------------
----------------------------------------------------------------------------------------------------%%%%%%%-------------------------------------------
---------------------------------------------------------o-------------------K--------------------oo||||||--------------SS-?Q-------------------------
----------Q---------S@S!S-----------------------------------%%%%%%---------SSSSS----#####-----------||||||------------------------S------#----TT------
-------------------------------------------------------------||||-----T-------------#----------TT---||||||------------------------------##----TT------
----------------------------tt-------------------------------||||-----T------------K#----------TT---||||||----TT---------------y-------###----TT------
-------------------#-g------tt----k-k---------------k--------||||-----T-------------#-------y--TT---||||||--ooTT-----------SSSSS------####----TT------
XXXXXXXXXXXXX--XXXXXXXXXXXXXXXXXXXXXXXX-X-XX-XX-XX-XXXXXXXXX-||||-----XXXXXXXXXXXXXXXXX---XXXXXXXXXX||||||--%%XXXXXXXX---------XX-XXXXXXXXXXXXXX--XXXX
XXXXXXXXXXXXX--XXXXXXXXXXXXXXXXXXXXXXXX-X-XX-XX-XX-XXXXXXXXX-||||-----XXXXXXXXXXXXXXXXX---XXXXXXXXXX||||||---|XXXXXXXX---------XX-XXXXXXXXXXXXXX--XXXX
