------------------------------------------------------------------------------------------------------------------------------------------------------
------------------------------------------------------------------------------------------------------------------------------------------------------
------------------------------------------------------------------------------------------------------------------------------------------------------
S-----SSSS--------------------SSSSSSSSSS--------------------------------------------------------------------------------------------------------------
S-----------------------------SSSSSSSSSS--------------------------------------------------------------------------------------------------------------
S-----------------------------SSSSSSSSSSooooo----------oooo----------R----------K---------------------------------------------------------------------
S-----------------Q-----------SSSSSSSSSS---------------%%%%---------------SSCSS-SS----1----SSS!--------------R-------------------------------QQQQ-----
S-----------------------------------------------SS------||-----------------------------------------------r-------SSS----------------------------------
S----------------------------------------SSSS-----------||------------------------------------------%%%%%%%--------------------------g#---------------
S-------------------------------------------------SSS---||------------------------------------------||||||---------------------SSS--g##--------y------
S-----------------?---------TTSSSSSSSSSS----------------||-------%%%----QQQQ--QQSS------------C-----||||||--------------%-----------###-----Q?SSQQQ---
S-------------TT------------TTSSSSSSSSSS--------------U-||--------|-------------------TT------------||||||-------------------------####---------------
S-------------TT------------TTSSSSSSSSSS----%%%%%-------||--------|-------------------TT------------||||||------------------------#####---------------
S-------------TT--------ggg-TTSSSSSSSSSS-----|||--------||--------|-------------------TT-------g-g--||||||--oo-------------------r#####---------------
XXXXXXXXXXXXXXXXXXXXXXXXXXXXXXXXXXXXXXXX%%---|||------%%%%%-%%%%%-|---XXXXXXXXXXXXXXXXXXXXXXXXXXXXXX||||||--%%%%%%----%%----XXXXXXXXXXX--XXXXX--XXXXXX
XXXXXXXXXXXXXXXXXXXXXXXXXXXXXXXXXXXXXXXX|----|||-------|||---|||--|---XXXXXXXXXXXXXXXXXXXXXXXXXXXXXX||||||---||||------|----XXXXXXXXXXX--XXXXX--XXXXXX
