------------------------------------------------------------------------------------------------------------------------------------------------------
------------------------------------------------------------------------------------------------------------------------------------------------------
------------------------------------------------------------------------------------------------------------------------------------------------------
--------------------------------oo----------------------------------------------ooo-------------------------------------------------------------------
-------------------------------------g-g-g--------------------------------------%%%-------------------------------------------------------------------
-----------------------------------%%%%%%%--------------------g------------------|---------------------------------k----------------------------------
------------------Q-----------------|||||---------------------SSSSS--------------|----------------------------S---SSSSSSSSS--------------##--------SSS
------------------------------------|||||----oo----------------------------------|------------------------TT-----------------------------##-----------
------------------------------------|||||-----------------------------o----------|------------------------TT---------------------------####-----------
------------------------------%%%%%-|||||----------------o-----------------------|---%%%%---------oo------TT---------------------------####-----------
--------SU--------?------------|||--|||||----------------------------------------|----||-----------------SXXS------------------------######-------#---
--------------TT---------------|||--|||||-------------------------------------#-%%%%%%||-------TT------------------------------------######-------#---
--------------TT---------------|||--|||||---------------------TT-----t-------##--||||-||-------TT---TT--------TT--------------TT-----######-------#---
--M-----------TT---------------|||--|||||-----------k---------TT-----t-----------||||-||----y--TT---TT--------TT--------------TT-----######--ggg--#---
XXXXXXXXXXXXXXXXXXXXXXXXX--XXX-|||--|||||----%%%%--XXXXXXXXXXXXXXXXXXXXXXXXXXXXX-||||-||%%XXXXXXXXXXXXXXXXXXXXXXXXXXXX------XXXXXXXXXXXXXXXXXXXXXXXXXX
XXXXXXXXXXXXXXXXXXXXXXXXX--XXX-|||--|||||-----||---XXXXXXXXXXXXXXXXXXXXXXXXXXXXX-||||-||-|XXXXXXXXXXXXXXXXXXXXXXXXXXXX------XXXXXXXXXXXXXXXXXXXXXXXXXX
