------------------------------------------------------------------------------------------------------------------------------------------------------
------------------------------------------------------------------------------------------------------------------------------------------------------
------------------------------------------------------------------------------------------------------------------------------------------------------
S-----SSSS----------------------oo----------------SSSSSSS-------------SSSSSSSSSS----------SSSSSSSSSS--------------------SSSSSSSSSS--------------------
S------------------------------------g-g-g----------------------------------SSSS----------------------------------------------------------------------
S---------------------ooor---------%%%%%%%-------------------------------g--SSSS----------------------------------------------------------------------
S--------------------%%%%%----------|||||---------QQ--------------SSoo--SS-----------SUS----------------SSQSSS--------US------------------------------
S---------------------|||-----------|||||----oo-------------------------SS----------------------------------------------------------------------------
S---------------------|||-----------|||||------------------S------------SS----------------------------------------------------------------------------
S---------------------|||-----%%%%%-|||||-------------------------------SC--g-g---------------------------K---------E---------------------------------
S------------------%%%%%%%%----|||--|||||---------QQ--QQQ---%%%%%%------SS--SSSS----#####---------------SSSSSS-----TT----------------------#----------
S-------------------||||||-----|||--|||||--------------------||||-------------------#-----t------------------------TT--t--SS--------------##----------
S-------------------||||||--o--|||--|||||--------------------||||------------------K#-----t------------------------TT--t--SS-------------###-------F--
S------------%%%%---||||||-%%%-|||--|||||--------------------||||-------------------#-----t---------------------g--TT--t--SS---------y--####-------#--
XXXXXXXXXXX---||----||||||--|--|||--|||||----%%%%-XXXXXXX----||||-----XXXXXXXXXXXXXXXXX---XXXXXXXXXXXXXXXXXXXXXXXXXXXXXX--XX--XXXXXXXXXXXXXXXXXXXXXXXX
XXXXXXXXXXX---||----||||||--|--|||--|||||-----||--XXXXXXX----||||-----XXXXXXXXXXXXXXXXX---XXXXXXXXXXXXXXXXXXXXXXXXXXXXXX--XX--XXXXXXXXXXXXXXXXXXXXXXXX
