------------------------------------------------------------------------------------------------------------------------------------------------------
------------------------------------------------------------------------------------------------------------------------------------------------------
------------------------------------------------------------------------------------------------------------------------------------------------------
--------------------------------------------------SSSSSSSSSS----------SSSSSSSSSSooo---------------------------SS-------S----------SSSSSSSS------------
------------------------------------------------------SS--SS----------------SSSS%%%-------------------------------------------------------------------
----------------------ooor----------------------------SS--SS-------------g--SSSS-|--------------------------------------------------------------------
---------------------%%%%%----S---------------QQQQ--SS------------------SS-------|----------------------SSQSSS---------S------------------------------
----------------------|||---------------------------SS------------------SS-------|--------------------------------------------------------------------
----------------------|||---------------------------SS---------------o--SS-------|---------------------------------SSS--------------------------------
----------------------|||-----------------------k---SS----oo-----y------SC--g-g--|---%%%%--o--------------K-------------------------------------------
----------Q---------%%%%%%%---##--SSC---T-----?QQQ--SSSS--SS-----##-----SS--SSSS-|----||---------TT-----SSSSSS---------S---------------g##------------
--------------------||||||--------------T-------------SS--------###-------------%%%%%%||---------TT------------##----------------------###------------
--------------------||||||--o-----------T-------------SS-------####--------------||||-||---------TT------------##--------------------g####---------F--
-M-----------------#||||||-%%%----------T---------------------#####--------------||||-||---------TT------------##--------k----ggg----#####---------#--
XXXXXXXXXXXXX--XXXXX||||||--|-XX--XXXXXXXXXXXXXXXXXXXXXXXXXXXXXXXXX---XXXXXXXXXX-||||-||%%XXXXXXXXXXXXXXXXXXXX-XX------XXXXXXXXXXXXXXXXXXX--XXXXXXXXXX
XXXXXXXXXXXXX--XXXXX||||||--|-XX--XXXXXXXXXXXXXXXXXXXXXXXXXXXXXXXXX---XXXXXXXXXX-||||-||-|XXXXXXXXXXXXXXXXXXXX-XX------XXXXXXXXXXXXXXXXXXX--XXXXXXXXXX
