------------------------------------------------------------------------------------------------------------------------------------------------------
------------------------------------------------------------------------------------------------------------------------------------------------------
------------------------------------------------------------------------------------------------------------------------------------------------------
--------------------SSSSSSSSSS----------------------------------------SSSSSSSSSS----------------------------------------------------------------------
-----------------------------------------g----------------------------------SSSS----------------------------------------------------------------------
----------------------------------------%%-------------------------------g--SSSS----------------------------------------------------------------------
----------------------------------------|-------------------------------SS----------y------------------------@----------SSS-------SS------------------
----------------------------------------|----oo-------------------------SS--------#SSS----------------------------------------------------------------
----------------------------------------|-------------------------------SS-------##-------------------------------------------------------------------
-----------------------------C----------|----------------o--------------SC--g-g-###1-----------oooo---------------------------------------------------
---------Q-------------#-#--------------|-------------------------------SS--SSSS###-----------------SU----!--!--------------------SS----------#LSS----
---------------------#-#-#-#----------tt|---------------------------------------###--SSS------------------------------------------K---#----B--#-------
---------------------#-#-#-#----------tt|---------------------------------------###-------------------------------------------TT------#----b--#-------
-M--------k---ggg----#-#-#-#-E--------tt|-----------k--------y------------------###-----------------------k----k----kkk-------TT------#----Bkk#-------
XXXXXXXXXXXXXXXXXXXXXXXXXXXXXXXXXXXXXXXX|----%%%%--XXXXXXXXXXXXXXXXXXXXXXXXXXXXXXXXXXX---X%%%%%%%-%%XXXXXXXXXXXXXXXXXXXX----XXXXXXXXXXXXXXXXXXXXXXX---
XXXXXXXXXXXXXXXXXXXXXXXXXXXXXXXXXXXXXXXX|-----||---XXXXXXXXXXXXXXXXXXXXXXXXXXXXXXXXXXX---X||||||---|XXXXXXXXXXXXXXXXXXXX----XXXXXXXXXXXXXXXXXXXXXXX---
