------------------------------------------------------------------------------------------------------------------------------------------------------
------------------------------------------------------------------------------------------------------------------------------------------------------
------------------------------------------------------------------------------------------------------------------------------------------------------
--------------------SSSSSSSSSS----------------------------------------------------------------------------------------------------SSSSSSSSSS----------
------------------------------------------------------------------------------------------------------------------------------------------------------
----------------------------------------ooooo-------------------------------------------------------oo-------------k----------------------------------
--------------------------------------------------Q------------------------g--------y---------------%%%-------S---SSSSSS-SSS----S!--------------------
------------------------------------------------SS---------------------%%%%%%-----#SSS------------oo||--o----R----------------------------------------
-----------------------------------------SSSS---------------------------||||-----##-----------------||-%%%--------------------------------------------
-----------------------------C-----oo-----------------------------------||||----###1----------------||--|---------------------------------------------
----------------%%%%---#-#--------o--o------------Q------------------T--||||----###-----------------||--|------------------------S--------------------
-----------------||--#-#-#-#-----------------------------------------T--||||----###--SSS--------#---||-o|---------------------------------TT----------
-----------------||--#-#-#-#----------------%%%%%--------------------T--||||----###-------------#---||%%%%%---TT-------------------tt-----TT-------F--
-M---------------||--#-#-#-#-E---------------|||-----gg----k--ggg----T--||||----###-------------#---||-|||----TT------------gg-g-g-tt----kTT-------#--
XXXXXXXXXXX--%%%%||%XXXXXXXXXXXXXXXXXXXX%%---|||--XXXXXXXXXXXXXXXXXXXX--||||----XXXXXX---XXXXXXXXXXX||-|||----XXXXXXXX--XXXXXXXXXXXXXXXXXXXXXXXXXXXXXX
XXXXXXXXXXX---||-||-XXXXXXXXXXXXXXXXXXXX|----|||--XXXXXXXXXXXXXXXXXXXX--||||----XXXXXX---XXXXXXXXXXX||-|||----XXXXXXXX--XXXXXXXXXXXXXXXXXXXXXXXXXXXXXX
