------------------------------------------------------------------------------------------------------------------------------------------------------
------------------------------------------------------------------------------------------------------------------------------------------------------
------------------------------------------------------------------------------------------------------------------------------------------------------
------------------------------SSSSSSSSSS----------------------------------------------------------------------SSSSSSSSSS----------SSSSSSSSSS----------
--------------------------------------------?---------------------------------------------------------------------------------------------------------
--------------------------------------------------------------g---------------------------------------------------------------------------------------
------------------SC------------------------------------------SSSSS-----------------y-------------------------------------SSC-------------------------
----------------------------------------------r-----------------------------------#SSS----------------------------------------------------------------
---------------------------------------S--%%%%%%----------------------o----------##-------------------------------------------------------------------
---------------------------------------S---||||---------------------------------###1--------------------------------------SSS-------------------------
--------------TT---2-------------------S%%-||||ooo------------------------------###--------------tt-----------T---------------------------------------
--------------TT---------------#--------|--||||--r--K-------------------------#-###--SSS--T------tt---TT------T---------------------------TT----------
--------------TT---------------#-#------|%%%%%%%%%------------TT-----t-------##-###-------T------tt---TT----TTT----TT--------------tt-----TT-------F--
-M------------TT---------ggg---#-#------|-||||||||---------g--TT-----t----------###-------T------tt---TT-k--TTT--g-TT------------#-tt----kTT-------#--
XXXXXXXXXXXXXXXXXXXXXXXXXXXXXXXXXXXXXXXX|-||||||||XXXXXXXXXXXXXXXXXXXXXXXXXXXXXXXXXXXX---XXXXXXXXXXXXXXXXXXXXXXXXXXXXXXXX----XXXXXXXXXXXXXXXXXXXXXXXXX
XXXXXXXXXXXXXXXXXXXXXXXXXXXXXXXXXXXXXXXX|-||||||||XXXXXXXXXXXXXXXXXXXXXXXXXXXXXXXXXXXX---XXXXXXXXXXXXXXXXXXXXXXXXXXXXXXXX----XXXXXXXXXXXXXXXXXXXXXXXXX
