------------------------------------------------------------------------------------------------------------------------------------------------------
------------------------------------------------------------------------------------------------------------------------------------------------------
------------------------------------------------------------------------------------------------------------------------------------------------------
----------SSSSSSSSSSSSSSSSSSSS------------------------------------------------------------------------------------------------------------------------
------------------------------------------------------------------------------------------------------------------------------------------------------
--------------------------------------------------------------g-----------------------------oo------oo------------------------------------------------
--------------------------------------------------------------SSSSS--------g------------------------%%%-------------------oo---%%%----------SSS-------
-----------------------------------------------------------------------%%%%%%-----------------------||--o----R---SSS------SS----||--------------------
------------------------------------------------------------------------||||-----------------------%||-%%%----------------------||--------------------
-----------------------------C---------------------------o--------------||||------o-----------------||--|-----------------------||---------------SSSSS
----------@QQQQ--------#-#-----TT---------------------------------------||||-----------TT-S---------||--|--------------------SS-||--------------------
---------------------#-#-#-#---TT------------K---B----------------------||||-----------TT-----------||-o|-----------------------||--------------------
-----------------g-#-#-#-#-#---TT----------------b------------TT-----t--||||-----------TT----%%%%---||%%%%%---------------------||----------SSS-------
-M--------------g#-#-#-#-#-#-EgTT----------------B--k---------TT-----t--||||-----------TT-----||----||-|||----------------------||k----------------r--
XXXXXXXXXXXXXXXXXXXXXXXXXXXXXXXXXXXXXX--XXXXXXXXXX-XXXXXXXXXXXXXXXXXXX--||||----XXXXXXXXXX----||----||-|||----%%%%----%%%%-----%%%XX---XXXXX-----XXXXX
XXXXXXXXXXXXXXXXXXXXXXXXXXXXXXXXXXXXXX--XXXXXXXXXX-XXXXXXXXXXXXXXXXXXX--||||----XXXXXXXXXX----||----||-|||----|||------||-------||XX---XXXXX-----XXXXX
