------------------------------------------------------------------------------------------------------------------------------------------------------
------------------------------------------------------------------------------------------------------------------------------------------------------
------------------------------------------------------------------------------------------------------------------------------------------------------
----------SSSSSSSSSS------------oo--------------------------------------------------------------------------------------SSS-----SS--------------------
---------------------------------------g----------?---------------------------------------------------------------------------------------------------
-----------------------------------%%%%%----------------------------------------------------oo--------------------------------------------------------
------------------------------------||||-----------------------------------g---------------------------------@----------US---------------##-----------
------------------------------------||||----------SS-------------------%%%%%%------------------------------------------------------------##-----------
------------------------------------||||--------------------------------||||-----------------------%------------------------SSS--------####-----------
------------------------------%%%%%-||||--------------------------------||||------o----------------------------------------------------####-----------
----------------------------TT-|||--||||--------------------------------||||-----------TT-SS--------SU----!--!----------SSS----------######---#LSS----
----------------------------TT-|||--||||T-----TT-------SSS-----------T--||||-----------TT--------------------------------------------######---#-------
----------------------------TT-|||--||||T-----TT-------------B-------T--||||-----------TT----%%%%------------------------------------######---#-------
-M----------------------ggg-TT-|||--||||T-----TT-------------b-------T--||||-----------TT-----||----------k----k----kkk--------------######-kk#-------
XXXXXXXXXXX--XX--X--XXXXXXXXXX-|||--||||XXXX--XXXX----------XXXXXX--XX--||||----XXXXXXXXXX----||----XXXXXXXXXXXXXXXXXXXXXXX------XXXXXXXXXXXXXXXXXX---
XXXXXXXXXXX--XX--X--XXXXXXXXXX-|||--||||XXXX--XXXX----------XXXXXX--XX--||||----XXXXXXXXXX----||----XXXXXXXXXXXXXXXXXXXXXXX------XXXXXXXXXXXXXXXXXX---
