------------------------------------------------------------------------------------------------------------------------------------------------------
------------------------------------------------------------------------------------------------------------------------------------------------------
------------------------------------------------------------------------------------------------------------------------------------------------------
--------------------SSSSSSSSSSSSSSSSSSSS----------------------------------------ooo-----------------SSSSSSSSSS--------------------SSSSSSSSSS----------
--------------------SSSSSSSSSS--------------------------------------------------%%%-------------------------------------------------------------------
--------------------SSSSSSSSSS---------------------------------------------------|--------------------------------------------------------------------
------------------SCSSSSSSSSSS---------------------------------------------1-----|--------------------------------------------------------------------
---------------------------------------------------------------------------------|------------------------------oooo------------oo--------------------
---------------------------------------S-----------------------------------------|--------------------------------------------------------------------
---------------------------------------S-----------------------------------ggg---|---%%%%-------------------------------------------------------------
--------------TT---2--SSSSSS?----------S------tt---------------------T#########--|----||---------tt----------TT--------------TT-------------#---------
--------------TT------SSSSS----#--------------tt----K----------------T--------#-%%%%%%||--T------tt----TT----TT--------------TT-----------TT##--------
--------------TT------SSSSS----#-#------------tt---------------------T--------#--||||-||--T------tt----TT----TT--------------TT----tt-----TT###------#
-M------------TT-----------ooo-#-#-------g----tt-----------g--ggg----T--------#--||||-||--T------tt-g--TT----TT---y------y---TT----tt----kTT####----##
XXXXXXXXXXXXXXXXXXXX-XXXXXXXXXXXXXXXXXXXXXXXXXXXXXXXXXXXXXXXXXXXXXXXXX--------X--||||-||%%XXXXXXXXXXXXXXXXXXXXXXXXXXXXXXXXXXXXXXXXXXXXXXXXXXXXXXXXXXXX
XXXXXXXXXXXXXXXXXXXX-XXXXXXXXXXXXXXXXXXXXXXXXXXXXXXXXXXXXXXXXXXXXXXXXX--------X--||||-||-|XXXXXXXXXXXXXXXXXXXXXXXXXXXXXXXXXXXXXXXXXXXXXXXXXXXXXXXXXXXX
