------------------------------------------------------------------------------------------------------------------------------------------------------
------------------------------------------------------------------------------------------------------------------------------------------------------
------------------------------------------------------------------------------------------------------------------------------------------------------
--------------------------------oo--------------------------------------------------------SSSSSSSSSS--------------------------------------------------
---------------------------------------g--------------------------------------------------------------------------------------------------------------
-----------------------------------%%%%%%%------------------------------------------------------------------------------------------------------------
--------------------USS-------------|||||----------------------------------1---------SUS------------------------------US-SSS----S!-----US---SSS-------
------------------------------------|||||----oo-------------------------------------------------------------------------------------------------------
------------------------------------|||||----------------B-----------o--------------------------------------------------------------------------------
------------------------------%%%%%-|||||----------------b-------y---------ggg--------------------------------------E----------------SS----------SSSSS
-------------------------------|||--|||||--------------SS#CS-----##---#########-----#####--------------------------TT------------S---------S----------
---------------------B---------|||--|||||-----------------------###-----------#-----#-----------------------g------TT--t------------------------------
---------------------b-------B-|||--|||||------------------K---####-----------#----K#-----------------------TT-----TT--t----------TT--------SSS-------
-M--------k---ggg----B-------b-|||--|||||---------------------#####-----------#-----#-----------g-g---------TT--g--TT--t----gg-g-gTT---------------r--
XXXXXXXXXXXXXXXXXXXXXXXXXXXXXX-|||--|||||----%%%%-XXXXXXXXXXXXXXXXX-----------X-XXXXXXX---XXXXXXXXXX--XXXXXXXXXXXXXXXXXXXXXXXXXXXXXXXXXX-X-X-----XXXXX
XXXXXXXXXXXXXXXXXXXXXXXXXXXXXX-|||--|||||-----||--XXXXXXXXXXXXXXXXX-----------X-XXXXXXX---XXXXXXXXXX--XXXXXXXXXXXXXXXXXXXXXXXXXXXXXXXXXX-X-X-----XXXXX
