------------------------------------------------------------------------------------------------------------------------------------------------------
------------------------------------------------------------------------------------------------------------------------------------------------------
------------------------------------------------------------------------------------------------------------------------------------------------------
S-----SSSS-----------------------------------------oo---------------------------SSSSSSSSSS------------------------------------------------------------
S-------------------------------------------------%%%%------------------------------------------------------------------------------------------------
S--------------------------------------------------||---------g---------------------------------------------------------------------------------------
S--------------------------------------------------||---------SSSSS---------------------------------------------------------------!S--------SS--------
S--------------------------------------------------||--SSS--------------------------------------------------------------------------------------------
S--------------------------------------------------||-------------------------------------------------------------------------------------------------
S--------------------------------------------------||----------------------------------S----------oo---------------------------SSS--------------------
S--------------------------------------------------||---------------------------SU--------------------------------------%---------S------#--SS--------
S-------------------------------------ttT-----TT---||-------------------------------TT---t-----TT-----------g---------------------------##--------#-TT
S-------------------------------------ttT-----TT--%||---------TT-----t--------------TT---t-----TT-----------TT-----B-------------------###-------##-TT
S--M------k---ggg--------ggg----------ttT-----TT---||---------TT-----t-------------kTT--kt--y--TT-----------TT-----b-------------r----####------###-TT
XXXXXXXXXXXXXXXXXXXXXXXXXXXXXXXXXXXXXXXXXXXX--XXXX-||-------XXXXXXXXXXX----XXXXXXXXXXXXXXXXXXXXXXXXX--XXXXXXXXXXXXXXXXXX----XXXXXXXXXXXXXXXXXXXXXXX-XX
XXXXXXXXXXXXXXXXXXXXXXXXXXXXXXXXXXXXXXXXXXXX--XXXX-||-------XXXXXXXXXXX----XXXXXXXXXXXXXXXXXXXXXXXXX--XXXXXXXXXXXXXXXXXX----XXXXXXXXXXXXXXXXXXXXXXX-XX
