------------------------------------------------------------------------------------------------------------------------------------------------------
------------------------------------------------------------------------------------------------------------------------------------------------------
------------------------------------------------------------------------------------------------------------------------------------------------------
--------------------------------oo---------------------------------SSS--------------------SSSSSSSSSS------------------------------SSSSSSSS------------
---------------------------------------g---------------------------------o----------------------------------------------------------------------------
-----------------------------------%%%%%ooooo---------------------------%%%---------------------------------------------------------------------------
------------------Q-----------------||||-----------------Q-Q----CSS------|--o------USS-------------------------------------------------------QQQQ-----
------------------------------------||||--------SS-----------------------|--SSSS----------------------------------------------------------------------
------------------------------------||||-SSSS---------------SS--2-----%--|---------------------------------------------y------------------------------
------------------------------%%%%%-||||-----------------------2-2-------|---------------------------------------------XSS-?Q------------------y------
---------Q--------?------------|||--||||-----------------Q-Q------2------|--------#-----------------------------------XX---------------g##--Q?SSQQQ---
--------------TT---------------|||--||||---------------------------------|--------#-------t-----------------g--------XXX---------------###------------
--------------TT---------------|||--||||----%%%%%------------------------|-----%--##------t-----------------TT------XXXX-------y-----g####------------
-M------------TT---------------|||--||||-----|||-------------------------|--------##--gg--t-----------------TT-----XXXXX---SSSSS-----#####------------
XXXXXXXXXXXXXXXXXXXXXXXXX--XXX-|||--||||%%---|||--XXXXXXXXXX---XXXXXXX%%%%%%------XXXXXXXXXXXXXXXXXX--XXXXXXXXXXXXXXXXXX-------XX-XXXXXXXX--XX--XXXXXX
XXXXXXXXXXXXXXXXXXXXXXXXX--XXX-|||--|||||----|||--XXXXXXXXXX---XXXXXXX|||||-------XXXXXXXXXXXXXXXXXX--XXXXXXXXXXXXXXXXXX-------XX-XXXXXXXX--XX--XXXXXX
