------------------------------------------------------------------------------------------------------------------------------------------------------
------------------------------------------------------------------------------------------------------------------------------------------------------
------------------------------------------------------------------------------------------------------------------------------------------------------
------------------------------SSSSSSSSSS----------------------------------------ooo-----------------SSSSSSSSSS----------------------------------------
------------------------------SSSSSSSSSS----------------------------------------%%%-------------------------------------------------------------------
-----------------------SSS----SSSSSSSSSS-----------------------------------------|--------------------------------------------------------------------
------------------------------SSSSSSSSSS--------------------------------SSSSS----|----------------------------?SSS------SSS--------SSSS---------------
---------------------g---------------------------------------o---o---o-----------|--------------------------------------------------------------------
-----------------g--%%%-------------------------------------%%%-%%%-%%-----------|--------------------------------------------------------------------
-----------------#--||----SSS----------------------------o---|---|---|-----------|---%%%%---------oo-----------------------------------SSSS-----------
----------S-----##--||--------SSSSSSSSSS---------------------|---|---|-------2---|----||---------------------TSSSSS---------------------------#LSS----
---------------###--||--------SSSSSSSSSS---------------------|---|---|-----TT---%%%%%%||-------TT------TT----T--------------------------------#-------
--------------####--||--------SSSSSSSSSS---------------------|---|---|t----TT--T-||||-||-------TT------TT----T----------------TT--------------#-------
-M-----------#####--||----oo--SSSSSSSSSS----y-y-----k--------|---|-r-|t----TT--T-||||-||----y--TT---g--TT----T--K-------------TT------------kk#-------
XXXXXXXXXXXXXXXXXXXX||---%%%--XXXXXXXXXXXXXXXXXXXX-XXXXXXXXX%%%%%%%%%%XXXXXXXXXX-||||-||%%XXXXXXXXXXXXXXXXXXXXXXXXXXXXXX----XXXXXX---------XXXXXXXX---
XXXXXXXXXXXXXXXXXXXX||----|---XXXXXXXXXXXXXXXXXXXX-XXXXXXXXX-|||||||||XXXXXXXXXX-||||-||-|XXXXXXXXXXXXXXXXXXXXXXXXXXXXXX----XXXXXX---------XXXXXXXX---
