------------------------------------------------------------------------------------------------------------------------------------------------------
------------------------------------------------------------------------------------------------------------------------------------------------------
------------------------------------------------------------------------------------------------------------------------------------------------------
------------------------------SSSSSSSSSS--------------------------------------------------------------------------------------------------------------
------------------------------SSSSSSSSSS--------------------------------------------------------------------------------------------------------------
------------------------------SSSSSSSSSS-----------------------------R----------K---------------------------------------------------------------------
------------------------------SSSSSSSSSS-----------------------------------g----SS----1-----------------SSQSSS--------------------%-------------------
-----------------------------------------------------------------------%%%%%%------------------------------------------------------------------y------
------------------------------------------------------------------------||||-------------------------------------------------SSS--------SSS--#SS--o---
------------------------------------------------------------------------||||------------------------------K---------------------------------##--------
---------Q------------------TTSSSSSSSSSS---------------ooo-------%%%----||||----SS----------------------SSSSSS----------r---------%%%%%-----##--SC----
----------------------------TTSSSSSSSSSS--------------------------|-----||||----------TT--------------------------------%%%%%%-----|||------##--------
----------------------------TTSSSSSSSSSS--------------------------|-----||||----------TT--------------------------------|||||------|||------##---SSS--
--------------k-ggg-----ggg-TTSSSSSSSSSS----y-y-------------------|-----||||----------TT-----------g-----------k----kkk-|||||------|||------##--------
XXXXXXXXXXXXXXXXXXXXXXXXXXXXXXXXXXXXXXXXXXXXXXXXXX--XXXXXXXX%%%%%-|-----||||----XXXXXXXXXX-XXXXXXXXXXXXXXXXXXXXXXXXXXXXX|||||-----%|||------XX------XX
XXXXXXXXXXXXXXXXXXXXXXXXXXXXXXXXXXXXXXXXXXXXXXXXXX--XXXXXXXX-|||--|-----||||----XXXXXXXXXX-XXXXXXXXXXXXXXXXXXXXXXXXXXXXX|||||------|||------XX------XX
