------------------------------------------------------------------------------------------------------------------------------------------------------
------------------------------------------------------------------------------------------------------------------------------------------------------
------------------------------------------------------------------------------------------------------------------------------------------------------
----------SSSSSSSSSS------------oo----------------------------------------------SSSSSSSSSL------------------------------------------------------------
---------------------------------------g--------------------------------------------------------------------------------------------------------------
-----------------------------------%%%%%--------------------------------------------------------------------------------------------------------------
------------------------------------||||--------------------------------------------oooooo--------------SSQSSS--------------------!S--------SS--------
------------------------------------||||------------------------------------------------------------------------oooo----------------------------------
------------------------------------||||-----------------------------o--------------SSSSSS------------------------------------------------------------
------------------------------%%%%%-||||-----------------o-------y------------------SSSSSS--------oo------K-------------------------------------------
----------------------------TT-|||--||||-------------------------##-------------------------------------SSSSSST-------------------S------#--SS--------
----------------------------TT-|||--||||------------------------###----------------------------TT-------------T-------------------------##--------#-TT
----------------------------TT-|||--||||-----------------------####----------------------------TT-------------T------------------------###-------##-TT
-M----------------------ggg-TT-|||--||||-------ggg--k---------#####-------------------------y--TT-------------T---y------k----ggg-----####------###-TT
XXXXXXXXXXX--XX--X--XXXXXXXXXX-|||--||||-XXXXXXXXX-XXXXXXXXXXXXXXXX---X----XXXXX---XXXXXXXXXXXXXXXXXXXXXXXXXXXXXXXXXXXXXXXXXXXXXXXXXXXXXXXXXXXXXXXX-XX
XXXXXXXXXXX--XX--X--XXXXXXXXXX-|||--||||-XXXXXXXXX-XXXXXXXXXXXXXXXX---X----XXXXX---XXXXXXXXXXXXXXXXXXXXXXXXXXXXXXXXXXXXXXXXXXXXXXXXXXXXXXXXXXXXXXXX-XX
