------------------------------------------------------------------------------------------------------------------------------------------------------
------------------------------------------------------------------------------------------------------------------------------------------------------
------------------------------------------------------------------------------------------------------------------------------------------------------
-----------------------oo-----------------------------------------------------------------SSSSSSSSSS----------------------------------------SSSSSSSSSS
------------------------------------------------------------------------------------------------------------------------------------------------------
----------------------------------------%%-------------------------------------------------------------------------k----------------------------------
----------------------SSSS--------------|-------------------------SSoo-------------USS------------------------S---SSSSSS--SSC-----!S------------------
----------------------------------------|----oo-------------------------------------------------------------------------------------------------------
-----------------%%%--------------------|----------------B--------------------------------------------------------------------------------------------
------------------||--------------------|----------------b---------------1------------------------------------------------SSS-------------------------
------------------||------%%%%--QQQQ----|--------------SS#CS%%%%%%----T-----------#-----------------------------------------------S------#----TT------
-------------%%%%%||-------|||-------K-B|--------------------||||-----T----TT-----#-------t---------------------------------------------##----TT------
--------------|||-||-------|||---------b|------------------K-||||-----T----TT-----##------t---------------*---TT-----------------------###----TT------
-M------------|||-||-------|||---------b|--------------------||||-----T---kTT-----##--gg--t---------gg----*---TT-----------------#----####----TT------
XXXXXXXXXXX---|||-||%%%----|||XXXXXXXXXX|----%%%%-XXXXXXXXXX-||||-----XXXXXXXXXX--XXXXXXXXXXXXXXXXXXXXXXXXXXX-XXXXXXXX--X----XXXXXXXXXXXXXXXXXXX--XXXX
XXXXXXXXXXX---|||-||||-----|||XXXXXXXXXX|-----||--XXXXXXXXXX-||||-----XXXXXXXXXX--XXXXXXXXXXXXXXXXXXXXXXXXXXX-XXXXXXXX--X----XXXXXXXXXXXXXXXXXXX--XXXX
