------------------------------------------------------------------------------------------------------------------------------------------------------
------------------------------------------------------------------------------------------------------------------------------------------------------
------------------------------------------------------------------------------------------------------------------------------------------------------
-----------------------oo-------------------------SSSSSSS---------------------------------------------------------------------------------------------
------------------------------------------------------------------------------------------------------------------------------------------------------
------------------------------------------------------------------------------------------------------------------------------------------------------
------------------Q---SSSS------------------------QQ----------------------SSCSS----USS------------------SSQSSS-----oo---------------------------------
----------------------------------------------------------------------------------------------------------------------------------oo------------------
-----------------------------------------------------------S-----------------------------------------------------------------SSS----------------------
-------------------------------------------------------------------------------------------o--------------K-------------------------------------------
------------------?-------%%%%---------T----------QQ--QQQ---------------QQQQ--QQ--#--------------TT-----SSSSSS-%%%%--%%%r------------------Q----------
--------------TT-----------|||---------T-----K---B--------------------------------#--------------TT-------------||----||%%%%%%------------------------
--------------TT-----------|||---------T---------b--------------------------------##-------------TT-------------||----|||||||----------------------F--
-M------------TT-----------|||--gg-----T---------B----------gg-------g------------##--gg---------TT-----------o-||----|||||||----------------------#--
XXXXXXXXXXXXXXXXXXXX%%%----|||XXXXXXXXXXXXXXXXXXXXXXXXXXX---XXXXXXXXXXXXXXXXXXXX--XXXXXXXXXXXXXXXXXXXXXXXXXXXX%-||----|||||||-----XXXXXXXXXXXXXXXXXXXX
XXXXXXXXXXXXXXXXXXXX||-----|||XXXXXXXXXXXXXXXXXXXXXXXXXXX---XXXXXXXXXXXXXXXXXXXX--XXXXXXXXXXXXXXXXXXXXXXXXXXXX--||----|||||||-----XXXXXXXXXXXXXXXXXXXX
