------------------------------------------------------------------------------------------------------------------------------------------------------
------------------------------------------------------------------------------------------------------------------------------------------------------
------------------------------------------------------------------------------------------------------------------------------------------------------
------------------------------------------------------------SSSSSSSSSS------------------------------SSSSSSSSSS----------------------------------------
------------------------------------------------------------SSSS--SSSS--------------------------------------------------------------------------------
------------------------------------------------------------SSSS--SSSS------------------oo------------------------------------------------------------
--------------------------------------------------------------SS---S------------oo----------------------------?SSS--------SSC-----SS------------------
--------------------------------------------------------------SS---S---------------------------------------------------------------------------y------
-----------------%%%------------------------------------------SS---S--o----------------------------------------------------------------------#SS--o---
------------------||-------------------------------------o--ooSS---SoU-----------SS-------------g-------------------------SSS---------------##--------
------------------||--------TT------------------------------SSSS---SSS-------------------S------TT---------TT-SSSSS---------------SS--------##--SC----
-------------%%%%%||--------TT---------T--------------------------------------#-----------------TT------#--TT---------------------K---#----B##--------
--------------|||-||--------TT---------T-------------------------------------##-----------------TT-----##--TT-------------------------#----b##---SSS--
-M------------|||-||----ggg-TT-------kkT------------k-------k--g-g------------------------------TT--kk-##--TT---K----------------#----#----B##--------
XXXXXXXXXXX---|||-||XXXXXXXXXXXXXXXXXXXXX-XX-XX-XX-XXXXXXXXXXXXXXXXXXXXXXXXXXXXX----------XXXXXXXXX-XXXXX--XX-XXXXXXXXXXX----XXXXXXXXXXXXXXXXX------XX
XXXXXXXXXXX---|||-||XXXXXXXXXXXXXXXXXXXXX-XX-XX-XX-XXXXXXXXXXXXXXXXXXXXXXXXXXXXX----------XXXXXXXXX-XXXXX--XX-XXXXXXXXXXX----XXXXXXXXXXXXXXXXX------XX
