------------------------------------------------------------------------------------------------------------------------------------------------------
------------------------------------------------------------------------------------------------------------------------------------------------------
------------------------------------------------------------------------------------------------------------------------------------------------------
S-----SSSSSSSSSSSSSS--------------------SSSSSSSSSS-oo--------------SSS--------------------------------------------------------------------------------
S-------------------------------------------------%%%%------------------------------------------------------------------------------------------------
S--------------------------------------------------||---------------------------------------oo--------------------------------------------------------
S----------------------------U-----------oooo------||-----------CSS--------g-------o--o---------------------------------------------------------------
S-------------------------------o----ooo-----------||--SSS-------------%%%%%%-----------------------------------------------------oo------------------
S----------------------------------------SSSS-U----||-------SS--2-------||||-----------------------%-------------------y------------------------------
S---------------------------------------oS--SoS----||----------2-2------||||-------SSSS--------------------------------XSS-?Q-------------------------
S---------------------------##--------%%SS--SSS----||-------------2-----||||--------------S---------------------------XX-------------------Q----------
S----------------------y-#####---------|-----------||-------------------||||--------------------------TT-------------XXX------------------------------
S-------------------y-######-----------|----------%||-------------------||||----%%%----------%%%%-----TT----TT------XXXX-------y-------------------F--
S--M----------------######-----%%%%%%%-|--kk-------||-------------------||||----||------------||------TT-k--TT-----XXXXX---SSSSS-------------------#--
XXXXXXXXXXX--XX--X--XXXX--------|||||--|XXXXXXXXXX-||----------XXXXXXX--||||----||------------||----XXXXXXXXXXXXXXXXXXXX-------XX-XXXXXXXXXXXXXXXXXXXX
XXXXXXXXXXX--XX--X--XXXX--------|||||--|XXXXXXXXXX-||----------XXXXXXX--||||----||------------||----XXXXXXXXXXXXXXXXXXXX-------XX-XXXXXXXXXXXXXXXXXXXX
