------------------------------------------------------------------------------------------------------------------------------------------------------
------------------------------------------------------------------------------------------------------------------------------------------------------
------------------------------------------------------------------------------------------------------------------------------------------------------
------------------------------SSSSSSSSSSSSSSSSSSSS------------------------------------------------------------SSSSSSSSSS------------------------------
------------------------------SSSSSSSSSSSSSSSSSS------------------------------------------------------------------------------------------------------
------------------------------SSSSSSSSSSSSSCSSSS------------------------------------------------------------------------------------------------------
---------------------LSSS-----SSSSSSSSSSSSSSSSSS------------------------SSSSS--------SSSS--------------------@----------SSS---------------------------
----------------------------------------------------------------------------------------------------------------------------------oo------------------
-----------------%%%-------------------------------------B-----------o--------------------------------------------------------------------------------
------------------||-----------------------ggg-----------b-------y------------------------------------------------------------------------------------
------------------||-2-----#--SSSSSSSSSSSSSSSSSS-------SS#CS-----##----------2--Q----------------tt-SU----!--!T----------------------------Q----------
-------------%%%%%||-------#--SSSSSSSSSSSSSSSSSS----------------###--------TT-------------T------tt-----------T---------------------------------------
--------------|||-||-------##-SSSSSSSSSSSSSSSSSS-----------K---####---t----TT--T----------T------tt-----------T----TT---------TT-------------------F--
-M------------|||-||--kk---##-SSSSSSSSSSSSSSSSSS--------------#####---t----TT--T-ggg------T------tt-------k---T--g-TT---------TT-------------------#--
XXXXXXXXXXX---|||-||XXXXXXXXXXXXXXXXXXXXXXXXXXXXXXXXXXXXXXXXXXXXXXX---XXXXXXXXXXXXXXX----XXXXXXXXXXXXXXXXXXXXXXXXXXXXXXX----XXXXXXXXXXXXXXXXXXXXXXXXXX
XXXXXXXXXXX---|||-||XXXXXXXXXXXXXXXXXXXXXXXXXXXXXXXXXXXXXXXXXXXXXXX---XXXXXXXXXXXXXXX----XXXXXXXXXXXXXXXXXXXXXXXXXXXXXXX----XXXXXXXXXXXXXXXXXXXXXXXXXX
