------------------------------------------------------------------------------------------------------------------------------------------------------
------------------------------------------------------------------------------------------------------------------------------------------------------
------------------------------------------------------------------------------------------------------------------------------------------------------
------------------------------SSSSSSSSSS------------------------------SSSSSSSSSSooo-------------------------------------------------------------U-----
------------------------------SSSSSSSSSS------------------------------------SSSS%%%-------------------------------------------------------------------
------------------------------SSSSSSSSSSooooo----------------------------g--SSSS-|--------------------------------------------------------------------
-----------------------------USSSSSSSSSS----------------------USSS------SS-------|--------------------------------------------------------------------
------------------------------------------------SS----------------------SS-------|------------------------TT--------------------------------------SS--
-----------------------------------------SSSS---------------------------SS-------|------------------------TT------------------------------------------
------------------------------------------------------------------------SC--g-g--|---%%%%-----------------TT----------------------------------SS------
-----SSS--------%%%%--------##SSSSSSSSSS--------------S------S-----TT---SS--SSSS-|----||--------TT-------SXXS---------r------------------------------#
-----------------||----y-#####SSSSSSSSSS----------TT---------------TT-----------%%%%%%||--------TT----------------%%%%%%-------------TT-------------##
-----------------||-y-######--SSSSSSSSSS----%%%%%-TT---------------TT------------||||-||--------TT--TT-------------|||||-------------TT------------###
-----------------||-######----SSSSSSSSSS-----|||--TT------k--ggg---TT------------||||-||----k---TT--TT-------------|||||-k----ggg----TT-----------####
XXXXXXXXXXX--%%%%||%XXXX------XXXXXXXXXX%%---|||--XXXXXXXXXXXXXXXXXXXXXXXXXXXXXX-||||-||%%XXXXXXXXXXXXXXXXXXXX-%%%-|||||XXXXXXXXXXXXXXXXXXXXXXXXX-XXXX
XXXXXXXXXXX---||-||-XXXX------XXXXXXXXXX|----|||--XXXXXXXXXXXXXXXXXXXXXXXXXXXXXX-||||-||-|XXXXXXXXXXXXXXXXXXXX--|--|||||XXXXXXXXXXXXXXXXXXXXXXXXX-XXXX
