------------------------------------------------------------------------------------------------------------------------------------------------------
------------------------------------------------------------------------------------------------------------------------------------------------------
------------------------------------------------------------------------------------------------------------------------------------------------------
S-----SSSS-----------------------------------------oo---------------------------------------------------------SS-------S------------------------------
S-------------------------------------------------%%%%------------------------------------------------------------------------------------------------
S--------------------------------------------------||-----------------------------------oo------------------------------------------------------------
S-------------------USS----------------------------||---------------------------oo-------------------------------------SSS----------------------------
S--------------------------------------------------||--SSS------------------------------------------------------------------------oo------------------
S--------------------------------------------------||--------------------------------------------------------------SSS--------------------------------
S--------------------------------------------------||-----------1--------1-------SSS---------------------------------------TT-------------------------
S-------------------------------QQQQ----------tt---||-----------------T------------------S-----------------------------S---TT--------------Q----------
S----------------K---B---------------K-B------tt---||-----------------T----TT----------------------------------##-------t--TT-------------------------
S-----------B--------b-------B---------b------tt--%||-----------------T----TT--------------------B--------*----##-------t--TT----------------------F--
S--M--------b--------B-------b---------b-g----tt---||-----------------T---kTT--------------------b--gg----*----##-------t--TT----------------------#--
XXXXXXXXXXXXXXXXXXXXXXXXXXXXXXXXXXXXXXXXXXXXXXXXXX-||-------XXXXXXXXX-XXXXXXXXXX----------XXXXXXXXXXXXXXXXXXX--XX------XXXXXXXXXXXXXXXXXXXXXXXXXXXXXXX
XXXXXXXXXXXXXXXXXXXXXXXXXXXXXXXXXXXXXXXXXXXXXXXXXX-||-------XXXXXXXXX-XXXXXXXXXX----------XXXXXXXXXXXXXXXXXXX--XX------XXXXXXXXXXXXXXXXXXXXXXXXXXXXXXX
