------------------------------------------------------------------------------------------------------------------------------------------------------
------------------------------------------------------------------------------------------------------------------------------------------------------
------------------------------------------------------------------------------------------------------------------------------------------------------
-----------------------oo-------oo--------------------------------------------------------------------------------------------------------------U-----
---------------------------------------g--------------------------------------------------------------------------------------------------------------
-----------------------------------%%%%%%%--------------------------------------------------oo--------------------------------------------------------
----------------------SSSS----------|||||--------------------------------------------SUS----------------SSQSSS----------SSS---------------------------
------------------------------------|||||----oo---------------------------------------------------------------------------------------------------SS--
------------------------------------|||||----------------------------------------------------------%-------------------y------------------------------
------------------------------%%%%%-|||||-----------------------1-----------------------------------------K------------X----------------------SS------
--------------------------%%%%-|||--|||||-------------S-----------------------------#####-SS------------SSSSSS--------XX-------------------#---------#
-----------------K---------|||-|||--|||||---------TT--------------------------------#--------------------------------XXX------------------##--------##
------------B--------------|||-|||--|||||---------TT-------------------------------K#--------%%%%-------------------XXXX------TT---------###-------###
-M----------b--------------|||-|||--|||||---------TT------k-----------gg------------#---------||-------------------XXXXX------TT-----y--####------####
XXXXXXXXXXXXXXXXXXXX%%%----|||-|||--|||||----%%%%-XXXXXXXXXXXXXXXXXXX-XXXXXXXXXXXXXXXXX-------||----XXXXXXXXXXXXXXXXXXXX----XXXXXXXXXXXXXXXXXXXXX-XXXX
XXXXXXXXXXXXXXXXXXXX||-----|||-|||--|||||-----||--XXXXXXXXXXXXXXXXXXX-XXXXXXXXXXXXXXXXX-------||----XXXXXXXXXXXXXXXXXXXX----XXXXXXXXXXXXXXXXXXXXX-XXXX
