------------------------------------------------------------------------------------------------------------------------------------------------------
------------------------------------------------------------------------------------------------------------------------------------------------------
------------------------------------------------------------------------------------------------------------------------------------------------------
S-----SSSS--------------------SSSSSSSSSS--------------------------------------------------------------------------------------------------------------
S----------------------------------------g------------------------------------------------------------------------------------------------------------
S---------------------------------------%%-------------oooo-------------------------------------------------------------------------------------------
S---------------------------------------|--------------%%%%-------SSoo----------------------------------------------------------------------SS--------
S---------------------------------------|----oo---------||------------------------------------------------------oooo--------------oo------------------
S--------------------------------------S|---------------||------------------------TT------------------------------------------------------------------
S--------------------------------------S|---------SSS---||------------------------TT------------------------------------------------------------------
S---------------%%%%SS-----------------S|---------------||--%%%%%%----------------TT--------------------------T----------------------------QSS--------
S----------------||--K---TT----#--------|-------------U-||---||||-----------------TT-----T------------------g-T-----------------------------------#-TT
S----------------||------TT----#-#------|---------------||---||||---------------T-TT-----T------------------TTT----------------------------------##-TT
S----------------||------TT----#-#------|---------------||---||||-----gg--------T-TT---k-T---------g--------TTT---y-------kkk-------------------###-TT
XXXXXXXXXXX--%%%%||%XXXXXXXXXXXXXXXXXXXX|----%%%%-----%%%%%--||||-----XXXXXXXXXXXXXXXXXXXX-XXXXXXXXX--XXXXXXXXXXXXXXXXXXXXXXXXXXXXXXXXXXXXXXXXXXXXX-XX
XXXXXXXXXXX---||-||-XXXXXXXXXXXXXXXXXXXX|-----||-------|||---||||-----XXXXXXXXXXXXXXXXXXXX-XXXXXXXXX--XXXXXXXXXXXXXXXXXXXXXXXXXXXXXXXXXXXXXXXXXXXXX-XX
