------------------------------------------------------------------------------------------------------------------------------------------------------
------------------------------------------------------------------------------------------------------------------------------------------------------
------------------------------------------------------------------------------------------------------------------------------------------------------
S-----SSSSSSSSSSSSSS------------------------------------------------------------------------------------------SSSSSSSSSS------------------------------
S-----------------------------------------------------------------------------------------------------------------------------------------------------
S---------------------ooor--------------ooooo------------------------R--------------------------------oo----------------------------------------------
S--------------------%%%%%----------------------------------------------------------y-----------------------------------SSS--------------##-SSS-------
S---------------------|||-----------------------SS--------------------------------#SSS------------oo-------------------------------------##-----------
S---------------------|||----------------SSSS-------------------------o----------##----------------------------------------------------####-----------
S---------------------|||-------------------------------------------------------###1---------------------------------------------------####------SSSSS
S---------@QQQQ-----%%%%%%%-----QQQQ-----------------------------%%%------------###---------------------------T----------------------######-----------
S-------------------||||||-----------K-B------------K-------------|-----------#-###--SSS--------#-------------T----------------------######-----------
S----------------g-#||||||--o----------b----%%%%%-----------------|----------##-###-------------#-----------ttT----TT---------TT-----######-SSS-------
S--M------------g#-#||||||-%%%---------b-----|||-----------g------|-------------###-------------#-----ggg---ttT--g-TT---------TT-----######--------r--
XXXXXXXXXXXXXXXXXXXX||||||--|-XXXXXXXXXX%%---|||--XXXXXXXXXX%%%%%-|---XXXXXXXXXXXXXXXX---XXXXXXXXXXXXXXXXXXXXXXXXXXXXXXX----XXXXXXXXXXXXXXXX-----XXXXX
XXXXXXXXXXXXXXXXXXXX||||||--|-XXXXXXXXXX|----|||--XXXXXXXXXX-|||--|---XXXXXXXXXXXXXXXX---XXXXXXXXXXXXXXXXXXXXXXXXXXXXXXX----XXXXXXXXXXXXXXXX-----XXXXX
