------------------------------------------------------------------------------------------------------------------------------------------------------
------------------------------------------------------------------------------------------------------------------------------------------------------
------------------------------------------------------------------------------------------------------------------------------------------------------
----------SSSSSSSSSS------------------------------------------------------------SSSSSSSSSS------------------------------------------------------------
-----------------------------------------------------------------------------------------------------------------------------------------------------o
-------------------------------------------------------oooo-------------------------------------------------------------------------------------------
-----------------------------U-------------------------%%%%-------------------------------SSS------%------------------US------------------------------
--------------------------------o----ooo----------SSSS--||------------------------------------------------TT------------------------------------SSS---
--------------------------------------------------------||------------------------------------------------TT-------------------------g#-----oo--------
--------------------------------------------------------||---------------1-------------S------------------TT--------E---------------g##---------------
----------------------------##--------%%----------------||------------T---------SU----------%%%----------SXXS------TT---------------###-----SS--------
-----------------------y-#####---------|-----K---B----U-||------------T----TT-------TT---t---|---------------------TT--t-----------####---------------
--------------------y-######-----------|---------b------||------------T----TT-------TT---t---|------TT-------------TT--t----------#####---------------
-M------------------######-----%%%%%%%-|---------B------||---y--------T---kTT------kTT--kt---|------TT----------g--TT--t--kkk-----#####---------------
XXXXXXXXXXX--XX--X--XXXX--------|||||--|XXXXXXXXXX----%%%%%-XXXXXXXXXXXXXXXXXXXXXXXXXXXXXX---|------XXXXXXXXXXXXXXXXXXXXXXXXXXXXXXXXXXX--XXX----------
XXXXXXXXXXX--XX--X--XXXX--------|||||--|XXXXXXXXXX-----|||--XXXXXXXXXXXXXXXXXXXXXXXXXXXXXX---|------XXXXXXXXXXXXXXXXXXXXXXXXXXXXXXXXXXX--XXX----------
