------------------------------------------------------------------------------------------------------------------------------------------------------
------------------------------------------------------------------------------------------------------------------------------------------------------
------------------------------------------------------------------------------------------------------------------------------------------------------
--------------------SSSSSSSSSS--------------------------------------------------SSSSSSSSSLSSSSSSSSSS--------------------------------------------------
--------------------SSSSSSSSSS------------------------------------------------------------------------------------------------------------------------
--------------------SSSSSSSSSS------------------------------------------------------------------------------------------------------------------------
--------------------SSSSSSSSSS--------------------Q---------------------------------oooooo-------------------R-----------SSS----S!-------##--QQQQ-----
-----------------------------------------------------------------------------------------------------r-----------------------------------##-----------
------------------------------------------------------------------------------------SSSSSS----------%%%%%%%----------------------------####-----------
-------------------------------------------------------------------------1----------SSSSSS----------||||||-----------------------------####----y------
-------------------%--SSSSSS?---------------------Q-------------------T-----------------------------||||||------!-----S----------S---######-Q?SSQQQ---
----------------------SSSSS-----------tt-----K---B--------------------T----TT-------------t---------||||||---------------------------######-----------
----------------------SSSSS-----------tt---------b--------------------T----TT-------------t---------||||||---------------------------######-----------
-M-----------%%%%----------ooo--------tt---------B---gg----kgg-------gT---kTT-------------t---------||||||--oo--------------gg-g-g---######-----------
XXXXXXXXXXX---||-----XXXXXXXXXXXXXXXXXXXXXXXXXXXXXXXXXXXXXXXXXXXXXXXXXXXXXXXXXXX---XXXXXXXXXXXXXXXXX||||||--%%XXXXXXXXXXXXXXXXXXXXXXXXXXXXXXXX--XXXXXX
XXXXXXXXXXX---||-----XXXXXXXXXXXXXXXXXXXXXXXXXXXXXXXXXXXXXXXXXXXXXXXXXXXXXXXXXXX---XXXXXXXXXXXXXXXXX||||||---|XXXXXXXXXXXXXXXXXXXXXXXXXXXXXXXX--XXXXXX
