------------------------------------------------------------------------------------------------------------------------------------------------------
------------------------------------------------------------------------------------------------------------------------------------------------------
------------------------------------------------------------------------------------------------------------------------------------------------------
--------------------------------------------------SSSSSSSSSSSSSSSSSSSS----------SSSSSSSSSL------------------------------SSSSSSSSSS--------------------
------------------------------------------------------SS--SSSSSS--SSSS--------------------------------------------------------------------------------
------------------------------------------------------SS--SSSSSS--SSSS--------------------------------------------------------------------------------
--------------------USS-----------------------------SS--------SS---S----------------oooooo-----------------------------------------SSSS------------SSS
----------------------------------------------------SS--------SS---S----------------------------------------------------------------------------------
-----------------%%%--------------------------------SS--------SS---S----------------SSSSSS------------------------------------------------------------
------------------||--------------------------------SS----ooooSS---SoU---1----------SSSSSS---------------------------------------------SSSS-----------
------------------||--------------------------------SSSS--SSSSSS---SSST-------------------------TT--------------!-----S---------------------------#---
-------------%%%%%||-B----------------tt--------------SS--------------T----TT-------------------TT------------------------SS----------------------#---
--------------|||-||-b-------B--------tt--------------SS--------------T----TT-------------------TT--------*---------------SS----------------------#---
--------------|||-||-B-------b--------tt----y-y-------------k--g-g----T---kTT---------------k---TT--gg----*---------------SS-----------------ggg--#---
XXXXXXXXXXX---|||-||XXXXXXXXXXXXXXXXXXXXXXXXXXXXXXXXXXXXXXXXXXXXXXXXXXXXXXXXXXXX---XXXXXXXXXXXXXXXXXXXXXXXXXX-XXXXXXXXXX--XX--XXXX---------XXXXXXXXXXX
XXXXXXXXXXX---|||-||XXXXXXXXXXXXXXXXXXXXXXXXXXXXXXXXXXXXXXXXXXXXXXXXXXXXXXXXXXXX---XXXXXXXXXXXXXXXXXXXXXXXXXX-XXXXXXXXXX--XX--XXXX---------XXXXXXXXXXX
