------------------------------------------------------------------------------------------------------------------------------------------------------
------------------------------------------------------------------------------------------------------------------------------------------------------
------------------------------------------------------------------------------------------------------------------------------------------------------
-----------------------oo-----------------------------------------------------------------------------------------------------------------------------
-------------------------------------------------------------------------o----------------------------------------------------------------------------
----------------------------------------ooooo---------------------------%%%---------------------------------------------------------------------------
----------------------SSSS-----------------------------------------------|--o--------------------------------------oo---SSS---------------------------
------------------------------------------------SS-----------------------|--SSSS--------------------oo------------------------------------------------
-----------------g-----------------------SSSS------------TT-----------%--|--------TT------------------------------------------------------------------
-----------------#---------------------------------TT----TT--------------|--------TT------------g-----------------------------------------------------
----------S-----##--------%%%%-TT------------------TT----XX----------#---|--------TT------------TT-----------T-%%%%--%%%------------------------------
---------------###---------|||-TT------------------TT---------------##---|--------TT-----T------TT-----------T--||----||------------------------------
--------------####---------|||-TT-----------%%%%%--TT-------TT-----###---|-----%T-TT-----T------TT-----------T--||----||------TT-------------------F--
---M---------#####---------|||gTT------------|||---TT-------TT----####---|------T-TT---k-T------TT--------y--To-||----||------TT--k----------------#--
XXXXXXXXXXXXXXXXXXXX%%%----|||XXXXXXXX--%%---|||--XXXXXXXXXXXXXXXXXXXX%%%%%%----XXXXXXXXXXXXXXXXXXX-XXXXXXXXXX%-||----||----XXXXXXXX---XXXXXXXXXXXXXXX
XXXXXXXXXXXXXXXXXXXX||-----|||XXXXXXXX--|----|||--XXXXXXXXXXXXXXXXXXXX|||||-----XXXXXXXXXXXXXXXXXXX-XXXXXXXXXX--||----||----XXXXXXXX---XXXXXXXXXXXXXXX
