------------------------------------------------------------------------------------------------------------------------------------------------------
------------------------------------------------------------------------------------------------------------------------------------------------------
------------------------------------------------------------------------------------------------------------------------------------------------------
--------------------SSSSSSSSSS------------------------------------------------------------------------------------------SSS-----SS--------------------
--------------------------------------------------?---------------------------------------------------------------------------------------------------
----------------------------------------------------------------------------------------------------oo------------------------------------------------
------------------Q--------------------------------------------------------1---------SUS------------%%%-----------------US----------------------------
--------------------------------o----ooo----------SS------------------------------------------------||--o----R--------------------oo------------------
----------------------------------------------------------------------------------------------------||-%%%------------------SSS-----------------------
-----------------------------C---------------------------------------------ggg--------------------oo||--|---------------------------------------------
--------SU--------?----#-#------------%%-----------------------------##########-----#####-----------||--|-------------r-SSS----------------Q----------
--------------TT-----#-#-#-#-----------|---------------SSS----------##--------#-----#----------TT---||-o|---------%%%%%%------------------------------
--------------TT-----#-#-#-#-----------|--------------------TT-----###--------#----K#----------TT---||%%%%%--------|||||---------------------------F--
--M-----------TT-----#-#-#-#-E-%%%%%%%-|-------ggg----------TT----####--------#-----#-------y--TT---||-|||---------|||||---------------------------#--
XXXXXXXXXXXXXXXXXXXXXXXXXXXXXX--|||||--|-XXXXXXXXX----------XXXXXXXXXX--------X-XXXXXXX---XXXXXXXXXX||-|||-----%%%-|||||XXX------XXXXXXXXXXXXXXXXXXXXX
XXXXXXXXXXXXXXXXXXXXXXXXXXXXXX--|||||--|-XXXXXXXXX----------XXXXXXXXXX--------X-XXXXXXX---XXXXXXXXXX||-|||------|--|||||XXX------XXXXXXXXXXXXXXXXXXXXX
