------------------------------------------------------------------------------------------------------------------------------------------------------
------------------------------------------------------------------------------------------------------------------------------------------------------
------------------------------------------------------------------------------------------------------------------------------------------------------
------------------------------------------------------------SSSSSSSSSS----------------------------------------SSSSSSSSSS------------------------------
-----------------------------------------g------------------SSSS--SSSS--------------------------------------------------------------------------------
----------------------ooor--------------%%------------------SSSS--SSSS--------------------------------------------------------------------------------
---------------------%%%%%--------------|---------Q-----------SS---S-------g-------USS--------------------2-----------------------SS--------SS--------
----------------------|||---------------|----oo---------------SS---S---%%%%%%---------------------oo--------------------------------------------------
----------------------|||---------------|---------------------SS---S----||||--------------------------------------------------------------------------
----------------------|||---------------|-------------------ooSS---SoU--||||------------------------o-------------------SS-?Q-------------------------
-------------------%%%%%%%%-------------|---------Q---------SSSS---SSS--||||------#-----------------------2---T-------------------SS--------SS--------
--------------------||||||-------------T|-------------------------------||||------#-------------#-------------T-------------------K---#----B------#-TT
--------------------||||||--o----------T|-------------------------------||||------##------------#-------------T----TT----------y------#----b-----##-TT
---M---------%%%%---||||||-%%%-------kkT|------------gg----kk--g-g------||||------##--gg--------#-------y--y--T--g-TT------SSSSS------#----B----###-TT
XXXXXXXXXXX---||----||||||--|-XXXXXXXXXX|----%%%%-XXXXXXXXXXXXXXXXXXXX--||||------XXXXXXXXXXXXXXXXXXXXXXXXXXXXXXXXXXXXXX-------XX-XXXXXXXXXXXXXXXXX-XX
XXXXXXXXXXX---||----||||||--|-XXXXXXXXXX|-----||--XXXXXXXXXXXXXXXXXXXX--||||------XXXXXXXXXXXXXXXXXXXXXXXXXXXXXXXXXXXXXX-------XX-XXXXXXXXXXXXXXXXX-XX
