------------------------------------------------------------------------------------------------------------------------------------------------------
------------------------------------------------------------------------------------------------------------------------------------------------------
------------------------------------------------------------------------------------------------------------------------------------------------------
------------------------------------------------------------SSSSSSSSSS--------------------------------------------------------------------------------
------------------------------------------------------------SSSS--SSSS--------------------------------------------------------------------------------
------------------------------------------------------------SSSS--SSSS----------------------oo--------------------------------------------------------
--------------------------------------------------------------SS---S----SSSSS--------------------------------R------------oo---%%%--------------------
--------------------------------------------------------------SS---S---------------------------------r--------------------SS----||oo------------------
---------------------------------------------------------TT---SS---S-------------------------------%%%%%%%%---------------------||--------------------
---------------------------------------------------TT----TT-ooSS---SoU------------o-----------------||||||----------------------||--------------------
----------Q-----------------TT---------T------tt---TT----XX-SSSS---SSS-------2---------TT-S---------||||||-------------------SS-||---------Q--#LSS----
----------------------------TT---------T------tt---TT----------------------TT----------TT-----------||||||----------------------||------------#-------
----------------------------TT---------T------tt---TT-----------------t----TT--T-------TT----%%%%---||||||---------B------------||------------#-------
-------------------#----ggg-TT--gg-----T-g----tt---TT-------k--g-g----t----TT--T-------TT-----||----||||||--oo-----b------------||----------kk#-------
XXXXXXXXXXXXX--XXXXXXXXXXXXXXXXXXXXXXXXXXXXXXXXXXXXXXXXXXXXXXXXXXXXXXXXXXXXXXXXXXXXXXXXXXX----||----||||||--%%XXXXXXXXXX%%-----%%%XXXXXXXXXXXXXXXXX---
XXXXXXXXXXXXX--XXXXXXXXXXXXXXXXXXXXXXXXXXXXXXXXXXXXXXXXXXXXXXXXXXXXXXXXXXXXXXXXXXXXXXXXXXX----||----||||||---|XXXXXXXXXX|-------||XXXXXXXXXXXXXXXXX---
