------------------------------------------------------------------------------------------------------------------------------------------------------
------------------------------------------------------------------------------------------------------------------------------------------------------
------------------------------------------------------------------------------------------------------------------------------------------------------
-----------------------oo-------------------------------------------------------------------------------------SSSSSSSSSS------------------------------
------------------------------------------------------------------------------------------------------------------------------------------------------
------------------------------------------------------------------------------------------------------------------------------------------------------
----------------------SSSS------------------------------------------------SS--------------------------------------------SS-------------------QQQQ-----
----------------------------------------------------------------------------------------------------oo------------------------------------------------
----------------------------------------------------------------------------------TT------------------------------------------------------------------
---------------------------------------------------------o------------------------TT---------------------------------------TT------------------y------
----------Q---------------%%%%---------------------------------------TSS-----SS---TT------------TT-----------TT------------TT---------------Q?SSQQQ---
---------------------------|||--------K------------------------------T------------TT-----T------TT-----------TT---------t--TT-------------------------
---------------------------|||TTTT-----------------------------------T----------T-TT-----T------TT-----------TT----TT---t--TT-------------------------
-M-----------------#-------|||TTTT----------y-y-----k---------ggg----T----------T-TT---k-T--k---TT--------y--TT--g-TT---t--TT-------------------------
XXXXXXXXXXXXX--XXXXX%%%----|||XXXXXXXXXXXXXXXXXXXX-XXXXXXXXXXXXXXXXXXX----------XXXXXXXXXXXXXXXXXXXXXXXXXXXXXXXXXXXXXXXXXXXXXXXXXXXXXXXXXXXXXX--XXXXXX
XXXXXXXXXXXXX--XXXXX||-----|||XXXXXXXXXXXXXXXXXXXX-XXXXXXXXXXXXXXXXXXX----------XXXXXXXXXXXXXXXXXXXXXXXXXXXXXXXXXXXXXXXXXXXXXXXXXXXXXXXXXXXXXX--XXXXXX
