------------------------------------------------------------------------------------------------------------------------------------------------------
------------------------------------------------------------------------------------------------------------------------------------------------------
------------------------------------------------------------------------------------------------------------------------------------------------------
----------SSSSSSSSSSSSSSSSSSSS------------------------------------------------------------------------------------------------------------------------
--------------------SSSSSSSSSS--------------?---------------------------------------------------------------------------------------------------------
--------------------SSSSSSSSSS--------------------------------g-------------------------oo------------------------------------------------------------
--------------------SSSSSSSSSS--------------------------------SSSSS---------SSSSoo---------SSS!------------------------------------------##-----------
----------------------------------------------r------------------------------------------------------------------SSS---------------------##-----------
------------------------------------------%%%%%%---------------------------------------------------------------------------------------####-----------
-------------------------------------------||||------------------------------K---SS--------------------------------------------SSS-----####-----------
----------@QQQQ-------SSSSSS?--TT-------%%-||||ooo----S--------------------SSSSS---------S----C-------------------------%------------######-----------
----------------------SSSSS----TT-------|--||||--rTT------------------T-------------------------------------g------------------------######-----------
-----------------g-#--SSSSS----TT-------|%%%%%%%%%TT----------TT-----tT-------------------------------------TT-----------------------######--------F--
-M--------------g#-#-------ooogTT-------|-||||||||TT------k---TT-----tT------------------------g-g----------TT-------------------r---######--------#--
XXXXXXXXXXXXXXXXXXXX-XXXXXXXXXXXXXXXXX--|-||||||||XXXXXXXXXXXXXXXXXXXXXXXXXXXXXX----------XXXXXXXXXX--XXXXXXXX%%%%----%%----XXXXXXXXXXXXXXXXXXXXXXXXXX
XXXXXXXXXXXXXXXXXXXX-XXXXXXXXXXXXXXXXX--|-||||||||XXXXXXXXXXXXXXXXXXXXXXXXXXXXXX----------XXXXXXXXXX--XXXXXXXX|||------|----XXXXXXXXXXXXXXXXXXXXXXXXXX
