------------------------------------------------------------------------------------------------------------------------------------------------------
------------------------------------------------------------------------------------------------------------------------------------------------------
------------------------------------------------------------------------------------------------------------------------------------------------------
----------SSSSSSSSSS--------------------SSSSSSSSSSSSSSSSS---------------------------------------------------------------SSS-----SS--------------------
------------------------------------------------------------------------------------------------------------------------------------------------------
----------------------------------------------------------------------------------------oo------------oo----------------------------------------------
-----------------------------------------oooo-----QQ----------USSS--------------oo----------------------------?SSS------US----------------------------
------------------------------------------------------------------------------------------------------------------------------------------------------
-----------------------------------------SSSS-U------------S----------------------------------------------------------------SSS-----------------------
----------------------------------------oS--SoS--------------------------1-------SS-------------------------------------------------------------------
---------Q----------SS------------------SS--SSS---QQ--QQQ----S-----TT-T------------------S--------------------SSSSS-----SSS----------------#----------
---------------------K---TT-----------tt---------------------------TT-T----TT-------------------------------------------------------------##----------
-------------------------TT-----------tt---------------------------TT-T----TT-------------------------------tt---------------------------###-------F--
-------------------------TT-----------tt--kk-----------------ggg---TT-T---kTT----------------------g--ggg---tt--K--------------------y--####-------#--
XXXXXXXXXXX--XX--X--XXXXXXXXXXXXXXXXXXXXXXXXXXXXXXXXXXXXX---XXXXXXXXXXXXXXXXXXXX-----------XXXXXXXXXXXXXXXXXXXXXXXXXXXXXXXX------XXXXXXXXXXXXXXXXXXXXX
XXXXXXXXXXX--XX--X--XXXXXXXXXXXXXXXXXXXXXXXXXXXXXXXXXXXXX---XXXXXXXXXXXXXXXXXXXX-----------XXXXXXXXXXXXXXXXXXXXXXXXXXXXXXXX------XXXXXXXXXXXXXXXXXXXXX
