------------------------------------------------------------------------------------------------------------------------------------------------------
------------------------------------------------------------------------------------------------------------------------------------------------------
------------------------------------------------------------------------------------------------------------------------------------------------------
--------------------------------------------------------------------------------ooo-------SSSSSSSSSS--------------------------------------------------
--------------------------------------------------------------------------------%%%-------------------------------------------------------------------
-----------------------SSS-------------------------------------------------------|--------------------------------------------------------------------
---------------------------------------------------------------------------------|----------------------SSQSSS-------------------------US-------------
---------------------g-----------------------------------------------------------|--------------------------------------------------------------------
--------------------%%%--------------------------------------------------------g-|--------------------------------------------------------------------
------------Q--?----||----SSS----------------------------------------------------|---%%%%-----------------K--------------------------SS---------------
-------------------S||-------------------TT---SU---------tt------------------S@S-|----||----------------SSSSSS--!-----S--------------------S----------
--------------------||-----------------T-TT--------------tt---------------------%%%%%%||--t--------------------------------------------------------#--
--------------------||-----------------T-TT--------------tt----------------------||||-||--t---------------------------------------TT-----------K---#--
-M----------------K-||----oo---------kkT-TT------k---g-g-tt--y-------------------||||-||--t-------------------------------kkk-----TT---------------#--
XXXXXXXXXXXXXXXXXXXX||---%%%--XXXXXXXXXXXXXXXXXXXXXXXXXXXXXXXXXXXXXXXX-XXXXXXXXX-||||-||%%XXXXXXXXXXXXXXXXXXXXXXXXXXXXXXXXXXXXXXXXXXXXXX-X-XXXXXX--XXX
XXXXXXXXXXXXXXXXXXXX||----|---XXXXXXXXXXXXXXXXXXXXXXXXXXXXXXXXXXXXXXXX-XXXXXXXXX-||||-||-|XXXXXXXXXXXXXXXXXXXXXXXXXXXXXXXXXXXXXXXXXXXXXX-X-XXXXXX--XXX
