------------------------------------------------------------------------------------------------------------------------------------------------------
------------------------------------------------------------------------------------------------------------------------------------------------------
------------------------------------------------------------------------------------------------------------------------------------------------------
------------------------------SSSSSSSSSS-----------oo-------------------------------------------------------------------------------------------------
--------------------------------------------------%%%%------------------------------------------------------------------------------------------------
----------------------ooor-------------------------||----------------R--------------------------------oo----------------------------------------------
---------------------%%%%%-------------------------||--------------------------------SUS------------------------------------------%-------------------
----------------------|||--------------------------||--SSS--------------------------------------------------------------------------------------------
----------------------|||--------------S-----------||-------------------------------------------------------------------------SSS-------SSS-----------
----------------------|||--------------S-----------||--------------------1-----------------o----------------------------------------------------------
-----SSS------------%%%%%%%------------S-----------||------------%%%--T-------------#####--------TT-------------!-----S-%---------%%%%%-------#LSS----
-----------------K--||||||-----#-------------------||-------------|---T----TT-------#------------TT--------------------------------|||--------#-------
------------B-------||||||--o--#-#----------------%||-------------|---T----TT------K#------------TT---------tt---------------------|||--------#-------
------------b-------||||||-%%%-#-#-------------ggg-||-------------|---T---kTT-------#------------TT---ggg---tt-------------------r-|||------kk#-------
XXXXXXXXXXXXXXXXXXXX||||||--|-XXXXXXXXXX-XXXXXXXXX-||-------%%%%%-|---XXXXXXXXXXXXXXXXX---XXXXXXXXXXXXXXXXXXXXXXXXXXXXXX----XXXXXX%|||------XXXXXXX---
XXXXXXXXXXXXXXXXXXXX||||||--|-XXXXXXXXXX-XXXXXXXXX-||--------|||--|---XXXXXXXXXXXXXXXXX---XXXXXXXXXXXXXXXXXXXXXXXXXXXXXX----XXXXXX-|||------XXXXXXX---
