------------------------------------------------------------------------------------------------------------------------------------------------------
------------------------------------------------------------------------------------------------------------------------------------------------------
------------------------------------------------------------------------------------------------------------------------------------------------------
------------------------------SSSSSSSSSS--------------------------------------------------------------------------------SSS-----SS--------------------
-----------------------------------------------------------------------------------------------------------------------------------------------------o
-------------------------------------------------------oooo---g-------------------------oo-------------------------k----------------------------------
-------------------------------------------------------%%%%---SSSSS-------SSCSS-oo------------------------2---S---SSSSSSUS----------------------------
--------------------------------------------------SSSS--||--------------------------------------------------------------------------------------SSS---
-----------------g---------------------S----------------||------------------------------------------------------------------SSS-------------oo--------
-----------------#---------------------S----------------||-----------------------SSS----------------o-------------------------------------------------
---------QS-----##--SS-----------------S------tt--------||--------------QQQQ--QQ---------S-------tt-------2-------------SSS-----------------SS--------
---------------###---K---TT----#--------------tt------U-||--------------------------------T------tt---------------------------------------------------
--------------####-------TT----#-#------------tt--------||----TT-----t--------------------T------tt-----------TT--------------------------------------
-------------#####-------TT----#-#-------g----tt--------||----TT-----t--------------------T------tt-----y--y--TT--------------------------------------
XXXXXXXXXXXXXXXXXXXXXXXXXXXXXXXXXXXXXXXXXXXXXXXXXX----%%%%%-XXXXXXXXXXXXXXXXXXXX----------XXXXXXXXXXXXXXXXXXXXXXXXXXXX--XXX------XXXXXXXXXXX----------
XXXXXXXXXXXXXXXXXXXXXXXXXXXXXXXXXXXXXXXXXXXXXXXXXX-----|||--XXXXXXXXXXXXXXXXXXXX----------XXXXXXXXXXXXXXXXXXXXXXXXXXXX--XXX------XXXXXXXXXXX----------
