------------------------------------------------------------------------------------------------------------------------------------------------------
------------------------------------------------------------------------------------------------------------------------------------------------------
------------------------------------------------------------------------------------------------------------------------------------------------------
----------------------------------------SSSSSSSSSS----------------------------------------------------------------------------------------------------
------------------------------------------------------------------------------------------------------------------------------------------------------
-------------------------------------------------------oooo----------R----------K-----------oo--------oo----------------------------------------k-----
--------------------S--------------------oooo----------%%%%---------------SS----SS----1----------------------------oo----SSS----S!-------------SQS--SQ
---------------------------TT---------------------SSSS--||--------------------------------------------------------------------------------------------
---------------------------TT------------SSSS-U---------||-----------------------------------------%--------------------------------------------------
---------------------------XX-----------oS--SoS---------||--------------------------------------------------------------------------------------------
-------------------%---TT---------------SS--SSS---------||-------%%%--SS-----SS-SS--------SS-------------------%%%%--%%%---------S-------------SQS--S?
-----------------------TT-------------K---------------U-||--------|-------------------TT------------------------||----||------------------------------
-----------------------TT-----TTTT----------------------||--------|-------------------TT-----%%%%-----------tt--||----||------------------------------
-M-----------%%%%---k--TT-----TTTT--------kk------------||--------|-------------------TT------||------ggg---tto-||----||----gg-g-g-----------k------gg
XXXXXXXXXXX---||----XXXXXXXXXXXXXXXXXXXXXXXXXXXXXX----%%%%%-%%%%%-|-------------XXXXXXXXXX----||----XXXXXXXXXX%-||----||XXXXXXXXXXXXXXXXXXXXXXXXXXXXXX
XXXXXXXXXXX---||----XXXXXXXXXXXXXXXXXXXXXXXXXXXXXX-----|||---|||--|-------------XXXXXXXXXX----||----XXXXXXXXXX--||----||XXXXXXXXXXXXXXXXXXXXXXXXXXXXXX
