------------------------------------------------------------------------------------------------------------------------------------------------------
------------------------------------------------------------------------------------------------------------------------------------------------------
------------------------------------------------------------------------------------------------------------------------------------------------------
---------------------------------------------------oo-------------------------------------SSSSSSSSSS--------------------------------------------------
--------------------------------------------------%%%%------------------------------------------------------------------------------------------------
----------------------------------------%%---------||-------------------------------------------------------------------------------------------------
---------------------LSSS---------------|----------||---------------------SS---------SSSS--------------------------oo----------SSS%-------------------
--------------------------------o----ooo|----oo----||--SSS------------------------------------------------TT------------------------------------------
----------------------------------------|----------||-----------------------------------------------------TT----------------------------SSS-----------
----------------------------------------|----------||-----------------------------------------------------TT--------------------K---------------------
---------QQ----------2-----#----------%%|----------||-----------------SS-----SS-Q------------------------SXXS--%%%%--%%%-------SSS%%%%%---------------
---------------------------#-----------||----------||-----------------------------------------------------------||----||-----------|||----------------
---------------------------##----------||---------%||-----------------------------------------------TT----------||----||-TT--------|||-------------F--
-------------------#--kk---##--%%%%%%%-||----------||-------gg-------g-----------ggg------------g-g-TT--------o-||----||-TT--------|||-------------#--
XXXXXXXXXXXXX--XXXXXXXXXXXXXXX--|||||--||----%%%%--||-------XXXXXXXXXX----------XXXXX----XXXXXXXXXXXXXXXXXXXXX%-||----||XXXXXXXXXX%|||------XXXXXXXXXX
XXXXXXXXXXXXX--XXXXXXXXXXXXXXX--|||||--||-----||---||-------XXXXXXXXXX----------XXXXX----XXXXXXXXXXXXXXXXXXXXX--||----||XXXXXXXXXX-|||------XXXXXXXXXX
