------------------------------------------------------------------------------------------------------------------------------------------------------
------------------------------------------------------------------------------------------------------------------------------------------------------
------------------------------------------------------------------------------------------------------------------------------------------------------
--------------------SSSSSSSSSSSSSSSSSSSS----------------------------------------------------------------------SS-------S------------------------------
------------------------------------------------------------------------------------------------------------------------------------------------------
----------------------------------------%%-------------oooo----------R------------g-------------------------------------------------------------------
----------------------------------------|--------------%%%%---------------------SSSSSSSS---------------------R---------S--SSC----------US----------SSS
----------------------------------------|----oo---------||-----------------------------------------------r--------------------------------------------
---------------------------------------S|---------------||------------------------------------------%%%%%%%--------SSS--------------------------------
-----------------------------C---------S|---------SSS---||----------------------------------------oo||||||----------------SSS--------SS---------------
---------Q------!------#-#-------------S|---------------||-------%%%--------------------------------||||||-------------S-------------------S------#---
---------------------#-#-#-#---#--------|-------------U-||--------|----------------------------TT---||||||-----##---------------------------------#---
---------------------#-#-#-#---#-#------|---------------||--------|----------------------------TT---||||||-----##-----------------TT--------------#---
-M-------------------#-#-#-#-E-#-#------|---------------||--------|---gg--------------------y--TT---||||||--oo-##----------------#TT---------ggg--#---
XXXXXXXXXXXXXXXXXXXXXXXXXXXXXXXXXXXXXXXX|----%%%%-----%%%%%-%%%%%-|---XXXXXXXXXXXXXXXX---XXXXXXXXXXX||||||--%%-XX------XX----XXXXXXXXXXX-X-XXXXXXXXXXX
XXXXXXXXXXXXXXXXXXXXXXXXXXXXXXXXXXXXXXXX|-----||-------|||---|||--|---XXXXXXXXXXXXXXXX---XXXXXXXXXXX||||||---|-XX------XX----XXXXXXXXXXX-X-XXXXXXXXXXX
