------------------------------------------------------------------------------------------------------------------------------------------------------
------------------------------------------------------------------------------------------------------------------------------------------------------
------------------------------------------------------------------------------------------------------------------------------------------------------
--------------------------------oo----------------------------------------------SSSSSSSSSS------------------------------------------------------------
---------------------------------------g--------------------------------------------------------------------------------------------------------------
-----------------------SSS---------%%%%%--------------------------------------------------------------------------------------------------------k-----
------------------------------------||||--------------------------SSoo--------------------SSS------%----SSQSSS-----------------SSS-------------SQS--SQ
---------------------g--------------||||--------------------------------------------------------------------------------------------------------------
--------------------%%%-------------||||---------------------------------------g----------------------------------------------------------------------
--------------------||----SSS-%%%%%-||||-----------------------------------------------S------------------K---------------------K---------------------
--------------------||---------|||--||||--------------S-----%%%%%%-----------S@SSU----------%%%---------SSSSSS-----------------SSS---------#---SQS--S?
--------------------||---------|||--||||----------TT---------||||-------------------TT---t---|--------------------------------------------##----------
--------------------||---------|||--||||----------TT---------||||-------------------TT---t---|---------------------------TT--------------###----------
-M------------k-ggg-||----oo---|||--||||-------y--TT------k--||||------------------kTT--kt---|-----------------k----kkk--TT----------y--####-k------gg
XXXXXXXXXXXXXXXXXXXX||---%%%---|||--||||XXXXXXXXXXXXXXXXXXXX-||||------XXXXXXXXXXXXXXXXXXX---|------XXXXXXXXXXXXXXXXXXXXXXXXXXXXXXXXXXXXXXXXXXXXXXXXXX
XXXXXXXXXXXXXXXXXXXX||----|----|||--||||XXXXXXXXXXXXXXXXXXXX-||||------XXXXXXXXXXXXXXXXXXX---|------XXXXXXXXXXXXXXXXXXXXXXXXXXXXXXXXXXXXXXXXXXXXXXXXXX
