------------------------------------------------------------------------------------------------------------------------------------------------------
------------------------------------------------------------------------------------------------------------------------------------------------------
------------------------------------------------------------------------------------------------------------------------------------------------------
------------------------------SSSSSSSSSS----------------------------------------ooo-----------------------------------------------SSSSSSSSSS----------
------------------------------SSSSSSSSSS----------------------------------------%%%-------------------------------------------------------------------
------------------------------SSSSSSSSSS-----------------------------R-----------|--------------------------------------------------------------------
------------------------------SSSSSSSSSS------QQQQ------------------------SS-----|---------------------------R-----oo----------SSS--------------------
---------------------------------------------------------------------------------|-----------------------r--------------------------------------------
---------------------------------------------------------------------------------|------------------%%%%%%%-------------------------------------------
------------------------------------------------k--------o-----------------------|---%%%%------oooo-||||||----------------------K---------------------
-------------------%----------SSSSSSSSSST-----?QQQ---------------%%%--SS-----SS--|----||------------||||||-----%%%%--%%%-------SSS--------------------
------------------------------SSSSSSSSSST-------------------------|-------------%%%%%%||------------||||||------||----||------------------TT----------
------------------------------SSSSSSSSSST-------------------------|--------------||||-||------------||||||------||----||-TT--------tt-----TT-------F--
-M-----------%%%%--------ggg--SSSSSSSSSST-----------k-------------|--------------||||-||------------||||||--ooo-||----||-TT--------tt----kTT-------#--
XXXXXXXXXXX---||----XXXXXXXXXXXXXXXXXXXXXXXXXXXXXX-XXXXXXXXX%%%%%-|--------------||||-||%%%%%%%%%-%%||||||--%%%-||----||XXXXXXXXXXXXXXXXXXXXXXXXXXXXXX
XXXXXXXXXXX---||----XXXXXXXXXXXXXXXXXXXXXXXXXXXXXX-XXXXXXXXX-|||--|--------------||||-||-|||||||---|||||||---|--||----||XXXXXXXXXXXXXXXXXXXXXXXXXXXXXX
