------------------------------------------------------------------------------------------------------------------------------------------------------
------------------------------------------------------------------------------------------------------------------------------------------------------
------------------------------------------------------------------------------------------------------------------------------------------------------
------------------------------SSSSSSSSSS--------------------------------------------------------------------------------SSSSSSSSSS--------------------
------------------------------SSSSSSSSSS--------------------------------------------------------------------------------------------------------------
----------------------ooor----SSSSSSSSSS----------------------------------------------------oo--------------------------------------------------------
---------------------%%%%%----SSSSSSSSSS------------------------------------SSSS---o--o------------------------------------------------US-------------
----------------------|||------------------------------------o---o---o--------------------------------------------------------------------------------
----------------------|||-----------------------------------%%%-%%%-%%-----------------------------%--------------------------------------------------
----------------------|||------------------------------------|---|---|-------K-----SSSS----------------------------------------------SS---------------
----------------!---%%%%%%%---SSSSSSSSSS-----------------tt--|---|---|-----SSSSS----------SS--------------------------r--------------------S--#LSS----
--------------------||||||----SSSSSSSSSS-----K---B-------tt--|---|---|T-------------------------------------g-----%%%%%%--SS------------------#-------
--------------------||||||--o-SSSSSSSSSS---------b-------tt--|---|---|T---------%%%----------%%%%-----------TT-----|||||--SS------TT----------#-------
-M------------------||||||-%%%SSSSSSSSSS---------B---g-g-tt--|---|-r-|T---------||------------||------------TT-----|||||--SS------TT--------kk#-------
XXXXXXXXXXXXXXXXXXXX||||||--|-XXXXXXXXXXXXXXXXXXXXXXXXXXXXXX%%%%%%%%%%XXXXXXXXXX||------------||------XXXXXXXX-%%%-|||||--XX--XXXXXXXXXX-X-XXXXXXXX---
XXXXXXXXXXXXXXXXXXXX||||||--|-XXXXXXXXXXXXXXXXXXXXXXXXXXXXXX-|||||||||XXXXXXXXXX||------------||------XXXXXXXX--|--|||||--XX--XXXXXXXXXX-X-XXXXXXXX---
