------------------------------------------------------------------------------------------------------------------------------------------------------
------------------------------------------------------------------------------------------------------------------------------------------------------
------------------------------------------------------------------------------------------------------------------------------------------------------
S-----SSSS--------------------SSSSSSSSSSSSSSSSSSSS----------SSSSSSSSSS--------------------SSSSSSSSSS--------------------------------------------------
S-----------------------------SSSSSSSSSS--------------------SSSS--SSSS---o----------------------------------------------------------------------------
S-----------------------------SSSSSSSSSS--------------------SSSS--SSSS--%%%---------------------------------------------------------------------------
S-----------------SCUSS-------SSSSSSSSSS-oooo-----------------SS---S-----|--o-------y-------------------------?SSS-----------------SSSS---------------
S-------------------------------------------------------------SS---S-----|--SSSS--#SSS----------------------------------------------------------------
S----------------------------------------SSSS-U----------B----SS---S--%--|-------##------------------------------------------SSS----------------------
S---------------------------------------oS--SoS----------b--ooSS---SoU---|------###1---------------------------------------------------SSSS-----------
S-------------TT---2----------SSSSSSSSSSSS--SSS--------SS#CSSSSS---SSS---|------###---------------------------SSSSS-----r-----------------------------
S-------------TT-----B--------SSSSSSSSSS---------------------------------|------###--SSS--------------------g-----------%%%%%%------------------------
S-------------TT-----b-------BSSSSSSSSSS-------------------K-------------|-----%###-------------------------TT----------|||||----------------------F--
S-------------TT-----B-------bSSSSSSSSSS--kk----------------k--g-g-------|------###-------------g-g---------TT--K-------|||||----------------------#--
XXXXXXXXXXXXXXXXXXXXXXXXXXXXXXXXXXXXXXXXXXXXXXXXXXXXXXXXXXXXXXXXXXXXXX%%%%%%----XXXXXX---XXXXXXXXXXX--XXXXXXXXXXXXXXXXXX|||||--------------XXXXXXXXXXX
XXXXXXXXXXXXXXXXXXXXXXXXXXXXXXXXXXXXXXXXXXXXXXXXXXXXXXXXXXXXXXXXXXXXXX|||||-----XXXXXX---XXXXXXXXXXX--XXXXXXXXXXXXXXXXXX|||||--------------XXXXXXXXXXX
