------------------------------------------------------------------------------------------------------------------------------------------------------
------------------------------------------------------------------------------------------------------------------------------------------------------
------------------------------------------------------------------------------------------------------------------------------------------------------
--------------------SSSSSSSSSSSSSSSSSSSS----------------------------------------SSSSSSSSSL------------------------------------------------------------
--------------------SSSSSSSSSS------------------------------------------------------------------------------------------------------------------------
--------------------SSSSSSSSSS----------ooooo-----------------------------------------------oo--------------------------------------------------------
--------------------SSSSSSSSSS------------------------------------------SSSSS-------oooooo------------------------------SSS-------%-------------------
------------------------------------------------SS--------------------------------------------------------------oooo----------------------------------
---------------------------------------S-SSSS---------------------------------------SSSSSS---------%------------------------------------SSS-----------
------------Q--?-----------------------S-----------------o--------------------------SSSSSS------------------------------------------------------------
-------------------S--SSSSSS?----------S-------------------------------------2------------SS----------%%%%%%--T-------------------%%%%%---------------
----------------------SSSSS----#-------------------------------------T-----TT--------------------------||||---T--------------------|||-------------#--
----------------------SSSSS----#-#----------%%%%%------------B-------Tt----TT--T-------------%%%%------||||---T---------------TT---|||---------K---#--
-M----------------K--------ooo-#-#-----------|||----k--------b-------Tt----TT--T--------------||-------||||---T---y-----------TT---|||-------------#--
XXXXXXXXXXXXXXXXXXXX-XXXXXXXXXXXXXXXXXXX%%---|||---XXXXXXXXXXXXXXX--XXXXXXXXXXXX---XXXXXXX----||----%%-||||-%%XXXXXXXXXX----XXXXXX%|||------XXXXX--XXX
XXXXXXXXXXXXXXXXXXXX-XXXXXXXXXXXXXXXXXXX|----|||---XXXXXXXXXXXXXXX--XXXXXXXXXXXX---XXXXXXX----||----|--||||--|XXXXXXXXXX----XXXXXX-|||------XXXXX--XXX
