------------------------------------------------------------------------------------------------------------------------------------------------------
------------------------------------------------------------------------------------------------------------------------------------------------------
------------------------------------------------------------------------------------------------------------------------------------------------------
--------------------SSSSSSSSSS------------------------------SSSSSSSSSS------------------------------SSSSSSSSSS----------------------------------------
--------------------SSSSSSSSSS------------------------------SSSS--SSSS--------------------------------------------------------------------------------
--------------------SSSSSSSSSS------------------------------SSSS--SSSS----------------------oo--------------------------------------------------------
--------------------SSSSSSSSSSS-------------------------------SS---S---------------o--o-----------------------------------oo---%%%!S------------------
--------------------------------------------------------------SS---S---------------------------------------------SSS------SS----||--------------------
--------------------------------------------------------------SS---S-------------------------------%----------------------------||--------------------
------------Q--?--------------------------------------------ooSS---SoU-------------SSSS-----------------------------------------||--------------------
-----SSS-----------S--SSSSSS?-##--SSC-----------------S-----SSSS---SSS--------------------SS---------------TT----------------SS-||S------#------------
----------------------SSSSS-----------------------TT----------------------------------------------------#--TT-------------------||------##------------
----------------------SSSSS-----------------------TT----------------------------%%%----------%%%%------##--TT-------------------||-----###---------F--
------------------K--------ooo-----------------gggTT------k-k--g-g----gg--------||------------||----kk-##--TT-------------------||----####---------#--
XXXXXXXXXXXXXXXXXXXX-XXXXXXXXXXX--XXXXXX-XXXXXXXXXXXXXXXXXXXXXXXXXXXXXXXXXXXXXXX||------------||----XXXXX--XX-%%%%----%%%%-----%%%XXXXXXXXXXXXXXXXXXXX
XXXXXXXXXXXXXXXXXXXX-XXXXXXXXXXX--XXXXXX-XXXXXXXXXXXXXXXXXXXXXXXXXXXXXXXXXXXXXXX||------------||----XXXXX--XX-|||------||-------||XXXXXXXXXXXXXXXXXXXX
