------------------------------------------------------------------------------------------------------------------------------------------------------
------------------------------------------------------------------------------------------------------------------------------------------------------
------------------------------------------------------------------------------------------------------------------------------------------------------
----------------------------------------------------------------------SSSSSSSSSS----------------------------------------------------------------------
------------------------------------------------------------------------------------------------------------------------------------------------------
----------------------------------------------------------------------------------------oo------------------------------------------------------------
------------------SCS-----------------------------------------------------------oo---------SSS!--------------------------SSS----S!--------------------
---------------------------TT-------------------------------------------------TT---------------------------------SSS----------------------------------
---------------------------TT----------------------------TT----------o--------TT----------------------------------------------------------------------
---------------------------XX----------------------TT----TT------y------------TT-SSS------------------------------------------------------------------
-----SSS------TT---2---TT--------------------------TT----XX------##---------SCTT---------S----C----------------------------------S--------------------
--------------TT-------TT--------------T-----------TT-----------###-----TT----TT-----------------------------------------------------TT---------------
--------------TT-------TT--------------T-----------TT----------####-----TT----TT--------------------------*--------------------------TT------------F--
--------------TT----k--TT------------kkT-----------TT---------#####-----TT---kTT---------------g-g--gg----*-----------------gg-g-g---TT------------#--
XXXXXXXXXXXXXXXXXXXXXXXXXXXXXXXXXXXXXXXXX-XX-XX-XXXXXXXXXXXXXXXXXXX---XXXXXXXXXX----------XXXXXXXXXXXXXXXXXXX-%%%%----%%XXXXXXXXXXXXXXXXXXXXXXXXXXXXXX
XXXXXXXXXXXXXXXXXXXXXXXXXXXXXXXXXXXXXXXXX-XX-XX-XXXXXXXXXXXXXXXXXXX---XXXXXXXXXX----------XXXXXXXXXXXXXXXXXXX-|||------|XXXXXXXXXXXXXXXXXXXXXXXXXXXXXX
