------------------------------------------------------------------------------------------------------------------------------------------------------
------------------------------------------------------------------------------------------------------------------------------------------------------
------------------------------------------------------------------------------------------------------------------------------------------------------
S-----SSSS----------------------------------------------------------------------SSSSSSSSSS------------------------------SSSSSSSSSSSSSSSSSS------------
S-------------------------------------------------?---------------------------------------------------------------------------------------------------
S------------------------------------------------------------------------------------------------------------------k----------------------------------
S---------------------------------------------QQQQ------------------------SS---------------------------------RS---SSSSSS---------------------QQQQ-----
S-------------------------------------------------SS-----------------------------------------------------r--------------------------------------------
S---------------------------------------------------------------------------------------------------%%%%%%%-------------------------------------------
S-----------------------------------------------k--------------------------------------S----------oo||||||-------------------------------------y------
S---------------------------TT----------T-----?QQQ-------------------TSS-----SS-SU------------------||||||-----------------------------g##--Q?SSQQQ---
S----------------K----------TT--------K-T--------------SSS-----------T--------------TT---t-----TT---||||||----------------SS-----------###------------
S-----------B---------------TTTTTT------T----------------------------T--------------TT---t-----TT---||||||----TT----------SS---------g####------------
S-----------b-----------ggg-TTTTTT------T---------------------ggg----T-------------kTT--kt--y--TT---||||||--ooTT----------SS---------#####------------
XXXXXXXXXXXXXXXXXXXXXXXXXXXXXXXXXXXXXXXXXXXXXXXXXX----------XXXXXXXXXX----------XXXXXXXXXXXXXXXXXXXX||||||--%%XXXXXXXX----XX--XXXXXXXXXXXX--XX--XXXXXX
XXXXXXXXXXXXXXXXXXXXXXXXXXXXXXXXXXXXXXXXXXXXXXXXXX----------XXXXXXXXXX----------XXXXXXXXXXXXXXXXXXXX||||||---|XXXXXXXX----XX--XXXXXXXXXXXX--XX--XXXXXX
