------------------------------------------------------------------------------------------------------------------------------------------------------
------------------------------------------------------------------------------------------------------------------------------------------------------
------------------------------------------------------------------------------------------------------------------------------------------------------
--------------------------------oo----------------SSSSSSS-----------------------ooo---------------------------SSSSSSSSSS----------SSSSSSSSSS----------
-------------------------------------g-g----?-----------------------------------%%%-------------------------------------------------------------------
-----------------------------------%%%%%-----------------------------------------|----------oo--------------------------------------------------------
--------------------S---------------||||----------QQ-----------------------------|---------------------------@------------oo---%%%--------------------
---------------------------TT-------||||------r----------------------------------|----------------------------------------SS----||--------------------
---------------------------TT-------||||--%%%%%%-----------S---------------------|-----------------%----------------------------||--------------------
---------------------------XX-%%%%%-||||---||||----------------------------------|---%%%%---------------------------------------||--------------------
----------Q------------TT------|||--||||%%-||||oooQQ--QQQ------------------------|----||--SS--------SU----!--!T--------------SS-||------------#LSS----
-----------------------TT------|||--|||||--||||--r-------------------T----------%%%%%%||----------------------T-----------------||--------TT--#-------
-----------------------TT------|||--|||||%%%%%%%%%-----------B-------T-----------||||-||-----%%%%-------------T----TT-----------||-tt-----TT--#-------
-M-----------------#k--TT------|||--|||||-||||||||-----------b-------T-----------||||-||------||----------k---T--g-TT-----------||-tt----kTTkk#-------
XXXXXXXXXXXXX--XXXXXXXXXXXXXXX-|||--|||||-||||||||XXXXXXX---XXXXXX--XXX----XXXXX-||||-||%%----||----XXXXXXXXXXXXXXXXXXXX%%-----%%%XXXXXXXXXXXXXXXXX---
XXXXXXXXXXXXX--XXXXXXXXXXXXXXX-|||--|||||-||||||||XXXXXXX---XXXXXX--XXX----XXXXX-||||-||-|----||----XXXXXXXXXXXXXXXXXXXX|-------||XXXXXXXXXXXXXXXXX---
