------------------------------------------------------------------------------------------------------------------------------------------------------
------------------------------------------------------------------------------------------------------------------------------------------------------
------------------------------------------------------------------------------------------------------------------------------------------------------
------------------------------SSSSSSSSSS----------------------------------------------------------------------SS-------S------------------------------
-----------------------------------------------------------------------------------------------------------------------------------------------------o
------------------------------------------------------------------------------------------------------------------------------------------------------
---------------------------------------------------------------------------g---------SUS---SSS!------------------------S-------SSS-------##-----------
-------------------------------------------------------------o---o---o-%%%%%%------------------------------------------------------------##-----SSS---
---------------------------------------S--------------------%%%-%%%-%%--||||---------------------------------------SSS-----------------####-oo--------
---------------------------------------S---------------------|---|---|--||||----------------------------------------------------K------####-----------
----------------------------TT---------S------tt-------------|---|---|--||||--------#####-----C------------------------S-------SSS---######-SS--------
-----------------K----------TT-#--------------tt----K--------|---|---|--||||--------#-----------------TT-------##--------------------######-----------
------------B---------------TT-#-#------------tt-------------|---|---|--||||-------K#-----------------TT----TT-##--------TT----------######-----------
-M----------b-----------ggg-TT-#-#-------g----tt-----------g-|---|-r-|--||||--------#----------g-g----TT-k--TT-##--------TT----------######-----------
XXXXXXXXXXXXXXXXXXXXXXXXXXXXXXXXXXXXXXXXXXXXXXXXXXXXXXXXXXXX%%%%%%%%%%--||||----XXXXXXX---XXXXXXXXXXXXXXXXXXXX-XX------XXXXXXXXXXXXXXXXXXXXX----------
XXXXXXXXXXXXXXXXXXXXXXXXXXXXXXXXXXXXXXXXXXXXXXXXXXXXXXXXXXXX-|||||||||--||||----XXXXXXX---XXXXXXXXXXXXXXXXXXXX-XX------XXXXXXXXXXXXXXXXXXXXX----------
