------------------------------------------------------------------------------------------------------------------------------------------------------
------------------------------------------------------------------------------------------------------------------------------------------------------
------------------------------------------------------------------------------------------------------------------------------------------------------
--------------------------------------------------------------------------------------------------------------------------------------------SSSSSSSSSS
------------------------------------------------------------------------------------------------------------------------------------------------------
-------------------------------------------------------oooo----------R----------------------oo--------------------------------------------------------
----------------------!--------------------------------%%%%----------------g-------------------------------------------------------------##-----------
--------------------------------------------------------||-------------%%%%%%------------------------------------------------------------##-----------
--------------------------------------------------------||--------------||||-----------------------%--------------------------SSS------####-----------
------------Q--?----------------------------------SSS---||--------------||||------o----------------------------------------------------####-----------
-------------------SS@S!S-------------------------------||-------%%%----||||-----------TT-SS----------------------------%------------######---TT------
--------------------------------------ttT-----TT------U-||--------|-----||||-----------TT--------------------------------------------######---TT------
----------------------------tt--------ttT-----TT--------||--------|-----||||-----------TT----%%%%---------*--------------------------######---TT------
-M----------------K--g------tt--------ttT-----TT--------||--------|-----||||-----------TT-----||----gg----*----k----kkk----------r---######---TT------
XXXXXXXXXXXXXXXXXXXXXXXXXXXXXXXXXXXXXXXXXXXX--XXXX----%%%%%-%%%%%-|-----||||----XXXXXXXXXX----||----XXXXXXXXX-XXXXXXXXXX----XXXXXXXXXXXXXXXXXXXX--XXXX
XXXXXXXXXXXXXXXXXXXXXXXXXXXXXXXXXXXXXXXXXXXX--XXXX-----|||---|||--|-----||||----XXXXXXXXXX----||----XXXXXXXXX-XXXXXXXXXX----XXXXXXXXXXXXXXXXXXXX--XXXX
