------------------------------------------------------------------------------------------------------------------------------------------------------
------------------------------------------------------------------------------------------------------------------------------------------------------
------------------------------------------------------------------------------------------------------------------------------------------------------
----------SSSSSSSSSS----------SSSSSSSSSS--------------------------------------------------SSSSSSSSSS--------------------------------------------------
------------------------------SSSSSSSSSS--------------------------------------------------------------------------------------------------------------
----------------------ooor----SSSSSSSSSSooooo---------------------------------------------------------------------------------------------------------
---------------------%%%%%----SSSSSSSSSS-----------------Q-Q-------------------------SUS---------------------------oo--------------SSSS---------------
----------------------|||-----------------------SS------------------------------------------------------------------------------oo--------------------
----------------------|||----------------SSSS------------------------o--------------------------------------------------------------------------------
----------------------|||----------------------------------------y---------------------------------------------------------------------SSSS-----------
-----SSS--@QQQQ-----%%%%%%%---SSSSSSSSSS-----------------Q-Q-----##-----------------#####----------------------%%%%--%%%-----TT---------------#LSS----
--------------------||||||----SSSSSSSSSS------------------------###-----------------#---------------------------||----||-----TT---------------#-------
-----------------g-#||||||--o-SSSSSSSSSS----%%%%%--------------####----------------K#---------------------*-----||----||-----TT---------------#-------
----------------g#-#||||||-%%%SSSSSSSSSS-----|||--------------#####---gg------------#-----------g-g-gg----*---o-||----||-y---TT-------------kk#-------
XXXXXXXXXXXXXXXXXXXX||||||--|-XXXXXXXXXX%%---|||--XXXXXXXXXXXXXXXXX---XXXXXXXXXXXXXXXXX---XXXXXXXXXXXXXXXXXXX-%-||----||XXXXXXXXXX---------XXXXXXXX---
XXXXXXXXXXXXXXXXXXXX||||||--|-XXXXXXXXXX|----|||--XXXXXXXXXXXXXXXXX---XXXXXXXXXXXXXXXXX---XXXXXXXXXXXXXXXXXXX---||----||XXXXXXXXXX---------XXXXXXXX---
