------------------------------------------------------------------------------------------------------------------------------------------------------
------------------------------------------------------------------------------------------------------------------------------------------------------
------------------------------------------------------------------------------------------------------------------------------------------------------
--------------------------------------------------------------------------------SSSSSSSSSL------------------------------------------------------------
------------------------------------------------------------------------------------------------------------------------------------------------------
--------------------------------------------------------------g---------------------------------------------------------------------------------------
----------------------------------------------QQQQ------------SSSSS--------g--------oooooo-------------------@-----------SSS----S!--------------------
-----------------------------------------------------------------------%%%%%%-------------------------------------------------------------------------
---------------------------------------------------------TT-------------||||--------SSSSSS------------------------------------------------------------
------------------------------------------------k--TT----TT-------------||||--------SSSSSS--------oo--------------------------------------------------
-------------------%--------TT----------T-----?QQQ-TT----XX-------------||||------------------------SU----!--!--!-----S----------S--------------------
----------------------------TT--------ttT----------TT-------------------||||-------------------TT------------------------------------TT------------#--
----------------------------TT--------ttT----------TT---------TT-----t--||||-------------------TT------------------------------------TT--------K---#--
-------------%%%%-------ggg-TT--------ttT----------TT---------TT-----t--||||----------------y--TT---------k-----------------gg-g-g---TT------------#--
XXXXXXXXXXX---||----XXXXXXXXXXXXXXXXXXXXXXXXXXXXXXXXXXXXXXXXXXXXXXXXXX--||||-------XXXXXXXXXXXXXXXXXXXXXXXXXXXXXXXXXXXXXXXXXXXXXXXXXXXXXXXXXXXXXX--XXX
XXXXXXXXXXX---||----XXXXXXXXXXXXXXXXXXXXXXXXXXXXXXXXXXXXXXXXXXXXXXXXXX--||||-------XXXXXXXXXXXXXXXXXXXXXXXXXXXXXXXXXXXXXXXXXXXXXXXXXXXXXXXXXXXXXX--XXX
