------------------------------------------------------------------------------------------------------------------------------------------------------
------------------------------------------------------------------------------------------------------------------------------------------------------
------------------------------------------------------------------------------------------------------------------------------------------------------
------------------------------SSSSSSSSSS----------SSSSSSS---------------------------------------------------------------------------------------U-----
------------------------------SSSSSSSSSS--------------------------------------------------------------------------------------------------------------
------------------------------SSSSSSSSSS------------------------------------------------oo------------oo-----------k----------------------------------
------------------------------SSSSSSSSSS----------QQ----------------------------oo----------------------------S---SSSSSS------------------------------
--------------------------------------------------------------------------------------------------------------------------------------------------SS--
-----------------------------------------------------------S------------------------------------------------------------------SSS---------------------
-------------------------------------------------------------------------1-------SS-----------------------------------------------------------SS------
----------------!-----------TTSSSSSSSSSS----------QQ--QQQ------------TT------------------S-------tt---------------------%------------------#---------#
----------------------------TTSSSSSSSSSS-----------------------------TT----TT-------------T------tt---------------------------------------##--------##
----------------------------TTSSSSSSSSSS-----------------------------TT----TT-------------T------tt---------ttTT-------------------------###-------###
-M----------------------ggg-TTSSSSSSSSSS----y-y---------------ggg----TT---kTT-------------T------tt---ggg---ttTT-----------------r---y--####------####
XXXXXXXXXXXXXXXXXXXXXXXXXXXXXXXXXXXXXXXXXXXXXXXXXXXXXXXXX---XXXXXXXXXXXXXXXXXXXX----------XXXXXXXXXXXXXXXXXXXXXXXXXXXX------XXXXXXXXXXXXXXXXXXXXX-XXXX
XXXXXXXXXXXXXXXXXXXXXXXXXXXXXXXXXXXXXXXXXXXXXXXXXXXXXXXXX---XXXXXXXXXXXXXXXXXXXX----------XXXXXXXXXXXXXXXXXXXXXXXXXXXX------XXXXXXXXXXXXXXXXXXXXX-XXXX
