------------------------------------------------------------------------------------------------------------------------------------------------------
------------------------------------------------------------------------------------------------------------------------------------------------------
------------------------------------------------------------------------------------------------------------------------------------------------------
S-----SSSS--------------------------------------------------------------------------------------------------------------------------------------------
S-----------------------------------------------------------------------------------------------------------------------------------------------------
S-----------------------------------------------------------------------------------------------------------------------------------------------------
S----------------------------U----------------QQQQ------------USSS---------1-------USS-----------------------------oo---SSS--------SSSS---------------
S-------------------------------------------------------------------------------------------------oo--------------------------------------------------
S-----------------------------------------------------------------------------------------------------------------------------------------------------
S-----------------------------------------------k--------------------------ggg---------------------------------------------------------SSSS-----------
S---------------%%%%--------##----------T-----?QQQ-----ooo---S-----TT-#########---#----------------------------%%%%--%%%------------------------------
S----------------||----y-#####----------T--------------------------TT---------#---#-------------#-----------g---||----||------------------------------
S----------------||-y-######------------T--------------------------TT---------#---##------------#-----------TT--||----||------TT-------------------F--
S----------------||-######--------k-k---T--------------------ggg---TT---------#---##--gg--------#-----------TTo-||----||------TT-------------------#--
XXXXXXXXXXX--%%%%||%XXXX------XXXXXXXXX-XXXXXXXXXX--XXXXXXXXXXXXXXXXXX--------X---XXXXXXXXXXXXXXXXXX--XXXXXXXX%-||----||----XXXXXX---------XXXXXXXXXXX
XXXXXXXXXXX---||-||-XXXX------XXXXXXXXX-XXXXXXXXXX--XXXXXXXXXXXXXXXXXX--------X---XXXXXXXXXXXXXXXXXX--XXXXXXXX--||----||----XXXXXX---------XXXXXXXXXXX
