------------------------------------------------------------------------------------------------------------------------------------------------------
------------------------------------------------------------------------------------------------------------------------------------------------------
------------------------------------------------------------------------------------------------------------------------------------------------------
S-----SSSS----------SSSSSSSSSS------------------------------------------------------------------------------------------SSSSSSSSSS--------------U-----
S-------------------SSSSSSSSSS--------------------?---------------------------------------------------------------------------------------------------
S-------------------SSSSSSSSSS----------------------------------------------------------oo-------------------------k----------------------------------
S-------------------SSSSSSSSSS------------------------------------SSoo----------oo---------------------------@S---SSSSSS----------SS------------------
S-------------------------------------------------SS----------------------------------------------------------------------------------------------SS--
S---------------------------------------------------------------------o-------------------------------------------------------------------------------
S--------------------------------------------------------------------------------SS-----------------------------------------------------------SS------
S---------------------SSSSSS?-------------------------------%%%%%%-----------------------S----------SU----!--!--------------------SS-----------------#
S----------------K----SSSSS----------------------------SSS---||||-------------#-------------------------------------------SS------K---#----B--------##
S-----------B---------SSSSS----------------------------------||||------------##-------------------------------TT----------SS----------#----b-------###
S--M--------b--------------ooo----k-k----------y-------------||||----------------------------------g------k---TT----------SS----------#----B------####
XXXXXXXXXXXXXXXXXXXX-XXXXXXXXXXXXXXXXXX-XXXXXXXXXX-----------||||-----XXXXXXXXXX-----------XXXXXXXXXXXXXXXXXXXXXXXXXXX----XX--XXXXXXXXXXXXXXXXXXX-XXXX
XXXXXXXXXXXXXXXXXXXX-XXXXXXXXXXXXXXXXXX-XXXXXXXXXX-----------||||-----XXXXXXXXXX-----------XXXXXXXXXXXXXXXXXXXXXXXXXXX----XX--XXXXXXXXXXXXXXXXXXX-XXXX
