------------------------------------------------------------------------------------------------------------------------------------------------------
------------------------------------------------------------------------------------------------------------------------------------------------------
------------------------------------------------------------------------------------------------------------------------------------------------------
--------------------------------oo--------------------------------------------------------------------------------------------------------------------
-------------------------------------g-g--------------------------------------------------------------------------------------------------------------
-----------------------------------%%%%%--------------------------------------------------------------------------------------------------------------
------------------SC---------U------||||-----------------------------------1---------SSSS--------------------------------------SSS-----------QQQQ-----
------------------------------------||||-------------------------------------------------------------------------SSS----------------------------------
------------------------------------||||-----------------------------o---------------------------------------------------------------g#---------------
------------------------------%%%%%-||||-------------------------y---------ggg-------------o------------------------------------K---g##--------y------
--------------TT---2--------##-|||--||||--------------S----------##---#########-Q----------------TT---%%%%%%-------------------SSS--###-----Q?SSQQQ---
--------------TT-------y-#####-|||--||||----------TT------------###-----------#------------------TT----||||------------------------####---------------
--------------TT----y-######---|||--||||----------TT-----------####-----------#------------------TT----||||--------------TT-------#####---------------
-M------------TT----######-----|||--||||----------TT------k---#####-----------#--ggg-------------TT----||||--------------TT-------#####---------------
XXXXXXXXXXXXXXXXXXXXXXXX-------|||--||||X-XX-XX-XXXXXXXXXXXXXXXXXXX-----------X-XXXXX----XXXXXXXXXXX%%-||||-%%%%%%----%%XXXXXXXXXXXXXXX--XXXXX--XXXXXX
XXXXXXXXXXXXXXXXXXXXXXXX-------|||--||||X-XX-XX-XXXXXXXXXXXXXXXXXXX-----------X-XXXXX----XXXXXXXXXXX|--||||--||||------|XXXXXXXXXXXXXXX--XXXXX--XXXXXX
