------------------------------------------------------------------------------------------------------------------------------------------------------
------------------------------------------------------------------------------------------------------------------------------------------------------
------------------------------------------------------------------------------------------------------------------------------------------------------
S-----SSSS----------SSSSSSSSSSSSSSSSSSSS----------------------------------------------------------------------SS-------S--------------------SSSSSSSSSS
S-------------------SSSSSSSSSS--------------------?---------------------------------------------------------------------------------------------------
S-------------------SSSSSSSSSS------------------------------------------------------------------------oo----------------------------------------------
S-------------------SSSSSSSSSS------------------------------------SSoo--SSSSS-------y-----SSS------%-------------------S----------%-------------------
S-------------------------------------------------SS------------------------------#SSS----------------------------------------------------------------
S--------------------------------------S-----------------------------------------##--------------------------------SSS------------------SSS-----------
S--------------------------------------S----------------------------------------###1------------------------------------------------------------------
S---------------%%%%--SSSSSS?----------S--------------------%%%%%%-----------2--###---------%%%------------------------S----------%%%%%-------TT------
S----------------||---SSSSS----#-----------------------SSS---||||----------TT---###--SSS-----|-----------------##------------------|||--------TT------
S----------------||---SSSSS----#-#---------------------------||||-----t----TT--T###----------|--------------tt-##------------------|||--------TT------
S--M-------------||--------ooo-#-#---------------------------||||-----t----TT--T###----------|--------ggg---tt-##--------k----ggg--|||--------TT------
XXXXXXXXXXX--%%%%||%-XXXXXXXXXXXXXXXXXXXX-XX-XX-XX-----------||||-----XXXXXXXXXXXXXXXX---X---|------XXXXXXXXXX-XX------XXXXXXXXXXX%|||------XXXX--XXXX
XXXXXXXXXXX---||-||--XXXXXXXXXXXXXXXXXXXX-XX-XX-XX-----------||||-----XXXXXXXXXXXXXXXX---X---|------XXXXXXXXXX-XX------XXXXXXXXXXX-|||------XXXX--XXXX
