------------------------------------------------------------------------------------------------------------------------------------------------------
------------------------------------------------------------------------------------------------------------------------------------------------------
------------------------------------------------------------------------------------------------------------------------------------------------------
--------------------------------------------------------------------------------------------------------------SSSSSSSSSS------------------------------
------------------------------------------------------------------------------------------------------------------------------------------------------
--------------------------------------oo--------------------------------------------------------------------------------------------------------------
--------------------S--------------SSSS------------------------------------g--------y-----------------------------------SS--------%-------------------
---------------------------TT------------------------------------------%%%%%%-----#SSS----------------------------------------------------------------
---------------------------TT-------------------------------------------||||-----##-----------------------------------------------------SSS-----------
---------------------------XX-------------------------------------------||||----###1---------------------------------------TT-------------------------
---------Q---------%---TT-----%--------------------------tt----------T--||||----###-------------------%%%%%%--T------------TT-----%%%%%---------------
-----------------------TT--------------------------------tt----------T--||||----###--SSS---------------||||---T---------t--TT------|||-------------#--
-----------------------TT--------------------------------tt----------T--||||----###--------------B-----||||---T----TT---t--TT------|||---------K---#--
-M-----------%%%%---k--TT----------------------------g-g-tt---ggg----T--||||----###--------------b-----||||---T--g-TT---t--TT------|||-------------#--
XXXXXXXXXXX---||----XXXXXXXXXX--%%%%--%%X-XX-XX-XXXXXXXXXXXXXXXXXXXXXX--||||----XXXXXX---XXXXXXXXXXX%%-||||-%%XXXXXXXXXXXXXXXXXXXX%|||------XXXXX--XXX
XXXXXXXXXXX---||----XXXXXXXXXX---||----|X-XX-XX-XXXXXXXXXXXXXXXXXXXXXX--||||----XXXXXX---XXXXXXXXXXX|--||||--|XXXXXXXXXXXXXXXXXXXX-|||------XXXXX--XXX
