------------------------------------------------------------------------------------------------------------------------------------------------------
------------------------------------------------------------------------------------------------------------------------------------------------------
------------------------------------------------------------------------------------------------------------------------------------------------------
--------------------------------------------------------------------------------SSSSSSSSSS----------SSSSSSSSSS----------------------------------------
------------------------------------------------------------------------------------------------------------------------------------------------------
----------------------------------------%%------------------------------------------------------------------------------------------------------------
--------------------USS-----------------|---------------------------------SS----------------------------------------------SSC-----SS------------------
----------------------------------------|----oo-------------------------------------------------------------------------------------------------------
----------------------------------------|-------------------------------------------------------------------------------------------------------------
----------------------------------------|----------------------------------------------S----------------------------------SSS-------------------------
----------------------------------------|-------------S---------------SS-----SS-SU-------------------------TT---------r-----------SS--------#---------
---------------------B----------------K-|---------TT--------------------------------TT---t--------------#--TT-----%%%%%%----------K---#----B##--------
---------------------b-------BTTTT------|---------TT--------------------------------TT---t-------B-----##--TT------|||||--------------#----b###------#
-M--------k---ggg----B-------bTTTT------|---------TT------k--y---------------------kTT--kt-------b--kk-##--TT------|||||---------#----#----B####----##
XXXXXXXXXXXXXXXXXXXXXXXXXXXXXXXXXXXXXXXX|----%%%%-XXXXXXXXXXXXXXXXXXXX----------XXXXXXXXXXXXXXXXXXXXXXXXX--XX--%%%-|||||X----XXXXXXXXXXXXXXXXXXXXXXXXX
XXXXXXXXXXXXXXXXXXXXXXXXXXXXXXXXXXXXXXXX|-----||--XXXXXXXXXXXXXXXXXXXX----------XXXXXXXXXXXXXXXXXXXXXXXXX--XX---|--|||||X----XXXXXXXXXXXXXXXXXXXXXXXXX
