------------------------------------------------------------------------------------------------------------------------------------------------------
------------------------------------------------------------------------------------------------------------------------------------------------------
------------------------------------------------------------------------------------------------------------------------------------------------------
---------------------------------------------------oo-------------------------------------------------------------------------------------------------
--------------------------------------------------%%%%------------------------------------------------------------------------------------------------
----------------------ooor-------------------------||-------------------------------------------------oo----------------------------------------------
---------------------%%%%%----S--------------------||-------------------------------------------------------------------SS-------------US---SSS-------
----------------------|||--------------------------||--SSS--------------------------------------------------------------------------------------------
-----------------g----|||--------------------------||-----------------------------TT------------------------------------------------------------------
-----------------#----|||--------------------------||-----------------------------TT-----------oooo------------------------TT--------SS----------SSSSS
----------S-----##--%%%%%%%---##--SSC--------------||----------------T------------TT----------------------------------r----TT--------------S----------
---------------###--||||||-------------------------||----------------T------------TT-----T------------------------%%%%%%t--TT-------------------------
--------------####--||||||--o---------------------%||----------------T----------T-TT-----T------------------tt-----|||||t--TT-----TT--------SSS-------
-M-----------#####--||||||-%%%-----------------ggg-||---------ggg----Tgg--------T-TT---k-T------------ggg---tt-----|||||t--TT-----TT---------------r--
XXXXXXXXXXXXXXXXXXXX||||||--|-XX--XXXXXX-XXXXXXXXX-||-------XXXXXXXXXXXXXXXXXXXXXXXXXXXXXX%%%%%%%-%%XXXXXXXXXX-%%%-|||||XXXXXXXXXXXXXXXX-X-X-----XXXXX
XXXXXXXXXXXXXXXXXXXX||||||--|-XX--XXXXXX-XXXXXXXXX-||-------XXXXXXXXXXXXXXXXXXXXXXXXXXXXXX||||||---|XXXXXXXXXX--|--|||||XXXXXXXXXXXXXXXX-X-X-----XXXXX
