------------------------------------------------------------------------------------------------------------------------------------------------------
------------------------------------------------------------------------------------------------------------------------------------------------------
------------------------------------------------------------------------------------------------------------------------------------------------------
-----------------------oo-----------------------------------------------------------------------------------------------------------------------------
------------------------------------------------------------------------------------------------------------------------------------------------------
--------------------------------------------------------------------------------K---------------------oo----------------------------------------------
------------------Q---SSSS-------------------------------------------------g----SS----1--------------------------------------------SSSS---------------
-----------------------------------------------------------------------%%%%%%-------------------------------------------------------------------------
------------------------------------------------------------------------||||--------------------------------------------------------------------------
---------------------------------------------------------o--------------||||---------------------------------------------------SSS-----SSSS-----------
------------------?-------%%%%------------------------------------------||||----SS--------------TT--------------------r-%-----------------------------
--------------TT-----------|||------------------------------------------||||----------TT--------TT----------------%%%%%%------------------------------
--------------TT-----------|||------------------------------------------||||----------TT--------TT----------tt-----|||||---------------------------F--
-M------------TT-----------|||----k-k----------y----k--------y----------||||----------TT----k---TT----ggg---tt-----|||||---------r-----------------#--
XXXXXXXXXXXXXXXXXXXX%%%----|||XXXXXXXXX-XXXXXXXXXX-XXXXXXXXXXXXXXXXXXX--||||----XXXXXXXXXXXXXXXXXXXXXXXXXXXXXX-%%%-|||||----XXXXXX---------XXXXXXXXXXX
XXXXXXXXXXXXXXXXXXXX||-----|||XXXXXXXXX-XXXXXXXXXX-XXXXXXXXXXXXXXXXXXX--||||----XXXXXXXXXXXXXXXXXXXXXXXXXXXXXX--|--|||||----XXXXXX---------XXXXXXXXXXX
