------------------------------------------------------------------------------------------------------------------------------------------------------
------------------------------------------------------------------------------------------------------------------------------------------------------
------------------------------------------------------------------------------------------------------------------------------------------------------
S-----SSSS----------------------oo----------------------------------------------------------------------------SS-------S------------------------------
S--------------------------------------g--------------------------------------------------------------------------------------------------------------
S----------------------SSS---------%%%%%--------------------------------------------------------------------------------------------------------k-----
S-----------------------------------||||-------------------------------------------o--o----------------------R---------S-------SSS!S-----------SQS--SQ
S--------------------g--------------||||-------------------------------------------------------------r------------------------------------------------
S-------------------%%%-------------||||------------------------------------------------------------%%%%%%%--------SSS--------------------------------
S-----------Q--?----||----SSS-%%%%%-||||------------------------1------------------SSSS---------g---||||||----------------------K---------------------
S------------------S||---------|||--||||-TT---SU-------ooo--------------------------------------TT--||||||-------------S-------SSSS------#-----SQS--S?
S-------------------||---------|||--||||-TT-----------------------------------------------------TT--||||||-----##-----------------------##------------
S-------------------||---------|||--||||-TT-------------------------------------%%%-------------TT--||||||-----##--------TT------------###------------
S-----------------K-||----oo---|||--||||-TT------k------------------------------||--------------TT--||||||--oo-##--------TT-----------####---k------gg
XXXXXXXXXXXXXXXXXXXX||---%%%---|||--||||XXXXXXXXXX--XXXXXXXXXXXXXXXXX-X----XXXXX||--------XXXXXXXXX-||||||--%%-XX------XXXXXXXXXXXXXXXXXXXXXXXXXXXXXXX
XXXXXXXXXXXXXXXXXXXX||----|----|||--||||XXXXXXXXXX--XXXXXXXXXXXXXXXXX-X----XXXXX||--------XXXXXXXXX-||||||---|-XX------XXXXXXXXXXXXXXXXXXXXXXXXXXXXXXX
