------------------------------------------------------------------------------------------------------------------------------------------------------
------------------------------------------------------------------------------------------------------------------------------------------------------
------------------------------------------------------------------------------------------------------------------------------------------------------
S-----SSSS--------------------------------------------------------------------------------------------------------------------------------------------
S----------------------------------------------------------------------------------------------------------------------------------------------------o
S-------------------------------------oo%%-------------oooo-------------------------------------------------------------------------------------------
S----------------------------------SSSS-|--------------%%%%--------------------------1-----------------------------oo--------------SSSS---------------
S---------------------------------------|----oo---SSSS--||--------------------------------------------------------------------------------------SSS---
S----------------%%%--------------------|---------------||---------------------g------------------------------------------------------------oo--------
S-----------------||--------------------|---------------||---------------------------------o----------------------------SS-?Q----------SSSS-----------
S-----------------||----------%---------|---------------||-------------------S@S---QQQQ----------TT------------%%%%--%%%--------------------SS--------
S------------%%%%%||--------------------|-------------U-||---------------------------------------TT---------g---||----||------------------------------
S-------------|||-||--------------------|---------------||---------------------------------------TT---------TT--||----||-------y----------------------
S-------------|||-||--------------------|---------------||--gg-------g--------------yy-----------TT---------TTo-||----||---SSSSS----------------------
XXXXXXXXXXX---|||-||XXXXX--XXX--%%%%--%%|----%%%%-----%%%%%-XXXXXXXXXX-XXXXXXXXXXXXXXXXXXXXXXXXXXXXX--XXXXXXXX%-||----||-------XX----------X----------
XXXXXXXXXXX---|||-||XXXXX--XXX---||----||-----||-------|||--XXXXXXXXXX-XXXXXXXXXXXXXXXXXXXXXXXXXXXXX--XXXXXXXX--||----||-------XX----------X----------
