------------------------------------------------------------------------------------------------------------------------------------------------------
------------------------------------------------------------------------------------------------------------------------------------------------------
------------------------------------------------------------------------------------------------------------------------------------------------------
-----------------------oo-----------------------------------SSSSSSSSSS--------------------------------------------------------------------------------
------------------------------------------------------------SSSS--SSSS--------------------------------------------------------------------------------
----------------------------------------%%------------------SSSS--SSSS--------------------------------------------------------------------------------
----------------------SSSS----S---------|---------------------SS---S-------1----------------------------------?SSS--------oo---%%%--------------------
----------------------------------------|----oo---------------SS---S------------------------------------------------------SS----||--------------------
-----------------g----------------------|---------------------SS---S--------------TT--------------------------------------------||---g#---------------
-----------------#----------------------|----------------o--ooSS---SoU-----ggg----TT-----------oooo-----------------------------||--g##---------------
----------S-----##--------%%%%##--SSC---|-------------------SSSS---SSS#########---TT--------------------------SSSSS----------SS-||--###-----#---------
---------------###---------|||----------|-------------------------------------#---TT-----T------------TT------------------------||-####-----##--------
--------------####---------|||----------|-------------------------------------#-T-TT-----T------------TT----TT------------------||#####-----###------#
-M-----------#####---------|||----------|-----------k-------k--g-g------------#-T-TT---k-T------------TT-k--TT--K---------------||#####-----####----##
XXXXXXXXXXXXXXXXXXXX%%%----|||XX--XXXXXX|----%%%%--XXXXXXXXXXXXXXXXXXX--------X-XXXXXXXXXX%%%%%%%-%%XXXXXXXXXXXXXXXXXXXX%%-----%%%XXXXX--XXXXXXXXXXXXX
XXXXXXXXXXXXXXXXXXXX||-----|||XX--XXXXXX|-----||---XXXXXXXXXXXXXXXXXXX--------X-XXXXXXXXXX||||||---|XXXXXXXXXXXXXXXXXXXX|-------||XXXXX--XXXXXXXXXXXXX
