------------------------------------------------------------------------------------------------------------------------------------------------------
------------------------------------------------------------------------------------------------------------------------------------------------------
------------------------------------------------------------------------------------------------------------------------------------------------------
--------------------SSSSSSSSSS--------------------SSSSSSSSSS--------------------ooo-------------------------------------------------------------------
--------------------SSSSSSSSSS--------------?---------SS--SS--------------------%%%-------------------------------------------------------------------
--------------------SSSSSSSSSS------------------------SS--SS---------------------|--------------------------------------------------------------------
--------------------SSSSSSSSSS----------------------SS--------------------SS-----|---------------------------------------SSS----S!-----------------SSS
----------------------------------------------r-----SS---------------------------|--------------------------------------------------------------------
------------------------------------------%%%%%%----SS---------------------------|---------------------------------------------------g#---------------
-------------------------------------------||||-----SS----oo---------------------|---%%%%-------------------------------------------g##---------------
-------------------%--SSSSSS?--TT-------%%-||||ooo--SSSS--SS----------SS-----SS--|----||-----------------------------------------S--###-----------#---
----------------------SSSSS----TT-------|--||||--r----SS------------------------%%%%%%||--------------------g----------------------####-----------#---
----------------------SSSSS----TT-------|%%%%%%%%%----SS-------------------------||||-||---------B----------TT--------------------#####-----------#---
-M-----------%%%%----------ooogTT-------|-||||||||----------gg-------g-----------||||-||---------b----------TT-k----kkk-----gg-g-g#####------ggg--#---
XXXXXXXXXXX---||-----XXXXXXXXXXXXXXXXX--|-||||||||XXXXXXXXXXXXXXXXXXXX-----------||||-||%%XXXXXXXXXX--XXXXXXXXXXXXXXXXXXXXXXXXXXXXXXXXX--XXXXXXXXXXXXX
XXXXXXXXXXX---||-----XXXXXXXXXXXXXXXXX--|-||||||||XXXXXXXXXXXXXXXXXXXX-----------||||-||-|XXXXXXXXXX--XXXXXXXXXXXXXXXXXXXXXXXXXXXXXXXXX--XXXXXXXXXXXXX
