------------------------------------------------------------------------------------------------------------------------------------------------------
------------------------------------------------------------------------------------------------------------------------------------------------------
------------------------------------------------------------------------------------------------------------------------------------------------------
S-----SSSS--------------------------------------------------------------------------------------------------------------------------------------------
S-----------------------------------------------------------------------------------------------------------------------------------------------------
S-------------------------------------oo---------------oooo-------------------------------------------------------------------------------------------
S---------------------!------------SSSS----------------%%%%--------------------------SSSS--------------------------oo----------SSS--------------------
S-------------------------------------------------SSSS--||--------------------------------------------------------------------------------------------
S-------------------------------------------------------||---------------------g----------------------------------------------------------------------
S-------------------------------------------------------||----------------------------------------------------------------------K---------------------
S-------------------S@S!S-----%-------------------------||-------------------S@SQ------------------------------%%%%--%%%-------SSS------------#LSS----
S--------------------------------------------K---B----U-||-----------T--------------------------------TT--------||----||-------------TT-------#-------
S---------------------------tt-------------------b------||---B-------T--------------------------------TT----TT--||----||-TT----------TT-------#-------
S--M----------k-ggg--g------tt-------------------B------||---b-------T-----------ggg---------------g--TT-k--TTo-||----||-TT----------TT-----kk#-------
XXXXXXXXXXXXXXXXXXXXXXXXXXXXXX--%%%%--%%XXXXXXXXXX----%%%%%-XXXXXX--XX-XXXXXXXXXXXXXX----X-XXXXXXXXXXXXXXXXXXX%-||----||XXXXXXXXXXXXXXXXXXXXXXXXXXX---
XXXXXXXXXXXXXXXXXXXXXXXXXXXXXX---||----|XXXXXXXXXX-----|||--XXXXXX--XX-XXXXXXXXXXXXXX----X-XXXXXXXXXXXXXXXXXXX--||----||XXXXXXXXXXXXXXXXXXXXXXXXXXX---
