------------------------------------------------------------------------------------------------------------------------------------------------------
------------------------------------------------------------------------------------------------------------------------------------------------------
------------------------------------------------------------------------------------------------------------------------------------------------------
--------------------------------oo--------------------------------------------------------------------------------------------------------------------
-------------------------------------g-g--------------------------------------------------------------------------------------------------------------
----------------------ooor---------%%%%%--------------------------------------------------------------------------------------------------------------
------------------Q--%%%%%----------||||---------------------------------------------------------------------------oo-----SSC----------US-------------
----------------------|||-----------||||-------------------------------------------------------------------------------------------------------y------
----------------------|||-----------||||-----------------------------------------------------------------------------------------------------#SS--o---
----------------------|||-----%%%%%-||||-----------------o------------------------o---------------------------------------SSS--------SS-----##--------
------------------?-%%%%%%%----|||--||||-----------------------------------------------TT--------tt------------%%%%--%%%-------------------S##--SC----
--------------TT----||||||-----|||--||||-----------------------------------------------TT-T------tt-------------||----||--------------------##--------
--------------TT----||||||--o--|||--||||-----------------------------------------------TT-T------tt-------*-----||----||----------TT--------##---SSS--
---M----------TT----||||||-%%%-|||--||||-------y----k-------gg-------ggg---------------TT-T------tt-gg----*---o-||----||---------#TT--------##--------
XXXXXXXXXXXXXXXXXXXX||||||--|--|||--||||XXXXXXXXXX-XXXXXXXXXXXXXXXXXXXXXXXXXXXXXXXXXXXXXXXXXXXXXXXXXXXXXXXXXX-%-||----||X----XXXXXXXXXXX-X-XXX------XX
XXXXXXXXXXXXXXXXXXXX||||||--|--|||--||||XXXXXXXXXX-XXXXXXXXXXXXXXXXXXXXXXXXXXXXXXXXXXXXXXXXXXXXXXXXXXXXXXXXXX---||----||X----XXXXXXXXXXX-X-XXX------XX
