------------------------------------------------------------------------------------------------------------------------------------------------------
------------------------------------------------------------------------------------------------------------------------------------------------------
------------------------------------------------------------------------------------------------------------------------------------------------------
----------------------------------------------------------------------------------------------------------------------------------SSSSSSSSSS----------
------------------------------------------------------------------------------------------------------------------------------------------------------
----------------------ooor----------------------------------------------------------------------------------------------------------------------k-----
---------------------%%%%%-------------------------------------------------g---------------------------------R---------------------------------SQS--SQ
----------------------|||------------------------------------o---o---o-%%%%%%----------------------------r----------------------oo--------------------
-----------------%%%--|||--------------------------------B--%%%-%%%-%%--||||------TT----------------%%%%%%%-------------------------------------------
------------------||--|||--------------------------------b---|---|---|--||||------TT--------------oo||||||--------------------------------------------
-----SSS----------||%%%%%%%--------------TT---SU-------SS#CS-|---|---|--||||------TT----------------||||||-------------------TT----------------SQS--S?
-------------%%%%%||||||||---------------TT------------------|---|---|--||||------TT-----T-----TT---||||||-------------------TT-----------TT----------
--------------|||-||||||||--o------------TT----------------K-|---|---|--||||----T-TT-----T-----TT---||||||---------B---------TT----tt-----TT----------
--------------|||-||||||||-%%%----k-k----TT------k-----------|---|-r-|--||||----T-TT---k-T--y--TT---||||||--oo-----b-----y---TT----tt----kTT-k------gg
XXXXXXXXXXX---|||-||||||||--|-XXXXXXXXX-XXXXXXXXXXXXXXXXXXXX%%%%%%%%%%--||||----XXXXXXXXXXXXXXXXXXXX||||||--%%XXXXXXXXXXXXXXXXXXXXXXXXXXXXXXXXXXXXXXXX
XXXXXXXXXXX---|||-||||||||--|-XXXXXXXXX-XXXXXXXXXXXXXXXXXXXX-|||||||||--||||----XXXXXXXXXXXXXXXXXXXX||||||---|XXXXXXXXXXXXXXXXXXXXXXXXXXXXXXXXXXXXXXXX
