------------------------------------------------------------------------------------------------------------------------------------------------------
------------------------------------------------------------------------------------------------------------------------------------------------------
------------------------------------------------------------------------------------------------------------------------------------------------------
------------------------------------------------------------------------------------------SSSSSSSSSS--------------------------------------------------
------------------------------------------------------------------------------------------------------------------------------------------------------
----------------------ooor------------------------------------------------------K---------------------------------------------------------------------
---------------------%%%%%-------------------------------------------------g----SS----1----------------------@?SSS------------------------------------
----------------------|||------------------------------------o---o---o-%%%%%%-------------------------------------------------------------------------
----------------------|||--------------------------------TT-%%%-%%%-%%--||||---------------------------------------------------------g#---------------
----------------------|||--------------------------TT----TT--|---|---|--||||--------------------------------------------------------g##---------------
--------------------%%%%%%%------------------------TT----XX--|---|---|--||||----SS------------------SU----!--!SSSSS-----------------###-------#LSS----
--------------------||||||-------------T-----------TT--------|---|---|--||||----------TT--t----------------------------------------####-------#-------
--------------------||||||--o----------T-----------TT--------|---|---|--||||----------TT--t---------------------------------------#####-------#-------
-M------------k-ggg-||||||-%%%-------kkT-------ggg-TT--------|---|-r-|--||||----------TT--t---------------k-----K--------k----ggg-#####-----kk#-------
XXXXXXXXXXXXXXXXXXXX||||||--|-XXXXXXXXXX-XXXXXXXXXXXXXXXXXXX%%%%%%%%%%--||||----XXXXXXXXXXXXXXXXXXXXXXXXXXXXXXXXXXXXXXXXXXXXXXXXXXXXXXX--XXXXXXXXXX---
XXXXXXXXXXXXXXXXXXXX||||||--|-XXXXXXXXXX-XXXXXXXXXXXXXXXXXXX-|||||||||--||||----XXXXXXXXXXXXXXXXXXXXXXXXXXXXXXXXXXXXXXXXXXXXXXXXXXXXXXX--XXXXXXXXXX---
