------------------------------------------------------------------------------------------------------------------------------------------------------
------------------------------------------------------------------------------------------------------------------------------------------------------
------------------------------------------------------------------------------------------------------------------------------------------------------
------------------------------------------------------------------------------------------SSSSSSSSSS--------------------------------------------------
------------------------------------------------------------------------------------------------------------------------------------------------------
---------------------------------------------------------------------R--------------------------------------------------------------------------------
---------------------------------------------------------------------------g----------------------------------------------oo---%%%!S--------SS--------
-----------------------------------------------------------------------%%%%%%------------------------------------SSS------SS----||--------------------
------------------------------------------------------------------------||||----------------------------------------------------||--------------------
---------------------------------------------------------o--------------||||------o---------------------------------------------||--------------------
--------------------------------QQQQ-----------------------------%%%----||||-----------TT-------------%%%%%%-----------------SS-||S------#--SS--------
-------------------------------------K-B--------------------------|-----||||-----------TT-t------------||||---------------------||------##--------#-TT
---------------------------------------b--------------------------|-----||||-----------TT-t------------||||---------------------||-----###-------##-TT
-M--------k---ggg--------ggg-----------b----y-y-----k-------------|-----||||-----------TT-t------------||||---------------------||----####------###-TT
XXXXXXXXXXXXXXXXXXXXXXXXXXXXXXXXXXXXXXXXXXXXXXXXXX-XXXXXXXXX%%%%%-|-----||||----XXXXXXXXXXXXXXXXXXXX%%-||||-%%%%%%----%%%%-----%%%XXXXXXXXXXXXXXXXX-XX
XXXXXXXXXXXXXXXXXXXXXXXXXXXXXXXXXXXXXXXXXXXXXXXXXX-XXXXXXXXX-|||--|-----||||----XXXXXXXXXXXXXXXXXXXX|--||||--||||------||-------||XXXXXXXXXXXXXXXXX-XX
