------------------------------------------------------------------------------------------------------------------------------------------------------
------------------------------------------------------------------------------------------------------------------------------------------------------
------------------------------------------------------------------------------------------------------------------------------------------------------
----------------------------------------SSSSSSSSSS------------------------------SSSSSSSSSS------------------------------------------------------------
----------------------------------------SSSSSSSS------------------------------------------------------------------------------------------------------
----------------------------------------SSSCSSSS------------------------------------------------------------------------------------------------------
----------------------------------------SSSSSSSS------------------SSoo---------------------------------------R--------US-SSS----S!SS---------QQQQ-----
--------------------------------o----ooo----------------------------------------------------------oo-r------------------------------------------------
----------------------------------------------------------------------------------------------------%%%%%%%-------------------------------------------
-------------------------------------------ggg-----------------------------------------S------------||||||----------E--------------------------y------
----------------%%%%------------------%%SSSSSSSS------------%%%%%%--------------SU------------------||||||---------TT------------SSS--------Q?SSQQQ---
-----------------||--------------------|SSSSSSSS----K--------||||-------------------TT---t------#---||||||---------TT--t----------K---#----B----------
-----------------||--------------------|SSSSSSSS-------------||||-------------------TT---t------#---||||||---------TT--t--------------#----b----------
-----------------||------------%%%%%%%-|SSSSSSSS-----------g-||||-----gg-----------kTT--kt------#---||||||--oo--g--TT--t----gg-g-g----#----B----------
XXXXXXXXXXX--%%%%||%XXXXX--XXX--|||||--|XXXXXXXXXXXXXXXXXXXX-||||-----XXXXXXXXXXXXXXXXXXXXXXXXXXXXXX||||||--%%XXXXXXXXXXXXXXXXXXXXXXXXXXXXXXXX--XXXXXX
XXXXXXXXXXX---||-||-XXXXX--XXX--|||||--|XXXXXXXXXXXXXXXXXXXX-||||-----XXXXXXXXXXXXXXXXXXXXXXXXXXXXXX||||||---|XXXXXXXXXXXXXXXXXXXXXXXXXXXXXXXX--XXXXXX
