------------------------------------------------------------------------------------------------------------------------------------------------------
------------------------------------------------------------------------------------------------------------------------------------------------------
------------------------------------------------------------------------------------------------------------------------------------------------------
--------------------SSSSSSSSSS--------------------------------------------------------------------------------SS-------S------------------------------
--------------------SSSSSSSSSS------------------------------------------------------------------------------------------------------------------------
--------------------SSSSSSSSSS-------------------------oooo----------R--------------------------------------------------------------------------------
--------------------SSSSSSSSSS-------------------------%%%%--------------------------SSSS------------------------------S-SSS----S!--------------------
--------------------------------------------------------||----------------------------------------oo--------------------------------------------------
-----------------g--------------------------------------||---------------------------------------------------------SSS--------------------------------
-----------------#--------------------------------SSS---||--------------------------------------------------------------------------------------------
---------QS-----##----SSSSSS?---------------------------||-------%%%------------Q---------------------%%%%%%-----------S---------S------------#LSS----
---------------###----SSSSS-----------K---------------U-||--------|-----------------------------#------||||----##--------------------TT-------#-------
--------------####----SSSSS---TTTT----------------------||--------|-----------------------------#------||||----##--------------------TT-------#-------
-------------#####---------oooTTTT----------------------||--------|---gg---------ggg------------#------||||----##-----------gg-g-g---TT-----kk#-------
XXXXXXXXXXXXXXXXXXXX-XXXXXXXXXXXXXXXXXXXX-XX-XX-XX----%%%%%-%%%%%-|---XXXXXXXXXXXXXXX----XXXXXXXXXXX%%-||||-%%-XX------XXXXXXXXXXXXXXXXXXXXXXXXXXXX---
XXXXXXXXXXXXXXXXXXXX-XXXXXXXXXXXXXXXXXXXX-XX-XX-XX-----|||---|||--|---XXXXXXXXXXXXXXX----XXXXXXXXXXX|--||||--|-XX------XXXXXXXXXXXXXXXXXXXXXXXXXXXX---
