------------------------------------------------------------------------------------------------------------------------------------------------------
------------------------------------------------------------------------------------------------------------------------------------------------------
------------------------------------------------------------------------------------------------------------------------------------------------------
S-----SSSS------------------------------SSSSSSSSSSSSSSSSS---------------------------------------------------------------------------------------------
S-----------------------------------------------------------------------------------------------------------------------------------------------------
S-------------------------------------oo------------------------------------------g---------oo---------------------k----------------------------------
S-------------------USS------------SSSS--oooo-----QQ----------------------------SSSSSSSS----------------------S---SSSSSSSS----------------------------
S-----------------------------------------------------------------------------------------------------------------------------------------------------
S----------------------------------------SSSS-U------------S---------------------------------------%--------------------------------------------------
S---------------------------------------oS--SoS--------------------------1-------------------------------------------------TT-------------------------
S------------------%----------%---------SS--SSS---QQ--QQQ-------------T-------------------SS-------------------------------TT-------------------------
S--------------------B------------------------------------------------T----TT-------------------------TT----------------t--TT-------------------------
S--------------------b-------B----------------------------------------T----TT----------------%%%%-----TT----TTTT--------t--TT----------------------F--
S------------%%%%----B-------b------------kk-----------------y--------T---kTT-----------------||------TT-k--TTTT--------t--TT----------------------#--
XXXXXXXXXXX---||----XXXXXXXXXX--%%%%--%%XXXXXXXXXXXXXXXXX---XXXXXXXXXXXXXXXXXXXXXXXXXX---X----||----XXXXXXXXXXXXXXXXXX--XXXXXXXXXXXXXXXXXXXXXXXXXXXXXX
XXXXXXXXXXX---||----XXXXXXXXXX---||----|XXXXXXXXXXXXXXXXX---XXXXXXXXXXXXXXXXXXXXXXXXXX---X----||----XXXXXXXXXXXXXXXXXX--XXXXXXXXXXXXXXXXXXXXXXXXXXXXXX
