------------------------------------------------------------------------------------------------------------------------------------------------------
------------------------------------------------------------------------------------------------------------------------------------------------------
------------------------------------------------------------------------------------------------------------------------------------------------------
------------------------------SSSSSSSSSS----------------------------------------ooo-----------------SSSSSSSSSS----------------------------------------
--------------------------------------------------------------------------------%%%-------------------------------------------------------------------
----------------------------------------%%---------------------------R-----------|--------------------------------------------------------------------
----------------------------------------|----------------Q-Q---------------------|--------------------------------------------------------------------
----------------------------------------|----oo----------------------------------|------------------------------------------------oo------------------
-----------------g---------------------S|----------------------------------------|--------------------------------------------------------------------
-----------------#---------------------S|----------------------------------------|---%%%%-------------------------------------------------------------
----------S-----##---------------------S|----------------Q-Q-----%%%-------------|----||--------TT-----------T-----------------------------Q----------
---------------###-------------#--------|-------------------------|-------------%%%%%%||--------TT-----TT----T-#--------------------------------------
--------------####-------------#-#------|-------------------------|--------------||||-||--------TT-----TT----T-#-----------------------------------F--
-M-----------#####-------ggg---#-#------|-------------------------|---gg---------||||-||----k---TT--g--TT----T-#----ggg---kkk----------------------#--
XXXXXXXXXXXXXXXXXXXXXXXXXXXXXXXXXXXXXXXX|----%%%%-XXXXXXXXXX%%%%%-|---XXXXXXXXXX-||||-||%%XXXXXXXXXXXXXXXXXXXX-XXXXXXXXXXXXXXXXXXXXXXXXXXXXXXXXXXXXXXX
XXXXXXXXXXXXXXXXXXXXXXXXXXXXXXXXXXXXXXXX|-----||--XXXXXXXXXX-|||--|---XXXXXXXXXX-||||-||-|XXXXXXXXXXXXXXXXXXXX-XXXXXXXXXXXXXXXXXXXXXXXXXXXXXXXXXXXXXXX
