------------------------------------------------------------------------------------------------------------------------------------------------------
------------------------------------------------------------------------------------------------------------------------------------------------------
------------------------------------------------------------------------------------------------------------------------------------------------------
------------------------------------------------------------------------------------------------------------------------------------------------------
-----------------------------------------------------------------------------------------------------------------------------------------------------o
------------------------------------------------------------------------------------------------------------------------------------------------------
-----------------------------U---------------------------Q-Q--------------SSCSS-----y------------------------R----------SSS---------------------------
----------------------------------------------------------------------------------#SSS-------------------r--------------------------------------SSS---
---------------------------------------------------------------------o-----------##-----------------%%%%%%%---------------------------------oo--------
------------Q--?-------------------------------------------------y--------------###1-----------oooo-||||||--------------------------------------------
-------------------S--------##---------------------------Q-Q-----##-----QQQQ--QQ###-----------------||||||----------------------------------SS--------
-----------------------y-#####----------T-----TT----------------###-------------###--SSS------------||||||-----#--------------------------------------
--------------------y-######------------T-----TT---------------####-------------###-----------------||||||-----#--------------TT----------------------
-M----------------K-######--------k-k---T-----TT--------------#####-------------###-----------------||||||--oo-#----ggg-------TT--k-------------------
XXXXXXXXXXXXXXXXXXXXXXXX------XXXXXXXXX-XXXX--XXXXXXXXXXXXXXXXXXXXX---XXXXXXXXXXXXXXXX---X%%%%%%%-%%||||||--%%-XXXXXXXXX----XXXXXXXX---XXXXX----------
XXXXXXXXXXXXXXXXXXXXXXXX------XXXXXXXXX-XXXX--XXXXXXXXXXXXXXXXXXXXX---XXXXXXXXXXXXXXXX---X||||||---|||||||---|-XXXXXXXXX----XXXXXXXX---XXXXX----------
