------------------------------------------------------------------------------------------------------------------------------------------------------
------------------------------------------------------------------------------------------------------------------------------------------------------
------------------------------------------------------------------------------------------------------------------------------------------------------
--------------------SSSSSSSSSS--oo-----------------oo-----------------------------------------------------------------------------SSSSSSSSSS----------
---------------------------------------g----------%%%%------------------------------------------------------------------------------------------------
-----------------------------------%%%%%-----------||-------------------------------------------------------------------------------------------------
------------------------------------||||------QQQQ-||---------USSS---------1---------SUS---------------------R----------------------------------------
------------------------------------||||-----------||--SSS-------------------------------------------r----------oooo----------------------------------
------------------------------------||||-----------||-----------------------------------------------%%%%%%%-------------------------------------------
-----------------------------C%%%%%-||||--------k--||----------------------ggg--------------------oo||||||--------------------------------------------
-----------------------#-#-----|||--||||T-----?QQQ-||--------S-----TT-#########-----#####-----------||||||----T-----------------------------#---------
---------------------#-#-#-#---|||--||||T----------||--------------TT---------#-----#----------TT---||||||----T---------------------------TT##--------
---------------------#-#-#-#---|||--||||T---------%||--------------TT---------#----K#----------TT---||||||----T--------------------tt-----TT###------#
-M--------k---ggg----#-#-#-#-E-|||--||||T----------||--------ggg---TT---------#-----#-------y--TT---||||||--ooT---y-------kkk------tt----kTT####----##
XXXXXXXXXXXXXXXXXXXXXXXXXXXXXX-|||--||||XXXXXXXXXX-||-------XXXXXXXXXX--------X-XXXXXXX---XXXXXXXXXX||||||--%%XXXXXXXXXXXXXXXXXXXXXXXXXXXXXXXXXXXXXXXX
XXXXXXXXXXXXXXXXXXXXXXXXXXXXXX-|||--||||XXXXXXXXXX-||-------XXXXXXXXXX--------X-XXXXXXX---XXXXXXXXXX||||||---|XXXXXXXXXXXXXXXXXXXXXXXXXXXXXXXXXXXXXXXX
