------------------------------------------------------------------------------------------------------------------------------------------------------
------------------------------------------------------------------------------------------------------------------------------------------------------
------------------------------------------------------------------------------------------------------------------------------------------------------
------------------------------SSSSSSSSSSSSSSSSSSSS----------------------------------------------------------------------------------------------------
------------------------------SSSSSSSSSSSSSSSSSS--?---------------------------------------------------------------------------------------------------
------------------------------SSSSSSSSSSSSSCSSSS--------------g---------------------------------------------------------------------------------------
------------------------------SSSSSSSSSSSSSSSSSS--------------SSSSS--------g--------y-------------------------------------SSC---------------SS--------
--------------------------------------------------SS-------------------%%%%%%-----#SSS----------------------------------------------------------------
------------------------------------------------------------------------||||-----##-------------------------------------------------------------------
-------------------------------------------ggg--------------------------||||----###1--------------------------------------SSS-------------------------
------------------------------SSSSSSSSSSSSSSSSSS------------------------||||----###-------------TT------------------------------------------SS--------
------------------------------SSSSSSSSSSSSSSSSSS-------SSS--------------||||----###--SSS--------TT----------g-------------------------------------#-TT
------------------------------SSSSSSSSSSSSSSSSSS--------------TT-----t--||||----###-------------TT----------TT-----------------------------------##-TT
-M------------k-ggg-----------SSSSSSSSSSSSSSSSSS--------------TT-----t--||||----###---------k---TT----------TT-k----kkk----------#--------------###-TT
XXXXXXXXXXXXXXXXXXXXXXXXX--XXXXXXXXXXXXXXXXXXXXXXX----------XXXXXXXXXX--||||----XXXXXX---XXXXXXXXXXX--XXXXXXXXXXXXXXXXXXX----XXXXXXXXXXXXXXXXXXXXXX-XX
XXXXXXXXXXXXXXXXXXXXXXXXX--XXXXXXXXXXXXXXXXXXXXXXX----------XXXXXXXXXX--||||----XXXXXX---XXXXXXXXXXX--XXXXXXXXXXXXXXXXXXX----XXXXXXXXXXXXXXXXXXXXXX-XX
