------------------------------------------------------------------------------------------------------------------------------------------------------
------------------------------------------------------------------------------------------------------------------------------------------------------
------------------------------------------------------------------------------------------------------------------------------------------------------
--------------------------------------------------------------------------------------------------------------------------------------------SSSSSSSSSS
------------------------------------------------------------------------------------------------------------------------------------------------------
----------------------------------------------------------------------------------------------------oo------------------------------------------------
----------------------------------------------QQQQ-------------------------g------------------------%%%-----------------------------------------------
--------------------------------o----ooo-------------------------------%%%%%%-----------------------||--o----R--------------------oo------------------
------------------------------------------------------------------------||||------TT----------------||-%%%-------------------SSS----------------------
------------------------------------------------k---------------1-------||||------TT----------------||--|---------------------------------------------
-------------------%SS----------------%%T-----?QQQ-----ooo--------------||||------TT----------------||--|-------------r-r------------------Q--TT------
---------------------K---TT------------|T-------------------------------||||------TT-----T----------||-o|---------%%%%%%%%%%%%----------------TT------
-------------------------TT------------|T-------------------------------||||----T-TT-----T-------B--||%%%%%--------||||||||||-----------------TT------
-M-----------%%%%--------TT----%%%%%%%-|T-------------------------------||||----T-TT---k-T-------b--||-|||---------||||||||||-----------------TT------
XXXXXXXXXXX---||----XXXXXXXXXX--|||||--|XXXXXXXXXX--XXXXXXXXXXXXXXXXX---||||----XXXXXXXXXXXXXXXXXXXX||-|||-----%%%-||||||||||-----XXXXXXXXXXXXXX--XXXX
XXXXXXXXXXX---||----XXXXXXXXXX--|||||--|XXXXXXXXXX--XXXXXXXXXXXXXXXXX---||||----XXXXXXXXXXXXXXXXXXXX||-|||------|--||||||||||-----XXXXXXXXXXXXXX--XXXX
