------------------------------------------------------------------------------------------------------------------------------------------------------
------------------------------------------------------------------------------------------------------------------------------------------------------
------------------------------------------------------------------------------------------------------------------------------------------------------
------------------------------------------------------------SSSSSSSSSSSSSSSSSSSS--------------------SSSSSSSSSS----------------------------------------
------------------------------------------------------------SSSS--SSSS--------------------------------------------------------------------------------
-------------------------------------------------------oooo-SSSS--SSSS--------------------------------------------------------------------------------
-----------------------------U----------------QQQQ-----%%%%---SS---S----------------y------------------------------------SSS----S!-------##-----------
--------------------------------------------------------||----SS---S----------TT--#SSS---------------------------------------------------##-----------
--------------------------------------------------------||----SS---S----------TT-##----------------------------------------------------####-----------
-----------------------------------oo-----------k-SSS---||--ooSS---SoU--------TT###1--------------oo-----------------------------------####-----------
----------------------------##----o--o--T-----?QQQ------||--SSSS---SSS------SCTT###--------------------------T-------------------S---######-----------
-----------------------y-#####----------T-------------U-||--------------TT----TT###--SSS-------TT------TT----T-----------------------######-----------
--------------------y-######------------T---------------||--------------TT----TT###------------TT------TT----T-----------------------######--------F--
--------------k-ggg-######--------------T---------------||--k--g-g------TT---kTT###---------y--TT---g--TT----T-k----kkk-----gg-g-g---######--------#--
XXXXXXXXXXXXXXXXXXXXXXXX------XXXXXXXXXXXXXXXXXXXX----%%%%%-XXXXXXXXXXXXXXXXXXXXXXXXXX---XXXXXXXXXXXXXXXXXXXXXXXXXXXXXXXXXXXXXXXXXXXXXXXXXXXXXXXXXXXXX
XXXXXXXXXXXXXXXXXXXXXXXX------XXXXXXXXXXXXXXXXXXXX-----|||--XXXXXXXXXXXXXXXXXXXXXXXXXX---XXXXXXXXXXXXXXXXXXXXXXXXXXXXXXXXXXXXXXXXXXXXXXXXXXXXXXXXXXXXX
