------------------------------------------------------------------------------------------------------------------------------------------------------
------------------------------------------------------------------------------------------------------------------------------------------------------
------------------------------------------------------------------------------------------------------------------------------------------------------
S-----SSSS-------------oo---------------SSSSSSSSSS------------------------------ooo-----------------------------------------------SSSSSSSS------------
S-------------------------------------------------------------------------------%%%-------------------------------------------------------------------
S------------------------------------------------------oooo---g------------------|----------oo--------------------------------------------------------
S---------------------SSSS---------------oooo----------%%%%---SSSSS--------------|----------------------------------------------------------SS--------
S-------------------------------------------------SSSS--||-----------------------|------------------oo------------------------------------------------
S----------------------------------------SSSS-U---------||---------------------g-|-----------------%--------------------------------------------------
S---------------------------------------oS--SoS---------||-----------------------|---%%%%-------------------------------------------------------------
S-------------------------%%%%----------SS--SSS---------||-------------------S@S-|----||--S------------------T--!-----S----------------g##--SS--------
S--------------------------|||------------------------U-||----------------------%%%%%%||---------------------T-------------------------###--------#-TT
S--------------------------|||--------------------------||----TT-----t-----------||||-||-----%%%%------------T-----------------------g####-------##-TT
S--M------k---ggg----------|||----k-k-----kk------------||----TT-----t-----------||||-||------||----------y--T-----------k----ggg----#####------###-TT
XXXXXXXXXXXXXXXXXXXX%%%----|||XXXXXXXXX-XXXXXXXXXX----%%%%%-XXXXXXXXXX-XXXXXXXXX-||||-||%%----||----XXXXXXXXXXXXXXXXXXXXXXXXXXXXXXXXXXXXXX--XXXXXXX-XX
XXXXXXXXXXXXXXXXXXXX||-----|||XXXXXXXXX-XXXXXXXXXX-----|||--XXXXXXXXXX-XXXXXXXXX-||||-||-|----||----XXXXXXXXXXXXXXXXXXXXXXXXXXXXXXXXXXXXXX--XXXXXXX-XX
