------------------------------------------------------------------------------------------------------------------------------------------------------
------------------------------------------------------------------------------------------------------------------------------------------------------
------------------------------------------------------------------------------------------------------------------------------------------------------
--------------------------------oo--------------------------------------------------------------------------------------SSSSSSSSSS----------SSSSSSSSSS
-------------------------------------g-g--------------------------------------------------------------------------------------------------------------
----------------------ooor---------%%%%%------------------------------------------g-------------------------------------------------------------------
---------------------%%%%%----------||||----------------------------------------SSSSSSSS---------------------------oo--------------------##-----------
----------------------|||-----------||||---------------------o---o---o-------------------------------------------------------------------##-----------
----------------------|||-----------||||--------------------%%%-%%%-%%-----------------------------------------------------------------####-----------
----------------------|||-----%%%%%-||||---------------------|---|---|---------------------o-------------------------------------------####-----------
----------Q---------%%%%%%%----|||--||||-----------------tt--|---|---|---------------------------TT------------%%%%--%%%-------------######---TT------
--------------------||||||-----|||--||||-----------------tt--|---|---|---------------------------TT---TT--------||----||--SS---------######---TT------
--------------------||||||--o--|||--||||-----------------tt--|---|---|---------------------------TT---TT----TT--||----||--SS---------######---TT------
-M-----------------#||||||-%%%-|||--||||-------ggg---g-g-tt--|---|-r-|---------------------------TT---TT-k--TTo-||----||--SS---------######---TT------
XXXXXXXXXXXXX--XXXXX||||||--|--|||--||||-XXXXXXXXXXXXXXXXXXX%%%%%%%%%%X----XXXXXXXXXXX---XXXXXXXXXXXXXXXXXXXXX%-||----||--XX--XXXXXXXXXXXXXXXXXX--XXXX
XXXXXXXXXXXXX--XXXXX||||||--|--|||--||||-XXXXXXXXXXXXXXXXXXX-|||||||||X----XXXXXXXXXXX---XXXXXXXXXXXXXXXXXXXXX--||----||--XX--XXXXXXXXXXXXXXXXXX--XXXX
