------------------------------------------------------------------------------------------------------------------------------------------------------
------------------------------------------------------------------------------------------------------------------------------------------------------
------------------------------------------------------------------------------------------------------------------------------------------------------
------------------------------SSSSSSSSSS--------------------------------------------------------------------------------------------------------------
------------------------------------------------------------------------------------------------------------------------------------------------------
-----------------------SSS-------------------------------------------R--------------------------------------------------------------------------------
------------------------------------------------------------------------SSSSS---------------------------------?SSS-----------------SSSS------------SSS
---------------------g--------------------------------------------------------------------------------------------------------------------------------
--------------------%%%----------------S-----------------B--------------------------------------------------------------------SSS---------------------
--------------------||----SSS----------S-----------------b------------------------o---------------oo-----------------------------------SSSS-----------
--------------------||-----------------S---------------SS#CS-----%%%---------2---------TT---------------------SSSSS-----%-------------------------#---
--------------------||---------#-------------K---B----------------|--------TT----------TT------TT-----------g-------------------------------------#---
--------------------||---------#-#---------------b---------K------|---t----TT--T-------TT------TT-----------TT------------------------------------#---
-M------------k-ggg-||----oo---#-#---------------B----------------|---t----TT--T-------TT---y--TT-----------TT--K----------------r-----------ggg--#---
XXXXXXXXXXXXXXXXXXXX||---%%%--XXXXXXXXXXXXXXXXXXXXXXXXXXXXXX%%%%%-|---XXXXXXXXXXXXXXXXXXXXXXXXXXXXXX--XXXXXXXXXXXXXXXXXX----XXXXXX---------XXXXXXXXXXX
XXXXXXXXXXXXXXXXXXXX||----|---XXXXXXXXXXXXXXXXXXXXXXXXXXXXXX-|||--|---XXXXXXXXXXXXXXXXXXXXXXXXXXXXXX--XXXXXXXXXXXXXXXXXX----XXXXXX---------XXXXXXXXXXX
