------------------------------------------------------------------------------------------------------------------------------------------------------
------------------------------------------------------------------------------------------------------------------------------------------------------
------------------------------------------------------------------------------------------------------------------------------------------------------
--------------------SSSSSSSSSS--oo--------------------------------------------------------------------------------------------------------------------
--------------------SSSSSSSSSS---------g----?---------------------------------------------------------------------------------------------------------
--------------------SSSSSSSSSS-----%%%%%--------------------------------------------------------------------------------------------------------------
--------------------SSSSSSSSSS------||||------------------------------------------------------------------2-------------------------------------------
------------------------------------||||------r-------------------------------------------------------------------------------------------------------
------------------------------------||||--%%%%%%------------------------------------------------------------------------------SSS---------------------
------------------------------%%%%%-||||---||||--------------------------1--------o--------o--------o-------------------------------------------------
-----SSS--------%%%%--SSSSSS?--|||--||||%%-||||ooo-----ooo-----------#T----------------TT--------TT-------2-----------r-%-----------------------------
-----------------||---SSSSS----|||--|||||--||||--r------------------##T----TT----------TT--------TT---------------%%%%%%------------------------------
-----------------||---SSSSS----|||--|||||%%%%%%%%%----------TT-----###T----TT----------TT--------TT----------------|||||---------------------------F--
-----------------||--------ooo-|||--|||||-||||||||----------TT----####T---kTT----------TT--------TT-----y--y-------|||||---------rk----------------#--
XXXXXXXXXXX--%%%%||%-XXXXXXXXX-|||--|||||-||||||||--XXXXXXXXXXXXXXXXXXXXXXXXXXXXXXXXXXXXXXXXXXXXXXXXXXXXXXXXXX-%%%-|||||----XXXXXXXX---XXXXXXXXXXXXXXX
XXXXXXXXXXX---||-||--XXXXXXXXX-|||--|||||-||||||||--XXXXXXXXXXXXXXXXXXXXXXXXXXXXXXXXXXXXXXXXXXXXXXXXXXXXXXXXXX--|--|||||----XXXXXXXX---XXXXXXXXXXXXXXX
