------------------------------------------------------------------------------------------------------------------------------------------------------
------------------------------------------------------------------------------------------------------------------------------------------------------
------------------------------------------------------------------------------------------------------------------------------------------------------
S-----SSSS------------------------------SSSSSSSSSS-oo---------------------------SSSSSSSSSS----------------------------------------SSSSSSSSSS----------
S---------------------------------------SSSSSSSS--%%%%------------------------------------------------------------------------------------------------
S---------------------ooor--------------SSSCSSSS---||---------g-----------------------------oo--------------------------------------------------------
S--------------------%%%%%--------------SSSSSSSS---||---------SSSSS-------SSCSS--------------------------------------------------------------QQQQ-----
S---------------------|||--------------------------||--SSS------------------------------------------oo----------oooo----------------------------------
S----------------%%%--|||--------------------------||----------------------------------------------%--------------------------------------------------
S-----------------||--|||------------------ggg-----||----------------------------------S-------------------------------------------------------y------
S-----------------||%%%%%%%-------------SSSSSSSS---||-------------------QQQQ--QQSU--------SS-----------------TT-----------------------------Q?SSQQQ---
S------------%%%%%||||||||------------ttSSSSSSSS---||-------------------------------TT---t-------------------TT---------------------------TT----------
S-------------|||-||||||||--o---------ttSSSSSSSS--%||---------TT-----t--------------TT---t---%%%%------------TT--------------------tt-----TT----------
S--M----------|||-||||||||-%%%--------ttSSSSSSSS---||---------TT-----t-------------kTT--kt----||----------y--TT---y------k----ggg--tt----kTT----------
XXXXXXXXXXX---|||-||||||||--|-XXXXXXXXXXXXXXXXXXXX-||-------XXXXXXXXXXXXXXXXXXXXXXXXXXXXXX----||----XXXXXXXXXXXXXXXXXXXXXXXXXXXXXXXXXXXXXXXXXX--XXXXXX
XXXXXXXXXXX---|||-||||||||--|-XXXXXXXXXXXXXXXXXXXX-||-------XXXXXXXXXXXXXXXXXXXXXXXXXXXXXX----||----XXXXXXXXXXXXXXXXXXXXXXXXXXXXXXXXXXXXXXXXXX--XXXXXX
