------------------------------------------------------------------------------------------------------------------------------------------------------
------------------------------------------------------------------------------------------------------------------------------------------------------
------------------------------------------------------------------------------------------------------------------------------------------------------
------------------------------------------------------------------------------------------SSSSSSSSSSSSSSSSSSSS----------------------------------U-----
------------------------------------------------------------------------------------------------------------------------------------------------------
---------------------------------------------------------------------R----------K---------------------------------------------------------------------
--------------------------------------------------Q-----------------------SSCSS-SS----1---------------------------------------------------------------
--------------------------------------------------------------------------------------------------------------------------------------------------SS--
------------------------------------------------------------------------------------------------------------------------------------------------------
----------------------------------------------------------------------------------------------------------------------------------------------SS------
---------Q----------------------------------------Q--------------%%%----QQQQ--QQSS---------------------------T---------------------------------------#
-----------------K--------------------tt--------------------------|-------------------TT--t------------TT----T--------------------------------------##
------------B-------------------------tt--------------------------|-------------------TT--t------------TT----T-----B-------------------------------###
------------b-------------------------tt-------y-----gg----k------|-------------------TT--t---------g--TT----T-----b------kkk---------------------####
XXXXXXXXXXXXXXXXXXXXXXXXX--XXXXXXXXXXXXXXXXXXXXXXXXXXXXXXXXX%%%%%-|---XXXXXXXXXXXXXXXXXXXXXXXXXXXXXXXXXXXXXXXXXXXXXXXXXXXXXXXXXXXXXXXXXXXXXXXXXXX-XXXX
XXXXXXXXXXXXXXXXXXXXXXXXX--XXXXXXXXXXXXXXXXXXXXXXXXXXXXXXXXX-|||--|---XXXXXXXXXXXXXXXXXXXXXXXXXXXXXXXXXXXXXXXXXXXXXXXXXXXXXXXXXXXXXXXXXXXXXXXXXXX-XXXX
