------------------------------------------------------------------------------------------------------------------------------------------------------
------------------------------------------------------------------------------------------------------------------------------------------------------
------------------------------------------------------------------------------------------------------------------------------------------------------
--------------------------------oo----------------SSSSSSSSSS--------------------------------------------------SSSSSSSSSS------------------------U-----
---------------------------------------g--------------SS--SS------------------------------------------------------------------------------------------
-----------------------------------%%%%%ooooo---------SS--SS------------------------------------------------------------------------------------------
--------------------S---------------||||------------SS--------------------SS---------SUS----------------------------------SSC-----%-------------------
---------------------------TT-------||||--------SS--SS--------------------------------------------------------------------------------------------SS--
-----------------g---------TT-------||||-SSSS-------SS----------------------------------------------------------------------------------SSS-----------
-----------------#---------XX-%%%%%-||||------------SS----oo--------------------------------------------------------------SSS-----------------SS------
---------QS-----##-----TT------|||--||||------------SSSS--SS---------#SS-----SS-----#####--------tt-----------T-------------------%%%%%--------------#
---------------###-----TT------|||--||||--------------SS------------##--------------#-----T------tt-----------T--------------------|||--------------##
--------------####-----TT------|||--||||----%%%%%-----SS----TT-----###-------------K#-----T------tt-------*---T----TT--------------|||-------------###
-------------#####--k--TT------|||--||||-----|||------------TT----####--------------#-----T------tt-gg----*---T--g-TT------------#-|||------------####
XXXXXXXXXXXXXXXXXXXXXXXXXXXXXX-|||--||||%%---|||--XXXXXXXXXXXXXXXXXXXX----------XXXXXXX---XXXXXXXXXXXXXXXXXXX-XXXXXXXXXXX----XXXXX%|||------XXXXX-XXXX
XXXXXXXXXXXXXXXXXXXXXXXXXXXXXX-|||--|||||----|||--XXXXXXXXXXXXXXXXXXXX----------XXXXXXX---XXXXXXXXXXXXXXXXXXX-XXXXXXXXXXX----XXXXX-|||------XXXXX-XXXX
