------------------------------------------------------------------------------------------------------------------------------------------------------
------------------------------------------------------------------------------------------------------------------------------------------------------
------------------------------------------------------------------------------------------------------------------------------------------------------
----------SSSSSSSSSS----------------------------------------------------------------------------------------------------------------------------------
------------------------------------------------------------------------------------------------------------------------------------------------------
----------------------ooor----------------------------------------------------------------------------------------------------------------------------
---------------------%%%%%------------------------Q-----------------------SS-------USS----------------------------------SS---------------##-SSS-------
----------------------|||------------------------------------o---o---o-------------------------------------------------------------------##-----------
----------------------|||-----------------------------------%%%-%%%-%%-------------------------------------------------y---------------####-----------
----------------------|||----------oo------------------------|---|---|----------------------------oo-------------------X---TT----------####------SSSSS
---------Q----------%%%%%%%-------o--o------------Q----------|---|---|SS-----SS---#-------------------%%%%%%----------XX---TT--------######-----------
--------------------||||||-----------------------------------|---|---|------------#------------TT------||||----------XXXt--TT--------######-----------
--------------------||||||--o--------------------------------|---|---|------------##-----------TT------||||---------XXXXt--TT--------######-SSS-------
--------------------||||||-%%%-----------------------gg----k-|---|-r-|------------##--gg----y--TT------||||--------XXXXXt--TT--------######--------r--
XXXXXXXXXXX--XX--X--||||||--|-XXXXXXXXXXX-XX-XX-XXXXXXXXXXXX%%%%%%%%%%------------XXXXXXXXXXXXXXXXXX%%-||||-%%XXXXXXXXXXXXXXXXXXXXXXXXXXXXXX-----XXXXX
XXXXXXXXXXX--XX--X--||||||--|-XXXXXXXXXXX-XX-XX-XXXXXXXXXXXX-|||||||||------------XXXXXXXXXXXXXXXXXX|--||||--|XXXXXXXXXXXXXXXXXXXXXXXXXXXXXX-----XXXXX
