------------------------------------------------------------------------------------------------------------------------------------------------------
------------------------------------------------------------------------------------------------------------------------------------------------------
------------------------------------------------------------------------------------------------------------------------------------------------------
------------------------------SSSSSSSSSS----------------------------------------------------------------------------------------------------SSSSSSSSSS
------------------------------SSSSSSSSSS--------------------------------------------------------------------------------------------------------------
------------------------------SSSSSSSSSS--------------------------------------------------------------------------------------------------------------
------------------------------SSSSSSSSSS---------------------------------------------SUS---------------------R-----oo------------------US-------------
-----------------------------------------------------------------------------------------------------r------------------------------------------------
----------------------------------------------------------------------------------------------------%%%%%%%-------------------------------------------
----------------------------------------------------------------------------------------------------||||||---------------------------SS---------------
---------QQ-------------------SSSSSSSSSS-----------------------------#--------------#####-----------||||||-----%%%%--%%%-------------------S--TT------
------------------------------SSSSSSSSSST-----TT----K---------------##--------------#---------------||||||------||----||----------------------TT------
------------------------------SSSSSSSSSST-----TT------------TT-----###-------------K#---------------||||||------||----||----------TT----------TT------
-M-----------------#----------SSSSSSSSSST-----TT-----------gTT----####--------------#--------------g||||||--ooo-||----||--kkk-----TT----------TT------
XXXXXXXXXXXXX--XXXXXXXXXX--XXXXXXXXXXXXXXXXX--XXXXXXXXXXXXXXXXXXXXXXXXX----XXXXXXXXXXXX----XXXXXXXXX||||||--%%%-||----||XXXXXXXXXXXXXXXX-X-XXXXX--XXXX
XXXXXXXXXXXXX--XXXXXXXXXX--XXXXXXXXXXXXXXXXX--XXXXXXXXXXXXXXXXXXXXXXXXX----XXXXXXXXXXXX----XXXXXXXXX||||||---|--||----||XXXXXXXXXXXXXXXX-X-XXXXX--XXXX
