------------------------------------------------------------------------------------------------------------------------------------------------------
------------------------------------------------------------------------------------------------------------------------------------------------------
------------------------------------------------------------------------------------------------------------------------------------------------------
------------------------------------------------------------------------------------------------------------------------------------------------------
------------------------------------------------------------------------------------------------------------------------------------------------------
-------------------------------------------------------oooo-----------------------g-------------------------------------------------------------------
------------------SC-LSSS------------------------------%%%%---------------------SSSSSSSS---------------------@-----------SSS----S!--------------------
--------------------------------------------------------||------------------------------------------------------------------------oo------------------
--------------------------------------------------------||-------------------------------------------------------------y------------------------------
--------------------------------------------------SSS---||-------------------------------------------------------------X------------------------------
-----SSS------TT---2-2-----#----------------------------||------------------------------------------SU----!--!--------XX---------S---------Q#---------
--------------TT-----------#--------------------------U-||-----------------------------------------------------------XXX--------------------##--------
--------------TT-----------##---------------------------||---------------------------------------B------------------XXXX--------------------###------#
--------------TT------kk---##-----k-k-------------------||---y-----------------------------------b--------k--------XXXXX----gg-g-g----------####----##
XXXXXXXXXXXXXXXXXXXXXXXXXXXXXXXXXXXXXXX-X-XX-XX-XX----%%%%%-XXXXXXXXXXX----XXXXXXXXXXX---XXXXXXXXXXXXXXXXXXXXXXXXXXXXXXXXXXXXXXXXXXXXXXXXXXXXXXXXXXXXX
XXXXXXXXXXXXXXXXXXXXXXXXXXXXXXXXXXXXXXX-X-XX-XX-XX-----|||--XXXXXXXXXXX----XXXXXXXXXXX---XXXXXXXXXXXXXXXXXXXXXXXXXXXXXXXXXXXXXXXXXXXXXXXXXXXXXXXXXXXXX
