------------------------------------------------------------------------------------------------------------------------------------------------------
------------------------------------------------------------------------------------------------------------------------------------------------------
------------------------------------------------------------------------------------------------------------------------------------------------------
------------------------------------------------------------------------------------------------------------------------------------------------------
--------------------------------------------------?---------------------------------------------------------------------------------------------------
----------------------ooor----------------------------------------------------------------------------------------------------------------------------
---------------------%%%%%---------------------------------------------------------USS-----------------------------oo------------------US----QQQQ-----
----------------------|||-------------------------SS--------------------------------------------------------------------------------------------------
----------------------|||------------------------------------------------------g----------------------------------------------------------------------
----------------------|||------------------------------------------------------------------------------------------------------------SS--------y------
----------------!---%%%%%%%------------------------------------------T-------S@S--#-------------------%%%%%%---%%%%--%%%-------------------SQ?SSQQQ---
--------------------||||||-------------T-----K---B-----SSS-----------T------------#--------------------||||-----||----||------------------------------
--------------------||||||--o----------T---------b-------------------T------------##-------------B-----||||-----||----||----------TT------------------
---M----------------||||||-%%%-------kkT---------B------------ggg----T------------##--gg---------b-----||||---o-||----||-k----ggg-TT------------------
XXXXXXXXXXXXXXXXXXXX||||||--|-XXXXXXXXXXXXXXXXXXXX----------XXXXXXXXXX-XXXXXXXXX--XXXXXXXXXXXXXXXXXX%%-||||-%%%-||----||XXXXXXXXXXXXXXXX-X-XXX--XXXXXX
XXXXXXXXXXXXXXXXXXXX||||||--|-XXXXXXXXXXXXXXXXXXXX----------XXXXXXXXXX-XXXXXXXXX--XXXXXXXXXXXXXXXXXX|--||||--|--||----||XXXXXXXXXXXXXXXX-X-XXX--XXXXXX
