------------------------------------------------------------------------------------------------------------------------------------------------------
------------------------------------------------------------------------------------------------------------------------------------------------------
------------------------------------------------------------------------------------------------------------------------------------------------------
----------SSSSSSSSSS----------------------------------------------------------------------------------------------------SSSSSSSSSS--------------------
-------------------------------------------------------------------------o----------------------------------------------------------------------------
------------------------------------------------------------------------%%%-----K---------------------------------------------------------------------
------------------------------------------------------------------SSoo---|--o---SS----1----------------------------oo------------------US-------------
-------------------------------------------------------------------------|--SSSS--------------------------TT------------------------------------------
----------------------------------------------------------------------%--|--------------------------------TT------------------------------------------
---------------------------------------------------------o---------------|--------------------------------TT-------------------------SS---------------
---------------------------------------T--------------------%%%%%%-------|------SS--------------TT-------SXXS--%%%%--%%%-------------------S--#LSS----
---------------------------------------TT-----TT-------------||||--------|------------TT--------TT--------------||----||--SS------------------#-------
---------------------------------------TT-----TT-------------||||--------|-----%------TT--------TT--TT----------||----||--SS------TT----------#-------
-------------------------ggg----gg-----TT-----TT----k--------||||--------|------------TT----k---TT--TT--------o-||----||--SS------TT--------kk#-------
XXXXXXXXXXX--XX--X--XXXXXXXXXXXXXXXXXXXXXXXX--XXXX-XXXXXXXXX-||||-----%%%%%%----XXXXXXXXXXXXXXXXXXXXXXXXXXXXXX%-||----||--XX--XXXXXXXXXX-X-XXXXXXXX---
XXXXXXXXXXX--XX--X--XXXXXXXXXXXXXXXXXXXXXXXX--XXXX-XXXXXXXXX-||||-----|||||-----XXXXXXXXXXXXXXXXXXXXXXXXXXXXXX--||----||--XX--XXXXXXXXXX-X-XXXXXXXX---
