------------------------------------------------------------------------------------------------------------------------------------------------------
------------------------------------------------------------------------------------------------------------------------------------------------------
------------------------------------------------------------------------------------------------------------------------------------------------------
S-----SSSS----------SSSSSSSSSS--oo----------------------------------------------SSSSSSSSSS----------SSSSSSSSSS--------------------SSSSSSSS------------
S-------------------SSSSSSSSSS---------g--------------------------------------------------------------------------------------------------------------
S-------------------SSSSSSSSSS-----%%%%%--------------------------------------------------------------------------------------------------------------
S-------------------SSSSSSSSSS------||||--------------------------------SSSSS---------------------------------------------oo---%%%--------------------
S-----------------------------------||||----------------------------------------------------------oo------------oooo------SS----||--------------------
S-----------------------------------||||-----------------TT---------------------------------------------------------------------||--------------------
S-----------Q--?--------------%%%%%-||||-----------TT----TT----------------------------S----------------------------------------||--------------------
S------------------S--SSSSSS?--|||--||||-----------TT----XX------------------2--SU---------------------------TT--------------SS-||-----g##------------
S---------------------SSSSS----|||--||||T-----TT---TT----------------------TT-------TT---t------#------TT----TT-----------------||-----###------------
S---------------------SSSSS----|||--||||T-----TT---TT-----------------t----TT--T----TT---t------#------TT----TT-----------------||---g####---------F--
S--M--------------K--------ooo-|||--||||T-----TT---TT-------gg-------gt----TT--T---kTT--kt------#---g--TT----TT---y-------------||---#####---------#--
XXXXXXXXXXXXXXXXXXXX-XXXXXXXXX-|||--||||XXXX--XXXXXXXXXXXXXXXXXXXXXXXXXXXXXXXXXXXXXXXXXXXXXXXXXXXXXXXXXXXXXXXXXXXXXXXXXX%%-----%%%XXXXXXXX--XXXXXXXXXX
XXXXXXXXXXXXXXXXXXXX-XXXXXXXXX-|||--||||XXXX--XXXXXXXXXXXXXXXXXXXXXXXXXXXXXXXXXXXXXXXXXXXXXXXXXXXXXXXXXXXXXXXXXXXXXXXXXX|-------||XXXXXXXX--XXXXXXXXXX
