------------------------------------------------------------------------------------------------------------------------------------------------------
------------------------------------------------------------------------------------------------------------------------------------------------------
------------------------------------------------------------------------------------------------------------------------------------------------------
S-----SSSS--------------------------------------------------------------------------------SSSSSSSSSS--------------------------------------------------
S-----------------------------------------------------------------------------------------------------------------------------------------------------
S---------------------------------------------------------------------------------------oo------------------------------------------------------------
S-------------------------------------------------------------------------------oo---------------------------@---------------------------##-SS--------
S----------------------------------------------------------------------------------------------------------------SSS---------------------##-----------
S--------------------------------------------------------B--------------------------------------------------------------------SSS------####-----------
S--------------------------------------------------------b---------------1-------SS----------------------------------------------------####-----------
S------------------------------------------------------SS#CS----------T------------------S----------SU----!--!----------%------------######-SS--------
S---------------------------------------T-----TT----------------------T----TT--------------------------------------------------------######-------#-TT
S---------------------------------------T-----TT-----------K----------T----TT--------------------------------------------------------######------##-TT
S---------k---ggg-----------------k-k---T-----TT-------------y--------T---kTT-------------------g-g-------k----------------------r---######-----###-TT
XXXXXXXXXXXXXXXXXXXXXXXXX--XXXXXXXXXXXX-XXXX--XXXXXXXXXXXXXXXXXXXXXXXXXXXXXXXXXX----------XXXXXXXXXXXXXXXXXXXX%%%%----%%----XXXXXXXXXXXXXXXXXXXXXXX-XX
XXXXXXXXXXXXXXXXXXXXXXXXX--XXXXXXXXXXXX-XXXX--XXXXXXXXXXXXXXXXXXXXXXXXXXXXXXXXXX----------XXXXXXXXXXXXXXXXXXXX|||------|----XXXXXXXXXXXXXXXXXXXXXXX-XX
