------------------------------------------------------------------------------------------------------------------------------------------------------
------------------------------------------------------------------------------------------------------------------------------------------------------
------------------------------------------------------------------------------------------------------------------------------------------------------
S-----SSSS------------------------------------------------------------SSSSSSSSSS------------------------------------------------------------SSSSSSSSSS
S---------------------------------------------------------------------------SSSS----------------------------------------------------------------------
S------------------------------------------------------oooo--------------g--SSSSK---------------------oo----------------------------------------------
S---------------------!-----------------------QQQQ-----%%%%-------------SS------SS----1----------------------------oo---SS---------------##-----------
S-------------------------------------------------------||--------------SS---------------------------------------------------------------##-----------
S----------------%%%------------------------------------||-----------o--SS-------------------------------------------------------------####-----------
S-----------------||----------------------------k-SSS---||-------y------SC--g-g--------------------------------------------TT----------####-----------
S-----------------||S@S!S---------------T-----?QQQ------||-------##-----SS--SSSSSS-----------------------------%%%%--%%%---TT--------######---TT------
S------------%%%%%||------------------K-T-------------U-||------###-------------------TT------------------------||----||t--TT--------######---TT------
S-------------|||-||--------ttTTTT------T---------------||-----####-------------------TT---------B----------tt--||----||t--TT--------######---TT------
S--M----------|||-||-g------ttTTTT------T---------------||----#####-------------------TT---------b----ggg---tto-||----||t--TT--------######---TT------
XXXXXXXXXXX---|||-||XXXXXXXXXXXXXXXXXXXXXXXXXXXXXX----%%%%%-XXXXXXX---XXXXXXXXXXXXXXXXXXXXXXXXXXXXXXXXXXXXXXXX%-||----||XXXXXXXXXXXXXXXXXXXXXXXX--XXXX
XXXXXXXXXXX---|||-||XXXXXXXXXXXXXXXXXXXXXXXXXXXXXX-----|||--XXXXXXX---XXXXXXXXXXXXXXXXXXXXXXXXXXXXXXXXXXXXXXXX--||----||XXXXXXXXXXXXXXXXXXXXXXXX--XXXX
