------------------------------------------------------------------------------------------------------------------------------------------------------
------------------------------------------------------------------------------------------------------------------------------------------------------
------------------------------------------------------------------------------------------------------------------------------------------------------
--------------------------------------------------------------------------------SSSSSSSSSL------------------------------------------------------U-----
--------------------------------------------------?---------------------------------------------------------------------------------------------------
------------------------------------------------------------------------------------------------------------------------------------------------------
-----------------------------U------------------------------------------------------oooooo-------------------@----------SS--------%-------------------
--------------------------------------------------SS----------------------------------------------------------------------------------------------SS--
---------------------------------------------------------------------o---------g----SSSSSS----------------------------------------------SSS-----------
-----------------------------------------------------------------y------------------SSSSSS---------------------------------TT-----------------SS------
----------Q-----------------##--QQQQ-----------------------------##----------S@S--------------------SU----!--!-------------TT-----%%%%%--------------#
-----------------------y-#####-------K-B---------------SSS------###-----------------------------------------------------t--TT------|||--------------##
--------------------y-######-----------b-----------------------####-----------------------------------------------------t--TT------|||-------------###
-M-----------------#######-------------b-------ggg------------#####--------------------------------g------k----k----kkk-t--TT------|||------------####
XXXXXXXXXXXXX--XXXXXXXXX------XXXXXXXXXX-XXXXXXXXX----------XXXXXXX----XXXXXXXXX---XXXXXXX-XXXXXXXXXXXXXXXXXXXXXXXXXXXXXXXXXXXXXXX%|||------XXXXX-XXXX
XXXXXXXXXXXXX--XXXXXXXXX------XXXXXXXXXX-XXXXXXXXX----------XXXXXXX----XXXXXXXXX---XXXXXXX-XXXXXXXXXXXXXXXXXXXXXXXXXXXXXXXXXXXXXXX-|||------XXXXX-XXXX
