------------------------------------------------------------------------------------------------------------------------------------------------------
------------------------------------------------------------------------------------------------------------------------------------------------------
------------------------------------------------------------------------------------------------------------------------------------------------------
------------------------------SSSSSSSSSS----------------------------------------ooo-------SSSSSSSSSS--------------------------------------------------
------------------------------SSSSSSSSSS----------------------------------------%%%-------------------------------------------------------------------
------------------------------SSSSSSSSSS-----------------------------------------|--------------------------------------------------------------------
---------------------LSSS-----SSSSSSSSSS-----------------------------------g-----|---------------------------R----------------------------------------
-----------------------------------------------------------------------%%%%%%----|-------------------r------------------------------------------------
------------------------------------------------------------------------||||-----|------------------%%%%%%%-------------------------------------------
---------------------------------------------------------o------1-------||||-----|---%%%%-----------||||||--------------------------------------------
----------------%%%%-2-----#--SSSSSSSSSS--------------------------------||||-----|----||------------||||||----------------------------------#---------
-----------------||--------#--SSSSSSSSSS--------------------------------||||----%%%%%%||------------||||||----------------------------------##--------
-----------------||--------##-SSSSSSSSSS--------------------------------||||-----||||-||------------||||||---------B------------------------###------#
-M---------------||---kk---##-SSSSSSSSSS------------k-------------------||||-----||||-||--------g-g-||||||--oo-----b-----k----ggg-----------####----##
XXXXXXXXXXX--%%%%||%XXXXXXXXXXXXXXXXXXXXX-XX-XX-XX-XXXXXXXXXXXXXXXXXX---||||-----||||-||%%XXXXXXXXXX||||||--%%XXXXXXXXXXXXXXXXXXXXXXXXXXXXXXXXXXXXXXXX
XXXXXXXXXXX---||-||-XXXXXXXXXXXXXXXXXXXXX-XX-XX-XX-XXXXXXXXXXXXXXXXXX---||||-----||||-||-|XXXXXXXXXX||||||---|XXXXXXXXXXXXXXXXXXXXXXXXXXXXXXXXXXXXXXXX
