------------------------------------------------------------------------------------------------------------------------------------------------------
------------------------------------------------------------------------------------------------------------------------------------------------------
------------------------------------------------------------------------------------------------------------------------------------------------------
----------------------------------------SSSSSSSSSS----------------------------------------------------------------------------------------------------
------------------------------------------------------------------------------------------------------------------------------------------------------
--------------------------------------------------------------g---------------------------------------------------------------------------------------
-----------------------------------------oooo-----------------SSSSS------------------1--------------------2----------------------------------QQQQ-----
------------------------------------------------------------------------------------------------------------------------------------------------------
-----------------------------------------SSSS-U------------------------------------------------------------------------------SSS----------------------
----------------------------------------oS--SoS----------o--------------------------------------g---o------------------------------------------y------
-------------------%--------TT----------SS--SSS------------------------------------QQQQ---------TT--------2-------------r-------------------Q?SSQQQ---
----------------------------TT------------------------------------------------------------------TT----------------------%%%%%%------------------------
----------------------------TT--------------------------------TT-----t--------------------------TT-----------------B----|||||-------------------------
-M-----------%%%%-------ggg-TT----k-k-----kk--------k---------TT-----tgg------------yy----------TT------y--y-------b----|||||-----k-------------------
XXXXXXXXXXX---||----XXXXXXXXXXXXXXXXXXX-XXXXXXXXXX-XXXXXXXXXXXXXXXXXXXXXXXXXXXXXXXXXXXXXXXXXXXXXXXX-XXXXXXXXXXXXXXXXXXXX|||||-----XX---XXXXXXX--XXXXXX
XXXXXXXXXXX---||----XXXXXXXXXXXXXXXXXXX-XXXXXXXXXX-XXXXXXXXXXXXXXXXXXXXXXXXXXXXXXXXXXXXXXXXXXXXXXXX-XXXXXXXXXXXXXXXXXXXX|||||-----XX---XXXXXXX--XXXXXX
