------------------------------------------------------------------------------------------------------------------------------------------------------
------------------------------------------------------------------------------------------------------------------------------------------------------
------------------------------------------------------------------------------------------------------------------------------------------------------
--------------------------------oo------SSSSSSSSSS-oo-------------------------------------------------------------------------------------------------
---------------------------------------gSSSSSSSS--%%%%------------------------------------------------------------------------------------------------
-----------------------------------%%%%%SSSCSSSS---||----------------R----------K---------------------------------------------------------------------
------------------------------------||||SSSSSSSS---||---------------------SSCSS-SS----1----SSS!--------------R-----------SSS----S!!S------------------
------------------------------------||||-----------||--SSS-------------------------------------------r------------------------------------------------
------------------------------------||||-----------||-----------------------------------------------%%%%%%%-------------------------------------------
------------------------------%%%%%-||||---ggg-----||-----------------------------------------------||||||--------------------------------------------
----------Q--------------------|||--||||SSSSSSSS---||------------%%%----QQQQ--QQSS------------C-----||||||------------r----------SS------#------------
-------------------------------|||--||||SSSSSSSS---||-------------|-------------------TT------------||||||--------%%%%%%----------------##---------#--
-------------------------------|||--||||SSSSSSSS--%||-------------|-------------------TT------------||||||---------|||||---------------###-----K---#--
-M-----------------#-----------|||--||||SSSSSSSS---||-------------|-------------------TT-------g-g--||||||--oo-----|||||----gg-g-g----####---------#--
XXXXXXXXXXXXX--XXXXXXXXXX--XXX-|||--||||XXXXXXXXXX-||-------%%%%%-|---XXXXXXXXXXXXXXXXXXXXXXXXXXXXXX||||||--%%-%%%-|||||XXXXXXXXXXXXXXXXXXXXXXXXX--XXX
XXXXXXXXXXXXX--XXXXXXXXXX--XXX-|||--||||XXXXXXXXXX-||--------|||--|---XXXXXXXXXXXXXXXXXXXXXXXXXXXXXX||||||---|--|--|||||XXXXXXXXXXXXXXXXXXXXXXXXX--XXX
