------------------------------------------------------------------------------------------------------------------------------------------------------
------------------------------------------------------------------------------------------------------------------------------------------------------
------------------------------------------------------------------------------------------------------------------------------------------------------
----------SSSSSSSSSS----------------------------------------------------------------------------------------------------------------------------------
------------------------------------------------------------------------------------------------------------------------------------------------------
------------------------------------------------------------------------------------------------------------------------------------------------------
-----------------------------U-------------------------------------------------------------------------------R------------oo---%%%SS------------------
-----------------------------------------------------------------------------------------------------r--------------------SS----||--------------------
---------------------------------------------------------------------o------------------------------%%%%%%%---------------------||--------------------
-----------------------------------------------------------------y-------1--------o---------------oo||||||----------------------||--------------------
---------Q@QQQQ-------------##-TT---------------------S----------##---T----------------TT-----------||||||-------------------SS-||SS--------#---------
-----------------------y-#####-TT------------K---BTT------------###---T----TT----------TT------TT---||||||-----#----------------||K---#----B##--------
-----------------g-#y-######---TT----------------bTT-----------####---T----TT----------TT------TT---||||||-----#----------------||----#----b###------#
----------------g#-#######----gTT----------------BTT------k---#####---T---kTT----------TT---y--TT---||||||--oo-#----ggg---------||----#----B####----##
XXXXXXXXXXXXXXXXXXXXXXXX------XXXXXXXX--XXXXXXXXXXXXXXXXXXXXXXXXXXX---XXXXXXXXXXXXXXXXXXXXXXXXXXXXXX||||||--%%-XXXXXXXXX%%-----%%%XXXXXXXXXXXXXXXXXXXX
XXXXXXXXXXXXXXXXXXXXXXXX------XXXXXXXX--XXXXXXXXXXXXXXXXXXXXXXXXXXX---XXXXXXXXXXXXXXXXXXXXXXXXXXXXXX||||||---|-XXXXXXXXX|-------||XXXXXXXXXXXXXXXXXXXX
