------------------------------------------------------------------------------------------------------------------------------------------------------
------------------------------------------------------------------------------------------------------------------------------------------------------
------------------------------------------------------------------------------------------------------------------------------------------------------
------------------------------------------------------------------------------------------------------------------------SSSSSSSSSS--------------------
------------------------------------------------------------------------------------------------------------------------------------------------------
----------------------------------------%%---------------------------R--------------------------------------------------------------------------------
----------------------------------------|----------------------------------g---------1----SSS------%---------------oo-----------------------SSS-------
----------------------------------------|----oo------------------------%%%%%%-----------------------------TT------------------------------------------
----------------------------------------|-------------------------------||||------------------------------TT------------------------------------------
----------------------------------------|----------------o--------------||||------------------------------TT-------------------------------------SSSSS
----------------------------------------|------------------------%%%----||||-------QQQQ-----%%%----------SXXS--%%%%--%%%-------------------#----------
--------------------------------------tt|-------------------------|-----||||-----------------|------------------||----||--SS--------------##----------
--------------------------------------tt|-------------------------|-----||||-----------------|------TT----------||----||--SS-------------###SSS-------
-M--------k---ggg---------------------tt|-----------k-------------|-----||||--------yy-------|------TT--------o-||----||--SS---------y--####-------r--
XXXXXXXXXXXXXXXXXXXXXXXXX--XXXXXXXXXXXXX|----%%%%--XXXXXXXXX%%%%%-|-----||||----XXXXXXXXXX---|------XXXXXXXXXX%-||----||--XX--XXXXXXXXXXXXXX-----XXXXX
XXXXXXXXXXXXXXXXXXXXXXXXX--XXXXXXXXXXXXX|-----||---XXXXXXXXX-|||--|-----||||----XXXXXXXXXX---|------XXXXXXXXXX--||----||--XX--XXXXXXXXXXXXXX-----XXXXX
