------------------------------------------------------------------------------------------------------------------------------------------------------
------------------------------------------------------------------------------------------------------------------------------------------------------
------------------------------------------------------------------------------------------------------------------------------------------------------
--------------------------------------------------------------------------------SSSSSSSSSS--------------------SS-------S------------------------------
------------------------------------------------------------------------------------------------------------------------------------------------------
------------------------------------------------------------------------------------------------------------------------------------------------------
------------------SC--------------------------QQQQQ---------------SSoo---------------------------------------@---------S---------------US----QQQQ-----
--------------------------------o----ooo--------------------------------------------------------------------------------------------------------------
----------------------------------------------------------------------o--------------------------------------------SSS--------------------------------
------------------------------------------------k--------------------------------------S---o-----------------------------------SSS---SS--------y------
--------------TT---2--------TT--------%%T-----?QQQQ---------%%%%%%--------------SU---------------TT-SU----!--!---------S%------------------SQ?SSQQQ---
--------------TT------------TT---------|T--------------------||||-------------#-----TT---t-------TT------------##-------------------------------------
--------------TT------------TT---------|T--------------------||||------------##-----TT---t-------TT------------##-----------------TT------------------
-M------------TT--------ggg-TT-%%%%%%%-|T------------gg----k-||||------------------kTT--kt-------TT-------k----##----------------rTT------------------
XXXXXXXXXXXXXXXXXXXXXXXXXXXXXX--|||||--|XXXXXXXXXXXXXXXXXXXX-||||-----XXXXXXXXXXXXXXXXXXXXXXXXXXXXXXXXXXXXXXXX-XX------X----XXXXXXXXXXXX-X-XXX--XXXXXX
XXXXXXXXXXXXXXXXXXXXXXXXXXXXXX--|||||--|XXXXXXXXXXXXXXXXXXXX-||||-----XXXXXXXXXXXXXXXXXXXXXXXXXXXXXXXXXXXXXXXX-XX------X----XXXXXXXXXXXX-X-XXX--XXXXXX
