------------------------------------------------------------------------------------------------------------------------------------------------------
------------------------------------------------------------------------------------------------------------------------------------------------------
------------------------------------------------------------------------------------------------------------------------------------------------------
--------------------------------oo------------------------------------------------------------------------------------------------SSSSSSSSSS----------
---------------------------------------g----------?---------------------------------------------------------------------------------------------------
----------------------ooor---------%%%%%-----------------------------R--------------------------------------------------------------------------------
---------------------%%%%%----------||||--------------------------------SSSSS-------------------------------------------------------------------------
----------------------|||-----------||||----------SS--------------------------------------------------------------------------------------------------
----------------------|||-----------||||------------------------------------------TT------------------------------------------------------------------
----------------------|||-----%%%%%-||||------------------------------------------TT-------------------------------------------SSS--------------------
---------Q----------%%%%%%%----|||--||||-------------------------%%%---------2----TT------------------------------------%---------------------#LSS----
-----------------K--||||||-----|||--||||---------------SSS--------|--------TT-----TT-----T------------------------------------------------TT--#-------
------------B-------||||||--o--|||--||||--------------------------|---t----TT--TT-TT-----T-------B--------*--------B---------------tt-----TT--#-------
------------b-------||||||-%%%-|||--||||----y-y-------------------|---t----TT--TT-TT---k-T-------b--gg----*--------b-------------r-tt----kTTkk#-------
XXXXXXXXXXXXXXXXXXXX||||||--|--|||--||||XXXXXXXXXX----------%%%%%-|---XXXXXXXXXXXXXXXXXXXXXXXXXXXXXXXXXXXXXXX-XXXXXXXXXX----XXXXXXXXXXXXXXXXXXXXXXX---
XXXXXXXXXXXXXXXXXXXX||||||--|--|||--||||XXXXXXXXXX-----------|||--|---XXXXXXXXXXXXXXXXXXXXXXXXXXXXXXXXXXXXXXX-XXXXXXXXXX----XXXXXXXXXXXXXXXXXXXXXXX---
