------------------------------------------------------------------------------------------------------------------------------------------------------
------------------------------------------------------------------------------------------------------------------------------------------------------
------------------------------------------------------------------------------------------------------------------------------------------------------
----------SSSSSSSSSS------------------------------------------------------------------------------------------SSSSSSSSSS------------------------------
------------------------------------------------------------------------------------------------------------------------------------------------------
--------------------------------------oo----------------------------------------------------oo--------------------------------------------------------
-----------------------------U-----SSSS----------------------------------------------------------------------R------------SSC-------------------------
-----------------------------------------------------------------------------------------------------r----------------------------oo------------------
---------------------------------------------------------------------------------------------------%%%%%%%%-------------------------------------------
----------------------------------------------------------------------------------o-----------------||||||----------------SSS-------------------------
---------Q@QQQQ-------------##%--------------------------tt----------------------------TT-S---------||||||----T----------------------------Q----------
-----------------------y-#####---------------K---B-------tt----------T-----------------TT-----------||||||----T---------------------------------------
-----------------g-#y-######---------------------b-------tt--B-------T-----------------TT----%%%%---||||||----T----TT------------------------------F--
-M--------------g#-#######-----------------------B---g-g-tt--b-------Tgg---------------TT-----||----||||||--ooT--g-TT------------#-----------------#--
XXXXXXXXXXXXXXXXXXXXXXXX--------%%%%--%%XXXXXXXXXXXXXXXXXXXXXXXXXX--XXXXXXXXXXXXXXXXXXXXXX----||----||||||--%%XXXXXXXXXXX----XXXXXXXXXXXXXXXXXXXXXXXXX
XXXXXXXXXXXXXXXXXXXXXXXX---------||----|XXXXXXXXXXXXXXXXXXXXXXXXXX--XXXXXXXXXXXXXXXXXXXXXX----||----||||||---|XXXXXXXXXXX----XXXXXXXXXXXXXXXXXXXXXXXXX
