------------------------------------------------------------------------------------------------------------------------------------------------------
------------------------------------------------------------------------------------------------------------------------------------------------------
------------------------------------------------------------------------------------------------------------------------------------------------------
------------------------------------------------------------------------------------------------------------------------------------------------------
------------------------------------------------------------------------------------------------------------------------------------------------------
--------------------------------------------------------------------------------------------oo--------------------------------------------------------
--------------------USS-----------------------QQQQQ------------------------1-------o--o----------------------------------------SSS-----US-------------
------------------------------------------------------------------------------------------------------------------------------------------------------
-----------------g---------------------------------------------------------------------------------%--------------------------------------------------
-----------------#------------------------------k--------------------------ggg-----SSSS-----------------------------------------K----SS---------------
----------S-----##--------------QQQQ----T-----?QQQQ-------------------#########-----------SS-----------------------------------SSS---------S----------
---------------###---B---------------K-BT-------------------------------------#-----------------------TT----------------------------------------------
--------------####---b-------B---------bT-------------------------------------#-%%%----------%%%%-----TT----TT-----------TT-------TT---------------F--
-M-----------#####---B-------b---------bT------------gg----kgg-------g--------#-||------------||------TT-k--TT-k----kkk--TT-------TT---------------#--
XXXXXXXXXXXXXXXXXXXXXXXXXXXXXXXXXXXXXXXXXXXXXXXXXXXXXXXXXXXXXXXXXXXXXX--------X-||------------||----XXXXXXXXXXXXXXXXXXXXXXXXXXXXXXXXXXXX-X-XXXXXXXXXXX
XXXXXXXXXXXXXXXXXXXXXXXXXXXXXXXXXXXXXXXXXXXXXXXXXXXXXXXXXXXXXXXXXXXXXX--------X-||------------||----XXXXXXXXXXXXXXXXXXXXXXXXXXXXXXXXXXXX-X-XXXXXXXXXXX
