------------------------------------------------------------------------------------------------------------------------------------------------------
------------------------------------------------------------------------------------------------------------------------------------------------------
------------------------------------------------------------------------------------------------------------------------------------------------------
----------------------------------------------------------------------------------------------------SSSSSSSSSSSS-------S------------------------------
------------------------------------------------------------------------------------------------------------------------------------------------------
---------------------------------------------------------------------R--------------------------------------------------------------------------------
--------------------S---------S--------------------------------------------g--------y------SSS!------------------------S--SSC----------------QQQQ-----
---------------------------TT------------------------------------------%%%%%%-----#SSS----------------------------------------------------------------
---------------------------TT----------------------------B--------------||||-----##--------------------------------SSS---------------g#---------------
---------------------------XX----------------------------b--------------||||----###1--------------------------------------SSS-------g##--------y------
-----------------------TT-----##--SSC------------------SS#CS-----%%%----||||----###-----------C------------TT----------S------------###-----Q?SSQQQ---
-----------------------TT-----------------------------------------|-----||||----###--SSS----------------#--TT--##------------------####---------------
-----------------------TT----------------------------------K------|-----||||----###--------------------##--TT--##-----------------#####---------------
-M------------k-ggg-k--TT-------------------y-y-------------------|-----||||----###------------g-g--kk-##--TT--##----------------######---------------
XXXXXXXXXXXXXXXXXXXXXXXXXXXXXXXX--XXXXXXXXXXXXXXXXXXXXXXXXXX%%%%%-|-----||||----XXXXXX---XXXXXXXXXXXXXXXX--XX--XX------XX----XXXXXXXXXX--XXXXX--XXXXXX
XXXXXXXXXXXXXXXXXXXXXXXXXXXXXXXX--XXXXXXXXXXXXXXXXXXXXXXXXXX-|||--|-----||||----XXXXXX---XXXXXXXXXXXXXXXX--XX--XX------XX----XXXXXXXXXX--XXXXX--XXXXXX
