------------------------------------------------------------------------------------------------------------------------------------------------------
------------------------------------------------------------------------------------------------------------------------------------------------------
------------------------------------------------------------------------------------------------------------------------------------------------------
--------------------------------oo------SSSSSSSSSS--------------------------------------------------------------------------------SSSSSSSS------------
-------------------------------------g-g--------------------------------------------------------------------------------------------------------------
-----------------------------------%%%%%---------------oooo-------------------------------------------------------------------------------------------
----------------------!-------------||||-oooo----------%%%%--------------------------------------------------------oo---------------------------------
------------------------------------||||----------------||--------------------------------------------------------------------------------------------
------------------------------------||||-SSSS-U---------||--------------------------------------------------------------------------------------------
------------------------------%%%%%-||||oS--SoS---SSS---||---------------1--------o-------------------------------------------------------------------
-------------------%S@S!S------|||--||||SS--SSS---------||-----------TT----------------TT-------TT----%%%%%%---%%%%--%%%---------------g##------------
-------------------------------|||--||||--------------U-||-----------TT----TT----------TT-------TT-----||||-----||----||---------------###---------#--
----------------------------tt-|||--||||----------------||-----------TT----TT----------TT-------TT-----||||-----||----||-------------g####-----K---#--
-M-----------%%%%----g------tt-|||--||||--kk------------||----ggg----TT---kTT----------TT---k---TT-----||||---o-||----||--kkk--------#####---------#--
XXXXXXXXXXX---||----XXXXXXXXXX-|||--||||XXXXXXXXXX----%%%%%-XXXXXXXXXXXXXXXXXXXXXXXXXXXXXXXXXXXXXXXX%%-||||-%%%-||----||XXXXXXXXXXXXXXXXXX--XXXXX--XXX
XXXXXXXXXXX---||----XXXXXXXXXX-|||--||||XXXXXXXXXX-----|||--XXXXXXXXXXXXXXXXXXXXXXXXXXXXXXXXXXXXXXXX|--||||--|--||----||XXXXXXXXXXXXXXXXXX--XXXXX--XXX
