------------------------------------------------------------------------------------------------------------------------------------------------------
------------------------------------------------------------------------------------------------------------------------------------------------------
------------------------------------------------------------------------------------------------------------------------------------------------------
--------------------------------------------------------------------------------SSSSSSSSSS--------------------SS-------S------------------------------
------------------------------------------------------------------------------------------------------------------------------------------------------
------------------------------------------------------------------------------------------------------------------------------------------------------
--------------------------------------------------------------------------SS---------------------------------@---------S--oo---%%%-------##-----------
--------------------------------------------------------------------------------------------------------------------------SS----||-------##-----------
---------------------------------------------------------TT--------------------------------------------------------SSS----------||-----####-----------
---------------------------------------------------TT----TT-----1----------------------S---o------------------------------------||-----####-----------
----------------------------------------------tt---TT----XX-----------SS-----SS-SU---------------TT-SU----!--!---------S-----SS-||---######-----------
-----------------K--------------------K-------tt---TT-------------------------------TT---t-------TT------------##---------------||---######--------#--
------------B-----------------TTTT------------tt---TT-------------------------------TT---t-------TT------------##---------------||---######----K---#--
---M--------b-----------------TTTT-------g----tt---TT------------------------------kTT--kt-------TT-------k----##---------------||---######--------#--
XXXXXXXXXXXXXXXXXXXXXXXXX--XXXXXXXXXXXXXXXXXXXXXXXXXXXXXXXXXXXXXXXXXX-----------XXXXXXXXXXXXXXXXXXXXXXXXXXXXXX-XX------X%%-----%%%XXXXXXXXXXXXXXX--XXX
XXXXXXXXXXXXXXXXXXXXXXXXX--XXXXXXXXXXXXXXXXXXXXXXXXXXXXXXXXXXXXXXXXXX-----------XXXXXXXXXXXXXXXXXXXXXXXXXXXXXX-XX------X|-------||XXXXXXXXXXXXXXX--XXX
