------------------------------------------------------------------------------------------------------------------------------------------------------
------------------------------------------------------------------------------------------------------------------------------------------------------
------------------------------------------------------------------------------------------------------------------------------------------------------
--------------------SSSSSSSSSS-------------------------------------SSSSSSSSSSSSS----------------------------------------------------------------------
------------------------------------------------------------------------------------------------------------------------------------------------------
------------------------------------------------------------------------------------------------------------------------------------------------------
----------------------------------------------------------------CSS------------------------------------------@-------------------------US---SS--------
--------------------------------o----ooo--------------------------------------TT----------------------------------------------------------------------
------------------------------------------------------------SS--2-------------TT----------------------------------------------------------------------
-----------------------------C---------------------------------2-2------------TT--o------------oooo----------------------------------SS---------------
----------Q------------#-#------------%%-TT---SU------S-----------2---------SCTT-------TT-----------SU----!--!-----------------------------SSS--------
---------------------#-#-#-#-----------|-TT-------TT--------------------TT----TT-------TT---------------------------------------------------------#-TT
---------------------#-#-#-#-----------|-TT-------TT--------------------TT----TT-------TT--------------------------B--------------TT-------------##-TT
---M---------------#-#-#-#-#-E-%%%%%%%-|-TT------kTT------k-------------TT---kTT-------TT-----------------k--------b-----k----ggg-TT------------###-TT
XXXXXXXXXXXXX--XXXXXXXXXXXXXXX--|||||--|XXXXXXXXXXXXXXXXXXXX---XXXXXXXXXXXXXXXXXXXXXXXXXXX%%%%%%%-%%XXXXXXXXXXXXXXXXXXXXXXXXXXXXXXXXXXXX-X-XXXXXXXX-XX
XXXXXXXXXXXXX--XXXXXXXXXXXXXXX--|||||--|XXXXXXXXXXXXXXXXXXXX---XXXXXXXXXXXXXXXXXXXXXXXXXXX||||||---|XXXXXXXXXXXXXXXXXXXXXXXXXXXXXXXXXXXX-X-XXXXXXXX-XX
