------------------------------------------------------------------------------------------------------------------------------------------------------
------------------------------------------------------------------------------------------------------------------------------------------------------
------------------------------------------------------------------------------------------------------------------------------------------------------
--------------------------------oo--------------------------------------------------------SSSSSSSSSS--------------------------------------------------
---------------------------------------g--------------------------------------------------------------------------------------------------------------
-----------------------------------%%%%%---------------oooo-------------------------------------------------------------------------------------------
---------------------LSSS-----------||||------QQQQ-----%%%%--------------------------SSSS--------------------R-----------SSS----S!-----US---SSS-------
------------------------------------||||----------------||-------------------------------------------r------------------------------------------------
------------------------------------||||----------------||------------------------------------------%%%%%%%-------------------------------------------
------------------------------%%%%%-||||--------k-SSS---||------------------------------------------||||||---------------------------SS----------SSSSS
-------------------%-2-----#---|||--||||T-----?QQQ------||----------------------Q-------------------||||||-----------------------S---------S----------
---------------------------#---|||--||||T-------------U-||--------------------------------t---------||||||--------------------------------------------
---------------------------##--|||--||||T---------------||--------------------------------t---------||||||---------B--------------TT--------SSS-------
-M-----------%%%%-----kk---##--|||--||||T---------------||--gg-------g-----------ggg------t---------||||||--oo-----b--------gg-g-gTT---------------r--
XXXXXXXXXXX---||----XXXXXXXXXX-|||--||||XXXXXXXXXX----%%%%%-XXXXXXXXXXX----XXXXXXXXXX----XXXXXXXXXXX||||||--%%XXXXXXXXXXXXXXXXXXXXXXXXXX-X-X-----XXXXX
XXXXXXXXXXX---||----XXXXXXXXXX-|||--||||XXXXXXXXXX-----|||--XXXXXXXXXXX----XXXXXXXXXX----XXXXXXXXXXX||||||---|XXXXXXXXXXXXXXXXXXXXXXXXXX-X-X-----XXXXX
