------------------------------------------------------------------------------------------------------------------------------------------------------
------------------------------------------------------------------------------------------------------------------------------------------------------
------------------------------------------------------------------------------------------------------------------------------------------------------
------------------------------------------------------------------------------------------------------------------------------------------------------
------------------------------------------------------------------------------------------------------------------------------------------------------
-----------------------SSS-----------------------------oooo-------------------------------------------------------------------------------------------
-------------------------------------------------------%%%%---USSS--------SSCSS----o--o-------------------------------USSSS-------%-------------------
---------------------g----------------------------SSSS--||--------------------------------------------------------------------------------------------
--------------------%%%---------------------------------||------------------------------------------------------------------------------SSS-----------
--------------------||----SSS---------------------------||-------------------------SSSS-----------------------------E---------------------------------
-------------------%||----------------------------------||---S-----TT---QQQQ--QQ-----------------tt----------------TT-------------%%%%%---------------
--------------------||--------------------------------U-||---------TT---------------------T------tt----------------TT--t-----------|||----------------
--------------------||----------------------------------||---------TT-----------%%%-------T------tt-------*--------TT--t------TT---|||-------------F--
-M-----------%%%%---||----oo------k-k-------------------||---ggg---TT-----------||--------T------tt-gg----*-----g--TT--t------TT---|||-------------#--
XXXXXXXXXXX---||----||---%%%--XXXXXXXXX-X-XX-XX-XX----%%%%%-XXXXXXXXXXXXXXXXXXXX||--------XXXXXXXXXXXXXXXXXXX-XXXXXXXXXX----XXXXXX%|||------XXXXXXXXXX
XXXXXXXXXXX---||----||----|---XXXXXXXXX-X-XX-XX-XX-----|||--XXXXXXXXXXXXXXXXXXXX||--------XXXXXXXXXXXXXXXXXXX-XXXXXXXXXX----XXXXXX-|||------XXXXXXXXXX
