------------------------------------------------------------------------------------------------------------------------------------------------------
------------------------------------------------------------------------------------------------------------------------------------------------------
------------------------------------------------------------------------------------------------------------------------------------------------------
----------------------------------------SSSSSSSSSSSSSSSSS-------------SSSSSSSSSSooo-------------------------------------------------------------------
----------------------------------------SSSSSSSS--------------------------------%%%-------------------------------------------------------------------
----------------------------------------SSSCSSSS---------------------R-----------|---------------------------------k----------------------------------
--------------------USS-----------------SSSSSSSS--QQ-----------------------------|----------------------------S---SSSSSSSSS--------------##-----------
------------------------------------------------------------------------------TT-|------------------------TT-----------------------------##-----------
-----------------------------------------------------------S------------------TT-|------------------------TT---------------------------####-----------
-------------------------------------------ggg--------------------------------TT-|---%%%%------oooo-------TT---------------------------####-----------
-------------------------------TT-------SSSSSSSS--QQ--QQQ--------%%%--------SCTT-|----||-----------------SXXS------------------------######-#---------
---------------------B---------TT-------SSSSSSSS------------------|-----TT----TT%%%%%%||---------------------------------------------######-##--------
---------------------b-------B-TT-------SSSSSSSS------------------|-----TT----TT-||||-||------------TT--------TT--------------TT-----######-###------#
-M------------k-ggg--B-------bgTT-------SSSSSSSS------------------|-----TT---kTT-||||-||------------TT--------TT--------------TT-----######-####----##
XXXXXXXXXXXXXXXXXXXXXXXXXXXXXXXXXXXXXX--XXXXXXXXXXXXXXXXX---%%%%%-|---XXXXXXXXXX-||||-||%%%%%%%%%-%%XXXXXXXXXXXXXXXXXX------XXXXXXXXXXXXXXXXXXXXXXXXXX
XXXXXXXXXXXXXXXXXXXXXXXXXXXXXXXXXXXXXX--XXXXXXXXXXXXXXXXX----|||--|---XXXXXXXXXX-||||-||-|||||||---|XXXXXXXXXXXXXXXXXX------XXXXXXXXXXXXXXXXXXXXXXXXXX
