------------------------------------------------------------------------------------------------------------------------------------------------------
------------------------------------------------------------------------------------------------------------------------------------------------------
------------------------------------------------------------------------------------------------------------------------------------------------------
----------------------------------------------------------------------SSSSSSSSSS----------------------------------------------------------------------
-----------------------------------------g------------------------------------------------------------------------------------------------------------
-----------------------SSS--------------%%------------------------------------------------------------------------------------------------------------
----------------------------------------|-------------------------------------------y-----------------------------------SSS---------------------------
---------------------g------------------|----oo-------------------------------TT--#SSS--------------oo------------------------------------------------
--------------------%%%-----------------|----------------B--------------------TT-##--------------------------------------------------g#---------------
------------Q--?----||----SSS-----------|----------------b--------------------TT###1-------o----------------------------------------g##---------------
-------------------S||-----------------T|--------------SS#CS----------------SCTT###--------------TT----------T--------r-------------###---------------
--------------------||-----------------T|-------------------------------TT----TT###--SSS---------TT----------T----%%%%%%-----------####---------------
--------------------||-----------------T|------------------K------------TT----TT###--------------TT----------T-----|||||------TT--#####------------F--
-M----------------K-||----oo----gg-----T|-------------------gg-------g--TT---kTT###--------------TT-------y--T-----|||||------TT--#####------------#--
XXXXXXXXXXXXXXXXXXXX||---%%%--XXXXXXXXXX|----%%%%-XXXXXXXXXXXXXXXXXXXXXXXXXXXXXXXXXXXX---XXXXXXXXXXXXXXXXXXXXX-%%%-|||||----XXXXXXXXXXX--XXXXXXXXXXXXX
XXXXXXXXXXXXXXXXXXXX||----|---XXXXXXXXXX|-----||--XXXXXXXXXXXXXXXXXXXXXXXXXXXXXXXXXXXX---XXXXXXXXXXXXXXXXXXXXX--|--|||||----XXXXXXXXXXX--XXXXXXXXXXXXX
