------------------------------------------------------------------------------------------------------------------------------------------------------
------------------------------------------------------------------------------------------------------------------------------------------------------
------------------------------------------------------------------------------------------------------------------------------------------------------
--------------------------------oo------SSSSSSSSSS--------------------------------------------------SSSSSSSSSS----------------------------------------
---------------------------------------g--------------------------------------------------------------------------------------------------------------
-----------------------------------%%%%%--------------------------------------------------------------------------------------------------------k-----
------------------SC--!-------------||||-oooo-----Q------------------------g---------1-----SSS!--------------------oo--------------------------SQS--SQ
------------------------------------||||-------------------------------%%%%%%-------------------------------------------------------------------------
------------------------------------||||-SSSS-U-------------------------||||---------------------------------------------------------g#---------------
------------------------------%%%%%-||||oS--SoS-------------------------||||---------------------------------------------------SSS--g##---------------
--------SU----TT---2S@S!S------|||--||||SS--SSS---Q---------------------||||-------QQQQ-------C--------------T-%%%%--%%%%-----------###--------SQS--S?
--------------TT---------------|||--||||--------------------------------||||---------------------------TT----T--||----||-----------####---------------
--------------TT------------tt-|||--||||--------------------------------||||---------------------------TT----T--||----||----------#####---------------
--M-----------TT-----g------tt-|||--||||--kk---------gg----kgg-------g--||||--------yy---------g-g--g--TT----To-||----||---------r#####------k------gg
XXXXXXXXXXXXXXXXXXXXXXXXXXXXXX-|||--||||XXXXXXXXXXXXXXXXXXXXXXXXXXXXXX--||||----XXXXXXXXXXXXXXXXXXXXXXXXXXXXXX%-||----||----XXXXXXXXXXX--XXXXXXXXXXXXX
XXXXXXXXXXXXXXXXXXXXXXXXXXXXXX-|||--||||XXXXXXXXXXXXXXXXXXXXXXXXXXXXXX--||||----XXXXXXXXXXXXXXXXXXXXXXXXXXXXXX--||----||----XXXXXXXXXXX--XXXXXXXXXXXXX
