------------------------------------------------------------------------------------------------------------------------------------------------------
------------------------------------------------------------------------------------------------------------------------------------------------------
------------------------------------------------------------------------------------------------------------------------------------------------------
-----------------------oo-----SSSSSSSSSS----------------------------------------ooo---------------------------SS-------S------------------------U-----
------------------------------SSSSSSSSSS----?-----------------------------------%%%-------------------------------------------------------------------
------------------------------SSSSSSSSSS-----------------------------------------|--------------------------------------------------------------------
----------------------SSSS----SSSSSSSSSS----------------------------------SS-----|-------------------------------------S----------%-------------------
----------------------------------------------r----------------------------------|----------------------------------------------oo----------------SS--
-----------------g------------------------%%%%%%---------------------------------|---------------------------------SSS------------------SSS-----------
-----------------#-------------------------||||----------------------------------|---%%%%-----------------------------------------------------SS------
----------S-----##--------%%%%SSSSSSSSSS%%-||||ooo-----ooo-----------TSS-----SS--|----||---------tt--------------------S-----TT---%%%%%--------------#
---------------###---------|||SSSSSSSSSS|--||||--r-------------------T----------%%%%%%||--T------tt------------##------------TT----|||--------------##
--------------####---------|||SSSSSSSSSS|%%%%%%%%%-------------------T-----------||||-||--T------tt-------*----##------------TT----|||-------------###
---M---------#####---------|||SSSSSSSSSS|-||||||||------------ggg----T-----------||||-||--T------tt-gg----*----##--------y---TT----|||------------####
XXXXXXXXXXXXXXXXXXXX%%%----|||XXXXXXXXXX|-||||||||--XXXXXXXXXXXXXXXXXX-----------||||-||%%XXXXXXXXXXXXXXXXXXX--XX------XXXXXXXXXXX%|||------XXXXX-XXXX
XXXXXXXXXXXXXXXXXXXX||-----|||XXXXXXXXXX|-||||||||--XXXXXXXXXXXXXXXXXX-----------||||-||-|XXXXXXXXXXXXXXXXXXX--XX------XXXXXXXXXXX-|||------XXXXX-XXXX
