------------------------------------------------------------------------------------------------------------------------------------------------------
------------------------------------------------------------------------------------------------------------------------------------------------------
------------------------------------------------------------------------------------------------------------------------------------------------------
S-----SSSS----------SSSSSSSSSS-------------------------------------SSS----------SSSSSSSSSS------------------------------------------------------------
S-------------------------------------------?---------------------------------------------------------------------------------------------------------
S------------------------------------------------------oooo---------------------------------oo--------------------------------------------------------
S------------------------------------------------------%%%%-----CSS-----SSSSS---------------------------------------------SSC-----SS------------------
S---------------------------------------------r---SSSS--||--------------------------------------------------------------------------------------------
S-----------------------------------------%%%%%%--------||--SS--2----------------------------------%--------------------------------------------------
S----------------------------C-----oo------||||---------||-----2-2---------------------S----------------------------------SSS-------------------------
S------------------%---#-#--------o--o--%%-||||ooo------||--------2----------2--SU--------S---------------------------------------SS------------------
S--------------------#-#-#-#------------|--||||--r----U-||-----------------TT-------TT---t------------------g---------------------K---#----B----------
S--------------------#-#-#-#------------|%%%%%%%%%------||------------t----TT--T----TT---t---%%%%-----------TT------------------------#----b-------F--
S--M---------%%%%----#-#-#-#-E----------|-||||||||------||------------t----TT--T---kTT--kt----||------------TT-k----kkk----------#----#----B-------#--
XXXXXXXXXXX---||----XXXXXXXXXXXXXXXXXXXX|-||||||||----%%%%%----XXXXXXXXXXXXXXXXXXXXXXXXXXX----||------XXXXXXXXXXXXXXXXXXX----XXXXXXXXXXXXXXXXXXXXXXXXX
XXXXXXXXXXX---||----XXXXXXXXXXXXXXXXXXXX|-||||||||-----|||-----XXXXXXXXXXXXXXXXXXXXXXXXXXX----||------XXXXXXXXXXXXXXXXXXX----XXXXXXXXXXXXXXXXXXXXXXXXX
