------------------------------------------------------------------------------------------------------------------------------------------------------
------------------------------------------------------------------------------------------------------------------------------------------------------
------------------------------------------------------------------------------------------------------------------------------------------------------
--------------------------------oo------SSSSSSSSSS----------------------------------------------------------------------------------------------------
-------------------------------------g-g--------------------------------------------------------------------------------------------------------------
----------------------ooor---------%%%%%--------------------------------------------------------------------------------------------------------------
---------------------%%%%%----------||||-oooo------------Q-Q--------------SSCSS------SUS----------------------------------oo---%%%-------##-----------
----------------------|||-----------||||----------------------------------------------------------------------------------SS----||-------##-----------
----------------------|||-----------||||-SSSS-U---------------------------------------------------------------------------------||-----####-----------
----------------------|||-----%%%%%-||||oS--SoS---------------------------------------------------------------------------------||-----####-----------
----------------!---%%%%%%%----|||--||||SS--SSS----------Q-Q------------QQQQ--QQ----#####-------------%%%%%%-----------------SS-||---######-----------
--------------------||||||-----|||--||||-----------------------------T--------------#------------------||||----#----------------||---######-----------
--------------------||||||--o--|||--||||---------------------B-------T-------------K#------------------||||----#----------------||---######--------F--
-M------------------||||||-%%%-|||--||||--kk-----------------b-------T--------------#--------------g---||||----#----ggg---------||---######--------#--
XXXXXXXXXXXXXXXXXXXX||||||--|--|||--||||XXXXXXXXXXXXXXXXXXXXXXXXXX--XXXXXXXXXXXXXXXXXXX----XXXXXXXXX%%-||||-%%-XXXXXXXXX%%-----%%%XXXXXXXXXXXXXXXXXXXX
XXXXXXXXXXXXXXXXXXXX||||||--|--|||--||||XXXXXXXXXXXXXXXXXXXXXXXXXX--XXXXXXXXXXXXXXXXXXX----XXXXXXXXX|--||||--|-XXXXXXXXX|-------||XXXXXXXXXXXXXXXXXXXX
