------------------------------------------------------------------------------------------------------------------------------------------------------
------------------------------------------------------------------------------------------------------------------------------------------------------
------------------------------------------------------------------------------------------------------------------------------------------------------
--------------------------------------------------SSSSSSS-------------SSSSSSSSSSSSSSSSSSSS----------------------------------------SSSSSSSSSS----------
----------------------------------------------------------------------------SSSS----------------------------------------------------------------------
--------------------------------------------------------------g----------g--SSSS--------------------oo-------------k----------------------------k-----
--------------------------------------------------QQ----------SSSSS-----SS--------------------------%%%-------S---SSSSSS-----------------------SQS--SQ
------------------------------------------------------------------------SS--------------------------||--o----R------------------oo--------------------
-----------------------------------------------------------S------------SS--------------------------||-%%%--------------------------------------------
------------------------------------------------------------------------SC--g-g--------S--------g---||--|---------------------------------------------
-----SSS--------------------------------------tt--QQ--QQQ---------------SS--SSSSSU--------------TT--||--|--------------------TT----------------SQS--S?
---------------------------------------T------tt------------------------------------TT---t------TT--||-o|--------------------TT-----------TT----------
---------------------------------------T------tt--------------TT-----t--------------TT---t------TT--||%%%%%---TT-------------TT----tt-----TT----------
----------k---ggg--------ggg---------kkT-g----tt--------------TT-----t-------------kTT--kt------TT--||-|||----TT---------y---TT----tt----kTT-k------gg
XXXXXXXXXXXXXXXXXXXXXXXXXXXXXXXXXXXXXXXXXXXXXXXXXXXXXXXXX---XXXXXXXXXXXXXXXXXXXXXXXXXXXXXXXXXXXXXXX-||-|||----XXXXXXXX--XXXXXXXXXXXXXXXXXXXXXXXXXXXXXX
XXXXXXXXXXXXXXXXXXXXXXXXXXXXXXXXXXXXXXXXXXXXXXXXXXXXXXXXX---XXXXXXXXXXXXXXXXXXXXXXXXXXXXXXXXXXXXXXX-||-|||----XXXXXXXX--XXXXXXXXXXXXXXXXXXXXXXXXXXXXXX
