------------------------------------------------------------------------------------------------------------------------------------------------------
------------------------------------------------------------------------------------------------------------------------------------------------------
------------------------------------------------------------------------------------------------------------------------------------------------------
S-----SSSS--------------------SSSSSSSSSS--------------------------------------------------------------------------------------------------------------
S----------------------------------------------------------------------------------------------------------------------------------------------------o
S--------------------------------------------------------------------R------------g---------oo--------------------------------------------------------
S----------------------------U--------------------------------------------------SSSSSSSS----------------------?SSS--------oo---%%%%-------------------
S---------------------------------------------------------------------------------------------------------TT--------------SS----||--------------SSS---
S--------------------------------------S-----------------------------------------------------------%------TT--------------------||------SSS-oo--------
S-----------Q--?-----------------------S------------------------------------------------------------------TT--------------------||--------------------
S------------------S--------##---------S---------------ooo-------%%%----------------------SS-------------SXXS-SSSSS----------SS-||%%%%%-----SS--------
S----------------------y-#####-#----------------------------------|-------------------------------------------------------------||-|||----------------
S-------------------y-######---#-#--------------------------------|--------------------------%%%%---TT--------------------------||-|||----------------
S-----------------K-######-----#-#-------------y------------------|---gg----------------------||----TT----------K---------------||-|||----------------
XXXXXXXXXXXXXXXXXXXXXXXX------XXXXXXXXXXXXXXXXXXXX--XXXXXXXX%%%%%-|---XXXXXXXXXXXXXXXX---X----||----XXXXXXXXXXXXXXXXXXXX%%-----%%%%|||----------------
XXXXXXXXXXXXXXXXXXXXXXXX------XXXXXXXXXXXXXXXXXXXX--XXXXXXXX-|||--|---XXXXXXXXXXXXXXXX---X----||----XXXXXXXXXXXXXXXXXXXX|-------||-|||----------------
