------------------------------------------------------------------------------------------------------------------------------------------------------
------------------------------------------------------------------------------------------------------------------------------------------------------
------------------------------------------------------------------------------------------------------------------------------------------------------
--------------------------------oo--------------------------------------------------------------------------------------------------------------------
-------------------------------------g-g--------------------------------------------------------------------------------------------------------------
-----------------------------------%%%%%-----------------------------R--------------------------------------------------------------------------------
--------------------USS-------------||||---------------------------------------------1---------------------------------------------------##-----------
------------------------------------||||-------------------------------------------------------------------------------------------------##-----------
------------------------------------||||---------------------------------------g---------------------------------------y---------------####-----------
------------------------------%%%%%-||||-----------------o-------------------------------------------------------------XSS-?Q----------####-----------
-------------------%-----------|||--||||-TT---SU-----------------%%%---------S@S---QQQQ-------------------------------XX-------------######-----------
---------------------B---------|||--||||-TT-----------------------|--------------------------------------------------XXX-------------######-----------
---------------------b-------B-|||--||||-TT-----------------------|------------------------------B--------*---------XXXX-------y-----######--------F--
-------------%%%%----B-------b-|||--||||-TT------k--k-------------|-----------------yy-----------b--gg----*--------XXXXX---SSSSS-----######--------#--
XXXXXXXXXXX---||----XXXXXXXXXX-|||--||||XXXXXXXXXX-XXXXXXXXX%%%%%-|----XXXXXXXXXXXXXXXXXXXXXXXXXXXXXXXXXXXXXX-XXXXXXXXXX-------XX-XXXXXXXXXXXXXXXXXXXX
XXXXXXXXXXX---||----XXXXXXXXXX-|||--||||XXXXXXXXXX-XXXXXXXXX-|||--|----XXXXXXXXXXXXXXXXXXXXXXXXXXXXXXXXXXXXXX-XXXXXXXXXX-------XX-XXXXXXXXXXXXXXXXXXXX
