------------------------------------------------------------------------------------------------------------------------------------------------------
------------------------------------------------------------------------------------------------------------------------------------------------------
------------------------------------------------------------------------------------------------------------------------------------------------------
--------------------SSSSSSSSSS-------------------------------------SSS------------------------------SSSSSSSSSS----------------------------------------
--------------------SSSSSSSSSS--------------------?---------------------------------------------------------------------------------------------------
--------------------SSSSSSSSSS----------------------------------------------------------oo--oo--------------------------------------------------------
--------------------SSSSSSSSSS----------------------------------CSS-------------oo--------------------------------------SSS--------------##-SS--------
--------------------------------------------------SS-------------------------------------------------------------------------------------##-----------
------------------------------------------------------------SS--2----------------------------------%-----------------------------------####-----------
---------------------------------------------------------------2-2---------------SSS---------------------------------------------------####-----------
--------SUQ-----------SSSSSS?----------T--------------------------2----------------------SSS-----------------T-----------------------######-SS--------
----------------------SSSSS------------TT-----TT-------SSS---------------------------------------------TT----T-----------------------######-------#-TT
----------------------SSSSS------------TT-----TT---------------------------------------------%%%%------TT----T-----B----------TT-----######------##-TT
--M----------------#-------ooo--gg-----TT-----TT----------------------gg----------------------||----g--TT----T-----b----------TT-----######-----###-TT
XXXXXXXXXXXXX--XXXXX-XXXXXXXXXXXXXXXXXXXXXXX--XXXX-------------XXXXXXXXXXXXXXXXX--------------||----XXXXXXXXXXXXXXXXXXXX----XXXXXXXXXXXXXXXXXXXXXXX-XX
XXXXXXXXXXXXX--XXXXX-XXXXXXXXXXXXXXXXXXXXXXX--XXXX-------------XXXXXXXXXXXXXXXXX--------------||----XXXXXXXXXXXXXXXXXXXX----XXXXXXXXXXXXXXXXXXXXXXX-XX
