------------------------------------------------------------------------------------------------------------------------------------------------------
------------------------------------------------------------------------------------------------------------------------------------------------------
------------------------------------------------------------------------------------------------------------------------------------------------------
-------------------------------------------------------------------SSS----------ooo-----------------SSSSSSSSSS----------------------------------------
--------------------------------------------------------------------------------%%%-------------------------------------------------------------------
----------------------ooor-------------------------------------------------------|--------------------------------------------------------------------
---------------------%%%%%-------------------------------Q-Q----CSS--------g-----|----------------------------------------oo---%%%-SSSS-----SSS-------
----------------------|||----------------------------------------------%%%%%%----|-------------------------------SSS------SS----||--------------------
----------------------|||-----------------------------------SS--2-------||||-----|----------------------------------------------||--------------------
----------------------|||--------------------------------------2-2------||||-----|---%%%%------oooo-----------------------------||-----SSSS------SSSSS
--------------------%%%%%%%------------------------------Q-Q------2-----||||-----|----||-------------------TT----------------SS-||--------------------
--------------------||||||------------K---------------------------------||||----%%%%%%||----------------#--TT-------------------||--------------------
--------------------||||||--o-TTTT--------------------------------------||||-----||||-||---------------##--TT-------------------||----------SSS-------
-M------------k-ggg-||||||-%%%TTTT-------------y------------------------||||-----||||-||------------kk-##--TT-------------------||-----------------r--
XXXXXXXXXXXXXXXXXXXX||||||--|-XXXXXXXXXXXXXXXXXXXXXXXXXXXXXX---XXXXXXX--||||-----||||-||%%%%%%%%%-%%XXXXX--XX-%%%%----%%%%-----%%%---------X-----XXXXX
XXXXXXXXXXXXXXXXXXXX||||||--|-XXXXXXXXXXXXXXXXXXXXXXXXXXXXXX---XXXXXXX--||||-----||||-||-|||||||---|XXXXX--XX-|||------||-------||---------X-----XXXXX
