------------------------------------------------------------------------------------------------------------------------------------------------------
------------------------------------------------------------------------------------------------------------------------------------------------------
------------------------------------------------------------------------------------------------------------------------------------------------------
----------------------------------------------------------------------------------------------------------------------------------SSSSSSSSSS----------
------------------------------------------------------------------------------------------------------------------------------------------------------
----------------------------------------------------------------------------------------oo------------------------------------------------------k-----
--------------------------------------------------------------------------------oo--------SSS------%---------R-----oo--------------------------SQS--SQ
---------------------------------------------------------------------------------------------------------r--------------------------------------------
-----------------g----------------------------------------------------o-----------------------------%%%%%%%-------------------------------------------
-----------------#---------------------------------------------------------------SSS----------------||||||--------------------------------------------
----------S-----##------------------------------------S----------------------------------S--%%%-----||||||-----%%%%--%%%-----------------------SQS--S?
---------------###--------------------K------K---BTT-----------------T--------#--------------|------||||||------||----||------------------TT----------
--------------####------------TTTT---------------bTT---------B-------T-------##--------------|------||||||------||----||-----------tt-----TT----------
-M-----------#####-------ggg--TTTT---------------BTT------k--b-------T-----------------------|------||||||--ooo-||----||-k----ggg--tt----kTT-k------gg
XXXXXXXXXXXXXXXXXXXXXXXXXXXXXXXXXXXXXXXXXXXXXXXXXXXXXXXXXXXXXXXXXX--XXXXXXXXXXXX-------------|------||||||--%%%-||----||XXXXXXXXXXXXXXXXXXXXXXXXXXXXXX
XXXXXXXXXXXXXXXXXXXXXXXXXXXXXXXXXXXXXXXXXXXXXXXXXXXXXXXXXXXXXXXXXX--XXXXXXXXXXXX-------------|------||||||---|--||----||XXXXXXXXXXXXXXXXXXXXXXXXXXXXXX
