------------------------------------------------------------------------------------------------------------------------------------------------------
------------------------------------------------------------------------------------------------------------------------------------------------------
------------------------------------------------------------------------------------------------------------------------------------------------------
----------SSSSSSSSSS--------------------SSSSSSSSSS------------------------------SSSSSSSSSS------------------------------------------------------------
----------------------------------------SSSSSSSS------------------------------------------------------------------------------------------------------
----------------------ooor------------ooSSSCSSSS-------------------------------------------------------------------k----------------------------------
---------------------%%%%%---------SSSS-SSSSSSSS--------------------------------------------------------------S---SSSSSSSSS-------%-------------------
----------------------|||-----------------------------------------------------------------------------------------------------------------------------
----------------------|||--------------------------------B---------------------g--------------------------------------------------------SSS-----------
----------------------|||------------------ggg-----------b-----------------------------S--------------------------------------------------------------
----------@QQQQ-----%%%%%%%---%---------SSSSSSSS-------SS#CS-----------------S@SSU---------------tt---%%%%%%----------------------%%%%%---------------
--------------------||||||--------------SSSSSSSS------------------------------------TT---tT------tt----||||------------------------|||----------------
-----------------g-#||||||--o-----------SSSSSSSS-----------K------------------------TT---tT------tt----||||---TT--------------TT---|||-------------F--
-M--------------g#-#||||||-%%%----------SSSSSSSS------------gg-------g-------------kTT--ktT------tt----||||---TT--------------TT---|||-------------#--
XXXXXXXXXXXXXXXXXXXX||||||--|---%%%%--%%XXXXXXXXXXXXXXXXXXXXXXXXXXXXXX-XXXXXXXXXXXXXXXXXXXXXXXXXXXXX%%-||||-%%XXXXXXXX------XXXXXX%|||------XXXXXXXXXX
XXXXXXXXXXXXXXXXXXXX||||||--|----||----|XXXXXXXXXXXXXXXXXXXXXXXXXXXXXX-XXXXXXXXXXXXXXXXXXXXXXXXXXXXX|--||||--|XXXXXXXX------XXXXXX-|||------XXXXXXXXXX
