------------------------------------------------------------------------------------------------------------------------------------------------------
------------------------------------------------------------------------------------------------------------------------------------------------------
------------------------------------------------------------------------------------------------------------------------------------------------------
----------SSSSSSSSSS-------------------------------oo-----------------------------------------------SSSSSSSSSS----------------------------------------
--------------------------------------------------%%%%------------------------------------------------------------------------------------------------
----------------------ooor-------------------------||-----------------------------g---------oo--------------------------------------------------------
---------------------%%%%%-------------------------||---------------------------SSSSSSSS----------------------?SSS--------SSC---------------SSS-------
----------------------|||--------------------------||--SSS--------------------------------------------------------------------------------------------
----------------------|||--------------------------||--------------------------g-------------------%--------------------------------------------------
----------------------|||--------------------------||---------------------------------------------------------------------SSS--------------------SSSSS
----------@QQQQ-----%%%%%%%-----QQQQ----------tt---||------------------------S@S----------S------------------TSSSSS-----------------------------------
--------------------||||||-----------K-B------tt---||----------------T---------------------------------TT----T----------------------------------------
-----------------g-#||||||--o----------b------tt--%||--------B-------T-----------------------%%%%------TT----T------------------------------SSS-------
-M--------------g#-#||||||-%%%---------b-g----tt---||--------b-------T------------------------||----g--TT----T--K----------------#k----------------r--
XXXXXXXXXXXXXXXXXXXX||||||--|-XXXXXXXXXXXXXXXXXXXX-||-------XXXXXX--XX-XXXXXXXXXXXXXXX---X----||----XXXXXXXXXXXXXXXXXXXXX----XXXXXXX---XXXXX-----XXXXX
XXXXXXXXXXXXXXXXXXXX||||||--|-XXXXXXXXXXXXXXXXXXXX-||-------XXXXXX--XX-XXXXXXXXXXXXXXX---X----||----XXXXXXXXXXXXXXXXXXXXX----XXXXXXX---XXXXX-----XXXXX
