------------------------------------------------------------------------------------------------------------------------------------------------------
------------------------------------------------------------------------------------------------------------------------------------------------------
------------------------------------------------------------------------------------------------------------------------------------------------------
S-----SSSS----------------------------------------SSSSSSSSSS--------------------SSSSSSSSSS--------------------SS-------S------------------------------
S-----------------------------------------------------SS--SS------------------------------------------------------------------------------------------
S-----------------------------------------------------SS--SS--g---------------------------------------------------------------------------------------
S---------------------!-----------------------------SS--------SSSSS-----------------------SSS------%-------------------S--------------------SS--------
S---------------------------------------------------SS------------------------------------------------------------------------------------------------
S----------------g----------------------------------SS-------------------------------------------------------------SSS--------------------------------
S----------------#----------------------------------SS----oo---------------------------S---------------------------------------SSS--------------------
S---------S-----##--S@S!S---------------------------SSSS--SS--------------------SU----------%%%------------------------S%-------------------SS--------
S--------------###--------------------K-T-----TT------SS----------------------------TT---t---|--------------g--##--------------------TT-----------#-TT
S-------------####----------ttTTTT------T-----TT------SS------TT-----t--------------TT---t---|--------------TT-##--------------------TT----------##-TT
S--M---------#####---g------ttTTTT------T-----TT--------------TT-----t-------------kTT--kt---|--------------TT-##----------------r---TT---------###-TT
XXXXXXXXXXXXXXXXXXXXXXXXXXXXXXXXXXXXXXXXXXXX--XXXXXXXXXXXXXXXXXXXXXXXXX----XXXXXXXXXXXXXXX---|--------XXXXXXXX-XX------X----XXXXXXXXXXXXXXXXXXXXXXX-XX
XXXXXXXXXXXXXXXXXXXXXXXXXXXXXXXXXXXXXXXXXXXX--XXXXXXXXXXXXXXXXXXXXXXXXX----XXXXXXXXXXXXXXX---|--------XXXXXXXX-XX------X----XXXXXXXXXXXXXXXXXXXXXXX-XX
