------------------------------------------------------------------------------------------------------------------------------------------------------
------------------------------------------------------------------------------------------------------------------------------------------------------
------------------------------------------------------------------------------------------------------------------------------------------------------
----------SSSSSSSSSS------------------------------SSSSSSSSSS------------------------------SSSSSSSSSS--------------------------------------------------
------------------------------------------------------SS--SS------------------------------------------------------------------------------------------
----------------------ooor------------oo--------------SS--SS----------------------------oo------------------------------------------------------------
---------------------%%%%%---------SSSS-------------SS--------------------------oo---------------------------------------SSS----S!-----------QQQQ-----
----------------------|||---------------------------SS------------------------------------------------------------------------------------------------
----------------------|||---------------------------SS------------------------------------------------------------------------------------------------
----------------------|||---------------------------SS----oo---------------------SS------------------------------------------------------------y------
--------------------%%%%%%%---%---------------tt----SSSS--SS-----------------------------S----------------------!-----S----------S----------Q?SSQQQ---
--------------------||||||--------------------tt------SS-------------T--------------------t-----------TT----------------------------------------------
--------------------||||||--o-----------------tt------SS-----B-------T--------------------t-----------TT----TT----------------------------------------
---M----------------||||||-%%%-----------g----tt-------------b-------Tgg------------------t-----------TT-k--TT--------------gg-g-gk-------------------
XXXXXXXXXXX--XX--X--||||||--|---%%%%--%%XXXXXXXXXXXXXXXXXXXXXXXXXX--XXXXXXXXXXXX----------XXXXXXXXXXXXXXXXXXXXXXXXXXXXXXXXXXXXXXXXXX---XXXXXXX--XXXXXX
XXXXXXXXXXX--XX--X--||||||--|----||----|XXXXXXXXXXXXXXXXXXXXXXXXXX--XXXXXXXXXXXX----------XXXXXXXXXXXXXXXXXXXXXXXXXXXXXXXXXXXXXXXXXX---XXXXXXX--XXXXXX
