------------------------------------------------------------------------------------------------------------------------------------------------------
------------------------------------------------------------------------------------------------------------------------------------------------------
------------------------------------------------------------------------------------------------------------------------------------------------------
--------------------SSSSSSSSSS--------------------SSSSSSS---------------------------------------------------------------------------------------------
--------------------------------------------?---------------------------------------------------------------------------------------------------------
--------------------------------------oo--------------------------------------------------------------------------------------------------------------
-----------------------------------SSSS-----------QQ----------USSS-------------------SSSS---------------------?SSS--------SSC-------------------------
----------------------------------------------r-------------------------------------------------------------------------------------------------------
-----------------%%%----------------------%%%%%%-----------S----------o-------------------------------------------------------------------------------
------------------||---------C-------------||||---------------------------------------------------oo----------------------SSS-------------------------
---------Q--------||---#-#----%---------%%-||||oooQQ--QQQ----S-----TT-----------Q-----------------------------SSSSS-----------------------------------
-------------%%%%%||-#-#-#-#------------|--||||--r-----------------TT---------#----------------TT-----TT----------------------------------------------
--------------|||-||-#-#-#-#------------|%%%%%%%%%-----------------TT--------##----------------TT-----TT----TT-------------------------------------F--
--------------|||-||-#-#-#-#-E----------|-||||||||-----------ggg---TT------------ggg--------y--TT-----TT-k--TT--K----------------#-----------------#--
XXXXXXXXXXX---|||-||XXXXXXXXXX--%%%%--%%|-||||||||XXXXXXX---XXXXXXXXXXXXXXXXXXXXXXXXX----XXXXXXXXXXXXXXXXXXXXXXXXXXXXXXXX----XXXXXXXXXXXXXXXXXXXXXXXXX
XXXXXXXXXXX---|||-||XXXXXXXXXX---||----||-||||||||XXXXXXX---XXXXXXXXXXXXXXXXXXXXXXXXX----XXXXXXXXXXXXXXXXXXXXXXXXXXXXXXXX----XXXXXXXXXXXXXXXXXXXXXXXXX
