------------------------------------------------------------------------------------------------------------------------------------------------------
------------------------------------------------------------------------------------------------------------------------------------------------------
------------------------------------------------------------------------------------------------------------------------------------------------------
--------------------------------------------------SSSSSSSSSS-------SSSSSSSSSSSSS----------------------------------------SSS-----SS----------SSSSSSSSSS
------------------------------------------------------SS--SS------------------------------------------------------------------------------------------
------------------------------------------------------SS--SS----------------------------oo--oo--------------------------------------------------------
--------------------S-------------------------------SS----------CSS-------------oo---------------------------R-----oo---US----------------------------
---------------------------TT-----------------------SS------------------------TT-------------------------r------------------------oo------------------
---------------------------TT-----------------------SS------SS--2-------------TT-------------------%%%%%%%%-----------------SSS-----------------------
---------------------------XX------oo---------------SS----oo---2-2------------TT-SS-----------------||||||--------------------------------------------
----------Q------------TT---------o--o--------------SSSS--SS------2---------SCTT---------SS---------||||||-----%%%%--%%%SSS----------------Q--TT------
-----------------------TT-----------------------------SS----------------TT----TT--------------------||||||------||----||----------------------TT------
-----------------------TT-----------------------------SS----------------TT----TT-------------%%%%---||||||------||----||----------------------TT------
-M-----------------#k--TT----------------------ggg----------------------TT---kTT--------------||----||||||--ooo-||----||----------------------TT------
XXXXXXXXXXXXX--XXXXXXXXXXXXXXXXXXXXXXXXX-XXXXXXXXXXXXXXXXXXX---XXXXXXXXXXXXXXXXX--------------||----||||||--%%%-||----||XXX------XXXXXXXXXXXXXXX--XXXX
XXXXXXXXXXXXX--XXXXXXXXXXXXXXXXXXXXXXXXX-XXXXXXXXXXXXXXXXXXX---XXXXXXXXXXXXXXXXX--------------||----||||||---|--||----||XXX------XXXXXXXXXXXXXXX--XXXX
