------------------------------------------------------------------------------------------------------------------------------------------------------
------------------------------------------------------------------------------------------------------------------------------------------------------
------------------------------------------------------------------------------------------------------------------------------------------------------
S-----SSSSSSSSSSSSSS----------------------------------------------------------------------------------------------------------------------------------
S------------------------------------------------------------------------o----------------------------------------------------------------------------
S-----------------------------------------------------------------------%%%---------------------------------------------------------------------------
S--------------------LSSS-------------------------Q----------------------|--o--------------------------------@?SSS----------------SS---------QQQQ-----
S------------------------------------------------------------------------|--SSSS----------------------------------------------------------------------
S---------------------------------------------------------------------%--|----------------------------------------------------SSS---------------------
S------------------------------------------------------------------------|--------o-------------g----------------------------------------------y------
S---------@QQQQ------2-----#----QQQQ--------------Q----------------------|-------------TT-------TT--SU----!--!SSSSS-----%---------SS--------Q?SSQQQ---
S--------------------------#---------K-B---------------------------------|-------------TT-------TT--------------------------------K---#----B----------
S----------------g-#-------##----------b---------------------------------|-----%-------TT-------TT------------------------------------#----b----------
S--M------------g#-#--kk---##----------b----y-y------gg----k-y-----------|-------------TT-------TT--------k-----K----------------r----#----B----------
XXXXXXXXXXXXXXXXXXXXXXXXXXXXXXXXXXXXXXXXXXXXXXXXXXXXXXXXXXXXXXXXXXXXXX%%%%%%----XXXXXXXXXXXXXXXXXXX-XXXXXXXXXXXXXXXXXXXX----XXXXXXXXXXXXXXXXXX--XXXXXX
XXXXXXXXXXXXXXXXXXXXXXXXXXXXXXXXXXXXXXXXXXXXXXXXXXXXXXXXXXXXXXXXXXXXXX|||||-----XXXXXXXXXXXXXXXXXXX-XXXXXXXXXXXXXXXXXXXX----XXXXXXXXXXXXXXXXXX--XXXXXX
