------------------------------------------------------------------------------------------------------------------------------------------------------
------------------------------------------------------------------------------------------------------------------------------------------------------
------------------------------------------------------------------------------------------------------------------------------------------------------
----------------------------------------SSSSSSSSSSSSSSSSSSSS----------------------------------------SSSSSSSSSS----------------------------------------
----------------------------------------SSSSSSSS------SS--SS------------------------------------------------------------------------------------------
----------------------------------------SSSCSSSS------SS--SS----------------------g-------------------------------------------------------------------
----------------------------------------SSSSSSSS----SS--------------------------SSSSSSSS--------------------------------SS---------------##-----------
----------------------------------------------------SS-----------------------------------------------------------------------------------##-----------
----------------------------------------------------SS----------------o------------------------------------------------y---------------####-----------
-------------------------------------------ggg------SS----oo------------------------------------g----------------------X---TT----------####-----------
---------Q------%%%%--------TT----------SSSSSSSS----SSSS--SS---------#--------------------------TT---------TT---------XX---TT--------######---#LSS----
-----------------||---------TT--------ttSSSSSSSS------SS------------##--------#-----------------TT------#--TT--------XXXt--TT--------######---#-------
-----------------||---------TT--------ttSSSSSSSS------SS----TT-----###-------##-----------------TT-----##--TT-------XXXXt--TT--------######---#-------
-----------------||-----ggg-TT--------ttSSSSSSSS------------TT----####--------------------------TT--kk-##--TT------XXXXXt--TT--------######-kk#-------
XXXXXXXXXXX--%%%%||%XXXXXXXXXXXXXXXXXXXXXXXXXXXXXXXXXXXXXXXXXXXXXXXXXXXXXXXXXXXXXXXXXX---XXXXXXXXXX-XXXXX--XX-XXXXXXXXXXXXXXXXXXXXXXXXXXXXXXXXXXXXX---
XXXXXXXXXXX---||-||-XXXXXXXXXXXXXXXXXXXXXXXXXXXXXXXXXXXXXXXXXXXXXXXXXXXXXXXXXXXXXXXXXX---XXXXXXXXXX-XXXXX--XX-XXXXXXXXXXXXXXXXXXXXXXXXXXXXXXXXXXXXX---
