------------------------------------------------------------------------------------------------------------------------------------------------------
------------------------------------------------------------------------------------------------------------------------------------------------------
------------------------------------------------------------------------------------------------------------------------------------------------------
-----------------------oo-------oo------SSSSSSSSSS--------------------SSSSSSSSSS------------------------------SS-------S------------------------------
-------------------------------------g-gSSSSSSSS------------------------------------------------------------------------------------------------------
-----------------------------------%%%%%SSSCSSSS------------------------------------------------------------------------------------------------------
----------------------SSSS----------||||SSSSSSSS--Q---------------------------------------SSS------%---------R---------S------------------------------
------------------------------------||||--------------------------------------TT-------------------------r------------------------oo------------------
-----------------%%%----------------||||--------------------------------------TT--------------------%%%%%%%--------SSS--------------------------------
------------------||----------%%%%%-||||---ggg--------------------------------TT--o-----------------||||||--------------SS-?Q-------------------------
---------Q--------||------%%%%-|||--||||SSSSSSSS--Q-------------------------SCTT-------TT---%%%-----||||||-------------S-------------------Q----------
-------------%%%%%||-------|||-|||--||||SSSSSSSS------------------------TT----TT-------TT----|------||||||-----##----------------------------------#--
--------------|||-||-------|||-|||--||||SSSSSSSS------------------------TT----TT-------TT----|------||||||-----##--------------y---------------K---#--
--------------|||-||-------|||-|||--||||SSSSSSSS-----gg----kgg-------g--TT---kTT-------TT----|------||||||--oo-##----------SSSSS-------------------#--
XXXXXXXXXXX---|||-||%%%----|||-|||--||||XXXXXXXXXXXXXXXXXXXXXXXXXXXXXXXXXXXXXXXXXXXXXXXXXX---|------||||||--%%-XX------X-------XX-XXXXXXXXXXXXXXX--XXX
XXXXXXXXXXX---|||-||||-----|||-|||--||||XXXXXXXXXXXXXXXXXXXXXXXXXXXXXXXXXXXXXXXXXXXXXXXXXX---|------||||||---|-XX------X-------XX-XXXXXXXXXXXXXXX--XXX
