------------------------------------------------------------------------------------------------------------------------------------------------------
------------------------------------------------------------------------------------------------------------------------------------------------------
------------------------------------------------------------------------------------------------------------------------------------------------------
--------------------------------oo----------------SSSSSSSSSS----------------------------------------------------------------------SSSSSSSS------------
-------------------------------------g-g--------------SS--SS------------------------------------------------------------------------------------------
-----------------------------------%%%%%--------------SS--SS------------------------------------------------------------------------------------------
------------------------------------||||------------SS---------------------1-------USS-----SSS!-------------------------------------------------------
------------------------------------||||------------SS------------------------------------------------------------------------------------------------
------------------------------------||||------------SS------------------------------------------------------------------------SSS---------------------
------------------------------%%%%%-||||------------SS----oo----1----------ggg------------------------------------------------------------------------
-------------------------------|||--||||------------SSSS--SS----------#########---#-----------C-----------------------r-%--------------g##------------
-------------------------------|||--||||--------------SS----------------------#---#-------------------------------%%%%%%---------------###------------
-------------------------------|||--||||--------------SS----------------------#---##----------------------*--------|||||-------------g####---------F--
-M------------k-ggg------ggg---|||--||||--------------------------------------#---##--gg-------g-g--gg----*--------|||||---------r---#####---------#--
XXXXXXXXXXXXXXXXXXXXXXXXXXXXXX-|||--||||X-XX-XX-XXXXXXXXXXXXXXXXXXXXX---------X---XXXXXXXXXXXXXXXXXXXXXXXXXXX--%%%-|||||----XXXXXXXXXXXXXX--XXXXXXXXXX
XXXXXXXXXXXXXXXXXXXXXXXXXXXXXX-|||--||||X-XX-XX-XXXXXXXXXXXXXXXXXXXXX---------X---XXXXXXXXXXXXXXXXXXXXXXXXXXX---|--|||||----XXXXXXXXXXXXXX--XXXXXXXXXX
