------------------------------------------------------------------------------------------------------------------------------------------------------
------------------------------------------------------------------------------------------------------------------------------------------------------
------------------------------------------------------------------------------------------------------------------------------------------------------
------------------------------SSSSSSSSSS------------------------------SSSSSSSSSSSSSSSSSSSS------------------------------------------------------------
-----------------------------------------g------------------------------------------------------------------------------------------------------------
----------------------------------------%%------------------------------------------------------------------------------------------------------------
----------------------------------------|--------------------------------------------------SSS!-----------------------------------SS------------------
----------------------------------------|----oo-------------------------------TT--------------------------TT------------------------------------------
---------------------------------------S|-------------------------------------TT--------------------------TT------------------------------------------
------------Q--?-----------------------S|-----------------------1-------------TT-------S------------------TT-------------------SSS--------------------
-----SSS-----------SSS-----------------S|-----------------------------------SCTTSU------------C----------SXXS---!-----S-%---------SS------------------
---------------------K---TT----#--------|-----------K-------------------TT----TT----TT---t----------------------------------------K---#----B----------
-------------------------TT----#-#------|-------------------------------TT----TT----TT---t----------TT--------------------------------#----b-------F--
------------------K------TT----#-#------|------------------g------------TT---kTT---kTT--kt-----g-g--TT---------------------------r----#----B-------#--
XXXXXXXXXXXXXXXXXXXXXXXXXXXXXXXXXXXXXXXX|----%%%%-XXXXXXXXXXXXXXXXXXX-XXXXXXXXXXXXXXXXXXXXXXXXXXXXXXXXXXXXXXXXXXXXXXXXXX----XXXXXXXXXXXXXXXXXXXXXXXXXX
XXXXXXXXXXXXXXXXXXXXXXXXXXXXXXXXXXXXXXXX|-----||--XXXXXXXXXXXXXXXXXXX-XXXXXXXXXXXXXXXXXXXXXXXXXXXXXXXXXXXXXXXXXXXXXXXXXX----XXXXXXXXXXXXXXXXXXXXXXXXXX
