------------------------------------------------------------------------------------------------------------------------------------------------------
------------------------------------------------------------------------------------------------------------------------------------------------------
------------------------------------------------------------------------------------------------------------------------------------------------------
--------------------------------------------------------------------------------SSSSSSSSSL------------------------------------------------------------
------------------------------------------------------------------------------------------------------------------------------------------------------
--------------------------------------oo%%--------------------g----------------------------------------------------k----------------------------------
-----------------------------------SSSS-|---------------------SSSSS-----------------oooooo----------------2---S---SSSSSS--oo---%%%--------------------
----------------------------------------|----oo---------------------------------------------------------------------------SS----||--------------------
----------------------------------------|----------------TT--------------------g----SSSSSS--------------------------------------||--------------------
----------------------------------------|----------TT----TT-------------------------SSSSSS-o--------o---------------------------||--------------------
-------------------%SS--------%---------|----------TT----XX------------------S@S-----------------TT-------2------------------SS-||--------------------
---------------------K---TT-------------|----------TT--------------------------------------------TT-----------------------------||---TT---------------
-------------------------TT-------------|----------TT---------TT-----t---------------------------TT-----------TT----------------||---TT------------F--
-M-----------%%%%--------TT-------------|----------TT---------TT-----t---------------------------TT-----y--y--TT----------------||---TT------------#--
XXXXXXXXXXX---||----XXXXXXXXXX--%%%%--%%|----%%%%-XXXXXXXXXXXXXXXXXXXX-XXXXXXXXX---XXXXXXXXXXXXXXXXXXXXXXXXXXXXXXXXXXX--%%-----%%%XXXXXXXXXXXXXXXXXXXX
XXXXXXXXXXX---||----XXXXXXXXXX---||----||-----||--XXXXXXXXXXXXXXXXXXXX-XXXXXXXXX---XXXXXXXXXXXXXXXXXXXXXXXXXXXXXXXXXXX--|-------||XXXXXXXXXXXXXXXXXXXX
