------------------------------------------------------------------------------------------------------------------------------------------------------
------------------------------------------------------------------------------------------------------------------------------------------------------
------------------------------------------------------------------------------------------------------------------------------------------------------
------------------------------------------------------------------------------------------------------------------------SSS-----SS----------SSSSSSSSSS
------------------------------------------------------------------------------------------------------------------------------------------------------
------------------------------------------------------------------------------------------------------------------------------------------------------
--------------------S--------------------------------------------------------------o--o---------------------------------US----------------------------
---------------------------TT---o----ooo----------------------------------------------------------oo-------------SSS----------------------------------
-----------------g---------TT-----------------------------------------------------------------------------------------------SSS------g#---------------
-----------------#---------XX------------------------------------------------------SSSS---------------------------------------------g##---------------
----------S-----##-----TT-------------%%------tt------S--------------T--------------------------------------------------SSS---------###-------TT------
---------------###-----TT--------------|------tt--TT-----------------T--------------------------#-----------g----------------------####-------TT------
--------------####-----TT--------------|------tt--TT-----------------T----------%%%-------------#-----------TT--------------------#####-------TT------
-------------#####--k--TT------%%%%%%%-|-g----tt--TT------k---ggg----T----------||--------------#-----------TT--------------------#####-------TT------
XXXXXXXXXXXXXXXXXXXXXXXXXXXXXX--|||||--|XXXXXXXXXXXXXXXXXXXXXXXXXXXXXXX----XXXXX||--------XXXXXXXXXX--XXXXXXXX%%%%----%%XXX------XXXXXX--XXXXXXX--XXXX
XXXXXXXXXXXXXXXXXXXXXXXXXXXXXX--|||||--|XXXXXXXXXXXXXXXXXXXXXXXXXXXXXXX----XXXXX||--------XXXXXXXXXX--XXXXXXXX|||------|XXX------XXXXXX--XXXXXXX--XXXX
