------------------------------------------------------------------------------------------------------------------------------------------------------
------------------------------------------------------------------------------------------------------------------------------------------------------
------------------------------------------------------------------------------------------------------------------------------------------------------
------------------------------------------------------------------------------------------------------------------------------------------------------
------------------------------------------------------------------------------------------------------------------------------------------------------
-------------------------------------------------------oooo-------------------------------------------------------------------------------------------
----------------------!--------------------------------%%%%------------------------USS------------------SSQSSS-------------------------------------SSS
--------------------------------------------------SSSS--||---o---o---o----------------------------oo--------------------------------------------------
--------------------------------------------------------||--%%%-%%%-%%---------g-----------------------------------------------------g#---------------
--------------------------------------------------------||---|---|---|------------------------------------K-------------------------g##---------------
---------Q------%%%%S@S!S-------------------------------||---|---|---|-------S@S--#---------------------SSSSSS----------------------###-----------#---
-----------------||--------------------T--------------U-||---|---|---|------------#-------------#----------------------------------####-----------#---
-----------------||---------tt---------T----------------||---|---|---|------------##------------#------------------B--------------#####-----------#---
-M---------------||--g------tt-------kkT----y-y---------||---|---|-r-|------------##--gg--------#------------------b-----k----ggg-#####------ggg--#---
XXXXXXXXXXX--%%%%||%XXXXXXXXXXXXXXXXXXXXXXXXXXXXXX----%%%%%-%%%%%%%%%%-XXXXXXXXX--XXXXXXXXXXXXXXXXXXXXXXXXXXXXXXXXXXXXXXXXXXXXXXXXXXXXX--XXXXXXXXXXXXX
XXXXXXXXXXX---||-||-XXXXXXXXXXXXXXXXXXXXXXXXXXXXXX-----|||---|||||||||-XXXXXXXXX--XXXXXXXXXXXXXXXXXXXXXXXXXXXXXXXXXXXXXXXXXXXXXXXXXXXXX--XXXXXXXXXXXXX
