------------------------------------------------------------------------------------------------------------------------------------------------------
------------------------------------------------------------------------------------------------------------------------------------------------------
------------------------------------------------------------------------------------------------------------------------------------------------------
-------------------------------------------------------------------SSS------------------------------SSSSSSSSSS----------------------------------------
------------------------------------------------------------------------------------------------------------------------------------------------------
------------------------------------------------------------------------------------------------------------------------------------------------------
--------------------S-------------------------------------------CSS----------------USS----------------------------------SS----------------------------
---------------------------TT------------------------------------------------------------------------------------SSS----------------------------------
-----------------%%%-------TT-------------------------------SS--2-------------------------------------------------------------------------------------
------------------||-------XX----------------------------------2-2-------------------------o-------------------------------TT-------------------------
--------SU--------||---TT--------------------------------tt-------2---------------#--------------TT----------T-------------TT-------------------------
-------------%%%%%||---TT-------------K------K---B-------tt-----------------------#--------------TT----TT----T----------t--TT-------------------------
--------------|||-||---TT-----TTTT---------------b-------tt-----------------------##-------------TT----TT----T----------t--TT----------------------F--
--M-----------|||-||k--TT-----TTTT---------------B---g-g-tt-----------gg----------##--gg---------TT-g--TT----T----------t--TT----------------------#--
XXXXXXXXXXX---|||-||XXXXXXXXXXXXXXXXXXXXXXXXXXXXXXXXXXXXXXXX---XXXXXXXXXXXXXXXXX--XXXXXXXXXXXXXXXXXXXXXXXXXXXX%%%%----%%XXXXXXXXXXXXXXXXXXXXXXXXXXXXXX
XXXXXXXXXXX---|||-||XXXXXXXXXXXXXXXXXXXXXXXXXXXXXXXXXXXXXXXX---XXXXXXXXXXXXXXXXX--XXXXXXXXXXXXXXXXXXXXXXXXXXXX|||------|XXXXXXXXXXXXXXXXXXXXXXXXXXXXXX
