------------------------------------------------------------------------------------------------------------------------------------------------------
------------------------------------------------------------------------------------------------------------------------------------------------------
------------------------------------------------------------------------------------------------------------------------------------------------------
--------------------SSSSSSSSSSSSSSSSSSSS--------------------------------------------------------------------------------------------------------------
------------------------------SSSSSSSSSS--------------------------------------------------------------------------------------------------------------
------------------------------SSSSSSSSSS%%---------------------------R--------------------------------------------------------------------------------
------------------------------SSSSSSSSSS|----------------------------------g-------o--o-------------------2--------------SSS----S!-SSSS---------------
----------------------------------------|----oo------------------------%%%%%%-------------------------------------------------------------------------
----------------------------------------|-------------------------------||||--------------------------------------------------------------------------
-----------------------------C----------|-------------------------------||||-------SSSS-----------ooo----------------------------------SSSS-----------
--------SU-------------#-#----SSSSSSSSSS|----------------tt------%%%----||||------------------------------2----------------------S----------#---------
---------------------#-#-#-#--SSSSSSSSSS|----------------tt-------|-----||||-------------------TT--------------#----------------------------##--------
---------------------#-#-#-#--SSSSSSSSSS|----------------tt-------|-----||||----%%%------------TT--------------#----------------------------###------#
--M-----------k-ggg--#-#-#-#-ESSSSSSSSSS|------------g-g-tt-------|-----||||----||----------y--TT-------y--y---#----ggg-----gg-g-g----------####----##
XXXXXXXXXXXXXXXXXXXXXXXXXXXXXXXXXXXXXXXX|----%%%%-XXXXXXXXXX%%%%%-|-----||||----||--------XXXXXXXXXXXXXXXXXXXX-XXXXXXXXXXXXXXXXXXX---------XXXXXXXXXXX
XXXXXXXXXXXXXXXXXXXXXXXXXXXXXXXXXXXXXXXX|-----||--XXXXXXXXXX-|||--|-----||||----||--------XXXXXXXXXXXXXXXXXXXX-XXXXXXXXXXXXXXXXXXX---------XXXXXXXXXXX
