------------------------------------------------------------------------------------------------------------------------------------------------------
------------------------------------------------------------------------------------------------------------------------------------------------------
------------------------------------------------------------------------------------------------------------------------------------------------------
------------------------------------------------------------------------------------------------------------------------------------------------------
-----------------------------------------------------------------------------------------------------------------------------------------------------o
--------------------------------------------------------------------------------K---------------------------------------------------------------------
------------------Q----------U------------------------------------------SSSSS---SS----1----------------------@?SSS------------------------------------
------------------------------------------------------------------------------------------------------------------------------------------------SSS---
------------------------------------------------------------------------------------------------------------------------------SSS----g#-----oo--------
----------------------------------------------------------------1-------------------------------------------------------------------g##---------------
------------------?---------##---------------------------tt------------------2--SS--------------TT--SU----!--!SSSSS-----%-----------###-----SS--------
--------------TT-------y-#####--------K------------------tt----------------TT---------TT--------TT---------------------------------####---------------
--------------TT----y-######--TTTT-----------------------tt-----------t----TT--T------TT--------TT--------------------------------#####---------------
--------------TT----######----TTTT-------------------g-g-tt-----------t----TT--T------TT----k---TT--------k-----K----------------r#####---------------
XXXXXXXXXXXXXXXXXXXXXXXX------XXXXXXXXXXX-XX-XX-XXXXXXXXXXXXXXXXXXXXX-XXXXXXXXXXXXXXXXXXXXXXXXXXXXXXXXXXXXXXXXXXXXXXXXXX----XXXXXXXXXXX--XXX----------
XXXXXXXXXXXXXXXXXXXXXXXX------XXXXXXXXXXX-XX-XX-XXXXXXXXXXXXXXXXXXXXX-XXXXXXXXXXXXXXXXXXXXXXXXXXXXXXXXXXXXXXXXXXXXXXXXXX----XXXXXXXXXXX--XXX----------
