------------------------------------------------------------------------------------------------------------------------------------------------------
------------------------------------------------------------------------------------------------------------------------------------------------------
------------------------------------------------------------------------------------------------------------------------------------------------------
----------------------------------------SSSSSSSSSS----------------------------------------------------------------------------------------------------
------------------------------------------------------------------------------------------------------------------------------------------------------
------------------------------------------------------------------------------------------------------------------------------------------------------
---------------------LSSS----------------oooo------------Q-Q-----------------------USS------------------SSQSSS------------oo---%%%-SSSS---------------
--------------------------------------------------------------------------------------------------------------------------SS----||-------------y------
-----------------------------------------SSSS-U-----------------------o---------------------------------------------------------||-----------#SS--o---
-----------------------------------oo---oS--SoS-----------------------------------------------------------K---------------------||-----SSSS-##--------
----------Q----------2-----#------o--o--SS--SSS----------Q-Q----------------------#---------------------SSSSSS--------r------SS-||----------##--SC----
---------------------------#--------------------------------------------------#---#-------------------------------%%%%%%--------||----------##--------
---------------------------##------------------------------------------------##---##-------------B-----------------|||||--------||----------##---SSS--
-M-----------------#--kk---##-------------kk-----------------y--------------------##--gg---------b-----------------|||||--------||----------##--------
XXXXXXXXXXXXX--XXXXXXXXXXXXXXXXXXXXXXXXXXXXXXXXXXXXXXXXXXXXXXXXXXXXXXXXXXXXXXXXX--XXXXXXXXXXXXXXXXXXXXXXXXXXXX-%%%-|||||%%-----%%%---------XXX------XX
XXXXXXXXXXXXX--XXXXXXXXXXXXXXXXXXXXXXXXXXXXXXXXXXXXXXXXXXXXXXXXXXXXXXXXXXXXXXXXX--XXXXXXXXXXXXXXXXXXXXXXXXXXXX--|--||||||-------||---------XXX------XX
