------------------------------------------------------------------------------------------------------------------------------------------------------
------------------------------------------------------------------------------------------------------------------------------------------------------
------------------------------------------------------------------------------------------------------------------------------------------------------
----------------------------------------SSSSSSSSSS-oo-------------------------------------------------------------------------------------------------
--------------------------------------------------%%%%------------------------------------------------------------------------------------------------
---------------------------------------------------||-------------------------------------------------------------------------------------------------
--------------------S--------------------oooo------||----------------------1---------1-----------------------R--------US--oo---%%%-SSSS---------------
---------------------------TT----------------------||--SSS-------------------------------------------r--------------------SS----||--------------------
---------------------------TT------------SSSS-U----||-----------------------------------------------%%%%%%%---------------------||--------------------
---------------------------XX-----------oS--SoS----||----------------------ggg----------------------||||||----------E-----------||-----SSSS-----------
-----------------------TT---------------SS--SSS----||-----------------#########----QQQQ----------tt-||||||---------TT--------SS-||----------#---------
-----------------------TT-------------tt-----------||----------------T--------#-----------T------tt-||||||---------TT--t--------||----------##--------
-----------------------TT-------------tt----------%||--------B-------T--------#-----------T------tt-||||||---------TT--t--------||----------###------#
-M------------k-ggg-k--TT-------------tt--kk-------||--------b-------T--------#-----yy----T------tt-||||||--oo--g--TT--t--------||----------####----##
XXXXXXXXXXXXXXXXXXXXXXXXXXXXXXXXXXXXXXXXXXXXXXXXXX-||-------XXXXXX--XX--------X-XXXXXXXXXXXXXXXXXXXX||||||--%%XXXXXXXXXX%%-----%%%---------XXXXXXXXXXX
XXXXXXXXXXXXXXXXXXXXXXXXXXXXXXXXXXXXXXXXXXXXXXXXXX-||-------XXXXXX--XX--------X-XXXXXXXXXXXXXXXXXXXX||||||---|XXXXXXXXXX|-------||---------XXXXXXXXXXX
