------------------------------------------------------------------------------------------------------------------------------------------------------
------------------------------------------------------------------------------------------------------------------------------------------------------
------------------------------------------------------------------------------------------------------------------------------------------------------
--------------------------------oo--------------------------SSSSSSSSSS------------------------------------------------------------SSSSSSSSSS----------
---------------------------------------g----?---------------SSSS--SSSS--------------------------------------------------------------------------------
----------------------ooor---------%%%%%---------------oooo-SSSS--SSSS------------------------------oo------------------------------------------------
---------------------%%%%%----------||||---------------%%%%---SS---S--------------------------------%%%-------------------oo---%%%-----------------SSS
----------------------|||-----------||||------r---SSSS--||----SS---S--------------------------------||--o----R--oooo------SS----||--------------------
----------------------|||-----------||||--%%%%%%--------||----SS---S--------------------------------||-%%%----------------------||--------------------
----------------------|||-----%%%%%-||||---||||---------||--ooSS---SoU---1--------o------------oooo-||--|-----------------------||--------------------
--------SU---------%%%%%%%%----|||--||||%%-||||ooo------||--SSSS---SSST----------------TT-----------||--|-----T--------------SS-||----------------#---
--------------------||||||-----|||--|||||--||||--r----U-||------------T----TT----------TT-----------||-o|-----T-----------------||--------TT------#---
--------------------||||||--o--|||--|||||%%%%%%%%%------||------------T----TT----------TT-----------||%%%%%---T-----------------||-tt-----TT------#---
--M----------%%%%---||||||-%%%-|||--|||||-||||||||------||--k--g-g----T---kTT----------TT-----------||-|||----T---y-------------||-tt----kTT-ggg--#---
XXXXXXXXXXX---||----||||||--|--|||--|||||-||||||||----%%%%%-XXXXXXXXXXXXXXXXXXXXXXXXXXXXXX%%%%%%%-%%||-|||----XXXXXXXXXX%%-----%%%XXXXXXXXXXXXXXXXXXXX
XXXXXXXXXXX---||----||||||--|--|||--|||||-||||||||-----|||--XXXXXXXXXXXXXXXXXXXXXXXXXXXXXX||||||---|||-|||----XXXXXXXXXX|-------||XXXXXXXXXXXXXXXXXXXX
