------------------------------------------------------------------------------------------------------------------------------------------------------
------------------------------------------------------------------------------------------------------------------------------------------------------
------------------------------------------------------------------------------------------------------------------------------------------------------
S-----SSSS----------------------oo--------------------------------------------------------------------------------------SSSSSSSSSSSSSSSSSS------------
S------------------------------------g-g--------------------------------------------------------------------------------------------------------------
S----------------------SSS---------%%%%%--------------------------------------------------------------oo----------------------------------------------
S-----------------------------------||||-----------------Q-Q--------------SSCSS------------------------------------oo---------------------------------
S--------------------g--------------||||--------------------------------------------------------------------------------------------------------------
S-------------------%%%-------------||||-----------------------------o------------TT------------------------------------------------------------------
S-------------------||----SSS-%%%%%-||||-------------------------y----------------TT------------------------------------------------------------------
S-------------------||---------|||--||||------tt---------Q-Q-----##-----QQQQ--QQ--TT---------------------------%%%%--%%%---------------g##------------
S-------------------||---------|||--||||------tt----------------###---------------TT-----T----------------------||----||--SS-----------###------------
S-------------------||---------|||--||||------tt---------------####-------------T-TT-----T------------------tt--||----||--SS---------g####---------F--
S--M------k---ggg---||----oo---|||--||||-g----tt--------------#####-------------T-TT---k-T---------g--ggg---tto-||----||--SS---------#####---------#--
XXXXXXXXXXXXXXXXXXXX||---%%%---|||--||||XXXXXXXXXXXXXXXXXXXXXXXXXXX---XXXXXXXXXXXXXXXXXXXX-XXXXXXXXXXXXXXXXXXX%-||----||--XX--XXXXXXXXXXXX--XXXXXXXXXX
XXXXXXXXXXXXXXXXXXXX||----|----|||--||||XXXXXXXXXXXXXXXXXXXXXXXXXXX---XXXXXXXXXXXXXXXXXXXX-XXXXXXXXXXXXXXXXXXX--||----||--XX--XXXXXXXXXXXX--XXXXXXXXXX
