------------------------------------------------------------------------------------------------------------------------------------------------------
------------------------------------------------------------------------------------------------------------------------------------------------------
------------------------------------------------------------------------------------------------------------------------------------------------------
--------------------------------oo----------------------------------------------------------------------------------------------------------SSSSSSSSSS
---------------------------------------g--------------------------------------------------------------------------------------------------------------
----------------------ooor---------%%%%%--------------------------------------------------------------------------------------------------------------
------------------Q--%%%%%----------||||--------------------------SSoo------SSSS-----1-----------------------------oo---------------------------------
----------------------|||-----------||||--------------------------------------------------------------------------------------------------------------
----------------------|||-----------||||--------------------------------------------------------------------------------------------------------------
----------------------|||-----%%%%%-||||-------------------------------------K--------------------oo--------------------------------------------------
---------Q--------?-%%%%%%%----|||--||||--------------------%%%%%%---------SSSSS---QQQQ------------------------%%%%--%%%-------------------#--TT------
--------------TT----||||||-----|||--||||------------K--------||||-----T------------------------TT---------------||----||------------------##--TT------
--------------TT----||||||--o--|||--||||---------------------||||-----T------------------------TT---------*-----||----||-----------------###--TT------
-M------------TT----||||||-%%%-|||--||||-------------------g-||||-----T-------------yy------y--TT---gg----*---o-||----||--kkk--------y--####--TT------
XXXXXXXXXXXXXXXXXXXX||||||--|--|||--||||X-XX-XX-XXXXXXXXXXXX-||||-----XXXXXXXXXXXXXXXXXXXXXXXXXXXXXXXXXXXXXXX-%-||----||XXXXXXXXXXXXXXXXXXXXXXXX--XXXX
XXXXXXXXXXXXXXXXXXXX||||||--|--|||--||||X-XX-XX-XXXXXXXXXXXX-||||-----XXXXXXXXXXXXXXXXXXXXXXXXXXXXXXXXXXXXXXX---||----||XXXXXXXXXXXXXXXXXXXXXXXX--XXXX
