------------------------------------------------------------------------------------------------------------------------------------------------------
------------------------------------------------------------------------------------------------------------------------------------------------------
------------------------------------------------------------------------------------------------------------------------------------------------------
--------------------------------------------------------------------------------------------------------------------------------------------SSSSSSSSSS
------------------------------------------------------------------------------------------------------------------------------------------------------
----------------------------------------------------------------------------------------oo------------------------------------------------------------
--------------------S-----------------------------------------------------------oo--------SSS------%----SSQSSS---------------------------##-----------
---------------------------TT------------------------------------------------------------------------------------------------------------##-----------
---------------------------TT------------------------------------------------------------------------------------------y---------------####-----------
---------------------------XX--------------------------------------------1-------SSS----------------------K------------XSS-?Q----------####-----------
---------Q-------------TT----------------TT---SU------S---------------T------------------S--%%%---------SSSSSS--------XX-------------######---TT------
-----------------------TT-------------tt-TT-------TT------------------T----TT----------------|-----------------------XXX-------------######---TT------
-----------------------TT-------------tt-TT-------TT------------------T----TT----------------|----------------------XXXX-------y-----######---TT------
-M--------k---ggg---k--TT-------------tt-TT------kTT------k-gg-------gT---kTT----------------|---------------------XXXXX---SSSSS-----######---TT------
XXXXXXXXXXXXXXXXXXXXXXXXXXXXXXXXXXXXXXXXXXXXXXXXXXXXXXXXXXXXXXXXXXXXXXXXXXXXXXXX-------------|------XXXXXXXXXXXXXXXXXXXX-------XX-XXXXXXXXXXXXXX--XXXX
XXXXXXXXXXXXXXXXXXXXXXXXXXXXXXXXXXXXXXXXXXXXXXXXXXXXXXXXXXXXXXXXXXXXXXXXXXXXXXXX-------------|------XXXXXXXXXXXXXXXXXXXX-------XX-XXXXXXXXXXXXXX--XXXX
