------------------------------------------------------------------------------------------------------------------------------------------------------
------------------------------------------------------------------------------------------------------------------------------------------------------
------------------------------------------------------------------------------------------------------------------------------------------------------
----------------------------------------SSSSSSSSSS-oo-------------------------------------------------------------------------------------------------
--------------------------------------------------%%%%------------------------------------------------------------------------------------------------
---------------------------------------------------||----------------R--------------------------------------------------------------------------------
-----------------------------------------oooo------||-------------------------------y------SSS!---------SSQSSS-----------SSS----S!--------------------
---------------------------------------------------||--SSS------------------------#SSS---------------------------SSS--------------oo-----------y------
-----------------------------------------SSSS-U----||----------------------------##----------------------------------------------------------#SS--o---
----------------------------------------oS--SoS----||--------------------1------###1----------------------K---------------------------------##--------
---------Q------------------------------SS--SSS----||------------%%%--T---------###-----------C---------SSSSSS-------------------S---------Q##--SC----
---------------------------------------------------||-------------|---T----TT---###--SSS----------------------------------------------------##--------
--------------------------------------------------%||-------------|---T----TT---###---------------------------------------------------------##---SSS--
-M--------k---ggg-----------------k-k-----kk-------||-------------|---T---kTT---###------------g-g--------------------------gg-g-g----------##--------
XXXXXXXXXXXXXXXXXXXXXXXXX--XXXXXXXXXXXX-XXXXXXXXXX-||-------%%%%%-|---XXXXXXXXXXXXXXXX---XXXXXXXXXXXXXXXXXXXXX%%%%----%%XXXXXXXXXXXXXXXXXXXXXX------XX
XXXXXXXXXXXXXXXXXXXXXXXXX--XXXXXXXXXXXX-XXXXXXXXXX-||--------|||--|---XXXXXXXXXXXXXXXX---XXXXXXXXXXXXXXXXXXXXX|||------|XXXXXXXXXXXXXXXXXXXXXX------XX
