------------------------------------------------------------------------------------------------------------------------------------------------------
------------------------------------------------------------------------------------------------------------------------------------------------------
------------------------------------------------------------------------------------------------------------------------------------------------------
S-----SSSS-----------------------------------------oo---------------------------------------------------------SS-------SSSS-----SS--------------------
S-------------------------------------------------%%%%------------------------------------------------------------------------------------------------
S--------------------------------------------------||-------------------------------------------------------------------------------------------------
S--------------------LSSS---------------------QQQQ-||------------------------------USS--------------------2------------SUS--------!S------------------
S--------------------------------------------------||--SSS---o---o---o--------------------------------------------------------------------------------
S--------------------------------------------------||-------%%%-%%%-%%---------g-----------------------------------SSS------SSS-----------------------
S-----------------------------------------------k--||--------|---|---|------------------------------o-------------------------------------------------
S--------------------2-----#------------T-----?QQQ-||--------|---|---|-------S@S--#-----------------------2------------SSSS-------S------#------------
S----------------K---------#------------T----------||--------|---|---|------------#----------------------------##-----------------------##------------
S-----------B--------------##-----------T---------%||--------|---|---|------------##-------------B-------------##----------------------###---------F--
S-----------b---------kk---##-----k-k---T----------||--------|---|-r-|------------##--gg---------b------y--y---##---------------------####---------#--
XXXXXXXXXXXXXXXXXXXXXXXXXXXXXXXXXXXXXXX-XXXXXXXXXX-||-------%%%%%%%%%%-XXXXXXXXX--XXXXXXXXXXXXXXXXXXXXXXXXXXXX-XX------XXXX------XXXXXXXXXXXXXXXXXXXXX
XXXXXXXXXXXXXXXXXXXXXXXXXXXXXXXXXXXXXXX-XXXXXXXXXX-||--------|||||||||-XXXXXXXXX--XXXXXXXXXXXXXXXXXXXXXXXXXXXX-XX------XXXX------XXXXXXXXXXXXXXXXXXXXX
