------------------------------------------------------------------------------------------------------------------------------------------------------
------------------------------------------------------------------------------------------------------------------------------------------------------
------------------------------------------------------------------------------------------------------------------------------------------------------
-------------------------------------------------------------------SSS------------------------------SSSSSSSSSS--------------------SSSSSSSS------------
------------------------------------------------------------------------------------------------------------------------------------------------------
----------------------ooor------------------------------------------------------K---------------------------------------------------------------------
---------------------%%%%%--------------------------------------CSS-----SSSSS---SS----1----------------------------oo---------------------------------
----------------------|||-----------------------------------------------------------------------------------------------------------------------------
----------------------|||--------------------------------B--SS--2------------------------------------------------------------SSS----------------------
----------------------|||--------------------------------b-----2-2------------------------------------------------------------------------------------
---------Q------!---%%%%%%%-----QQQQ-------------------SS#CS------2----------2--SS--------------TT---------TT--%%%%--%%%r--------------g##------------
--------------------||||||-----------K-BT-----TT---------------------------TT---------TT--------TT------#--TT---||----||%%%%%%---------###---------#--
--------------------||||||--o----------bT-----TT-----------K----------t----TT--T------TT--------TT-----##--TT---||----|||||||--------g####-----K---#--
--------------------||||||-%%%---------bT-----TT----------------------t----TT--T------TT----k---TT--kk-##--TT-o-||----|||||||--------#####---------#--
XXXXXXXXXXXXXXXXXXXX||||||--|-XXXXXXXXXXXXXX--XXXXXXXXXXXXXX---XXXXXXXXXXXXXXXXXXXXXXXXXXXXXXXXXXXXXXXXXX--XX-%-||----|||||||-----XXXXXXXX--XXXXX--XXX
XXXXXXXXXXXXXXXXXXXX||||||--|-XXXXXXXXXXXXXX--XXXXXXXXXXXXXX---XXXXXXXXXXXXXXXXXXXXXXXXXXXXXXXXXXXXXXXXXX--XX---||----|||||||-----XXXXXXXX--XXXXX--XXX
