------------------------------------------------------------------------------------------------------------------------------------------------------
------------------------------------------------------------------------------------------------------------------------------------------------------
------------------------------------------------------------------------------------------------------------------------------------------------------
---------------------------------------------------oo---------------------------------------------------------SSSSSSSSSS----------SSSSSSSS------------
--------------------------------------------------%%%%------------------------------------------------------------------------------------------------
---------------------------------------------------||----------------R--------------------------------oo----------------------------------------------
----------------------!----------------------------||-------------------------------y------------------------------------------SSS--------------------
---------------------------------------------------||--SSS------------------------#SSS----------------------------------------------------------------
---------------------------------------------------||----------------------------##-------------------------------------------------------------------
-----------------------------------oo--------------||--------------------1------###1--------------------------------------------K---------------------
--------SU---------%S@S!S---------o--o-------------||------------%%%--T---------###---------------------------T----------------SSS-----g##------------
---------------------------------------------------||-------------|---T----TT---###--SSS----------------------T------------------------###---------#--
----------------------------tt--------------------%||-------------|---T----TT---###--------------B----------ttT----TT----TT----------g####-----K---#--
--M----------%%%%----g------tt-----------------y---||-------------|---T---kTT---###--------------b----ggg---ttT--g-TT----TT----------#####---------#--
XXXXXXXXXXX---||----XXXXXXXXXXXXXXXXXXXXXXXXXXXXXX-||-------%%%%%-|---XXXXXXXXXXXXXXXX---XXXXXXXXXXXXXXXXXXXXXXXXXXXXXXXXXXXXXXXXXXXXXXXXX--XXXXX--XXX
XXXXXXXXXXX---||----XXXXXXXXXXXXXXXXXXXXXXXXXXXXXX-||--------|||--|---XXXXXXXXXXXXXXXX---XXXXXXXXXXXXXXXXXXXXXXXXXXXXXXXXXXXXXXXXXXXXXXXXX--XXXXX--XXX
