------------------------------------------------------------------------------------------------------------------------------------------------------
------------------------------------------------------------------------------------------------------------------------------------------------------
------------------------------------------------------------------------------------------------------------------------------------------------------
----------SSSSSSSSSS------------------------------SSSSSSSSSS----------------------------------------SSSSSSSSSS------------------------------SSSSSSSSSS
------------------------------------------------------SS--SS------------------------------------------------------------------------------------------
--------------------------------------oo--------------SS--SS------------------------------------------------------------------------------------------
-----------------------------U-----SSSS-------------SS---------------------g--------y-----SSS------%---------------------SSS----S!--------------------
----------------------------------------------------SS-----------------%%%%%%-----#SSS----------------------------------------------------------------
----------------------------------------------------SS------------------||||-----##------------------------------------y------------------------------
----------------------------------------------------SS----oo------------||||----###1-----------------------------------X------------------------------
----------@QQQQ-------------##%---------------------SSSS--SS------------||||----###---------%%%--------------T--------XX---------S---------#--TT------
-----------------------y-#####------------------------SS-------------T--||||----###--SSS-----|---------TT----T-------XXX------------------##--TT------
-----------------g-#y-######--------------------------SS-----B-------T--||||----###----------|---------TT----T------XXXX-----------------###--TT------
-M--------------g#-#######---------------------ggg-----------b-------T--||||----###----------|------g--TT----T-----XXXXX----gg-g-g---y--####--TT------
XXXXXXXXXXXXXXXXXXXXXXXX--------%%%%--%%-XXXXXXXXXXXXXXXXXXXXXXXXX--XX--||||----XXXXXX---X---|------XXXXXXXXXXXXXXXXXXXXXXXXXXXXXXXXXXXXXXXXXXXX--XXXX
XXXXXXXXXXXXXXXXXXXXXXXX---------||----|-XXXXXXXXXXXXXXXXXXXXXXXXX--XX--||||----XXXXXX---X---|------XXXXXXXXXXXXXXXXXXXXXXXXXXXXXXXXXXXXXXXXXXXX--XXXX
