------------------------------------------------------------------------------------------------------------------------------------------------------
------------------------------------------------------------------------------------------------------------------------------------------------------
------------------------------------------------------------------------------------------------------------------------------------------------------
--------------------SSSSSSSSSS------------------------------SSSSSSSSSS----------------------------------------SS-------S----------SSSSSSSSSS----------
------------------------------------------------------------SSSS--SSSS--------------------------------------------------------------------------------
----------------------------------------%%------------------SSSS--SSSS------------------oo------------------------------------------------------------
----------------------------------------|---------------------SS---S-------g----oo-------------------------------------S-SSS----S!-----------------SSS
----------------------------------------|----oo---------------SS---S---%%%%%%---------------------oooo------------------------------------------------
----------------------------------------|---------------------SS---S----||||---------------------------------------SSS--------------------------------
-----------------------------C-----oo---|-------------------ooSS---SoU--||||-----SS-------------------------------------------------------------------
-----------------------#-#--------o--o--|----------------tt-SSSS---SSS--||||-------------S-------------------T---------S---------S----------------#---
-----------------K---#-#-#-#------------|----------------tt-------------||||--------------------#------------T-##-------------------------TT------#---
------------B--------#-#-#-#------------|----------------tt-------------||||--------------------#------------T-##------------------tt-----TT------#---
-M----------b--------#-#-#-#-E----------|------------g-g-tt-k--g-g------||||--------------------#---------y--T-##-----------gg-g-g-tt----kTT-ggg--#---
XXXXXXXXXXXXXXXXXXXXXXXXXXXXXXXXXXXXXXXX|----%%%%-XXXXXXXXXXXXXXXXXXXX--||||--------------XXXXXXXXXXXXXXXXXXXX-XX------XXXXXXXXXXXXXXXXXXXXXXXXXXXXXXX
XXXXXXXXXXXXXXXXXXXXXXXXXXXXXXXXXXXXXXXX|-----||--XXXXXXXXXXXXXXXXXXXX--||||--------------XXXXXXXXXXXXXXXXXXXX-XX------XXXXXXXXXXXXXXXXXXXXXXXXXXXXXXX
