------------------------------------------------------------------------------------------------------------------------------------------------------
------------------------------------------------------------------------------------------------------------------------------------------------------
------------------------------------------------------------------------------------------------------------------------------------------------------
--------------------SSSSSSSSSS----------SSSSSSSSSS------------------------------------------------------------SSSSSSSSSS------------------------------
------------------------------------------------------------------------------------------------------------------------------------------------------
-------------------------------------------------------oooo-----------------------------------------oo------------------------------------------------
------------------------------S----------oooo----------%%%%----------------g---------1--------------%%%---------------------------%-------------------
--------------------------------------------------SSSS--||-------------%%%%%%-----------------------||--o----R----------------------------------------
-----------------------------------------SSSS-U---------||--------------||||------------------------||-%%%------------------------------SSS-----------
-----------------------------C----------oS--SoS---------||--------------||||------------------------||--|---------------SS-?Q-------------------------
-----SSS--------%%%%---#-#----##--SSC---SS--SSS---------||-----------T--||||-------QQQQ---------TT--||--|-----T-------------------%%%%%---------------
-----------------||--#-#-#-#--------------------------U-||-----------T--||||--------------------TT--||-o|-----T--------------------|||----------------
-----------------||--#-#-#-#----------------------------||-----------T--||||--------------------TT--||%%%%%---T----TT----------y---|||-------------F--
-----------------||--#-#-#-#-E------------kk------------||----ggg----T--||||--------yy------k---TT--||-|||----T--g-TT------SSSSS---|||-------------#--
XXXXXXXXXXX--%%%%||%XXXXXXXXXXXX--XXXXXXXXXXXXXXXX----%%%%%-XXXXXXXXXX--||||----XXXXXXXXXXXXXXXXXXXX||-|||----XXXXXXXXXX-------XX-%|||------XXXXXXXXXX
XXXXXXXXXXX---||-||-XXXXXXXXXXXX--XXXXXXXXXXXXXXXX-----|||--XXXXXXXXXX--||||----XXXXXXXXXXXXXXXXXXXX||-|||----XXXXXXXXXX-------XX--|||------XXXXXXXXXX
