------------------------------------------------------------------------------------------------------------------------------------------------------
------------------------------------------------------------------------------------------------------------------------------------------------------
------------------------------------------------------------------------------------------------------------------------------------------------------
------------------------------SSSSSSSSSS---------------------------SSS--------------------------------------------------------------------------------
------------------------------SSSSSSSSSS--------------------------------------------------------------------------------------------------------------
----------------------ooor----SSSSSSSSSS---------------oooo---------------------K---------------------------------------------------------------------
---------------------%%%%%----SSSSSSSSSS---------------%%%%-----CSS-----SSSSS---SS----1-----------------------?SSS-------------SSS-------##-----------
----------------------|||-------------------------------||-------------------------------------------------------------------------------##-----------
----------------------|||-------------------------------||--SS--2----------------------------------------------------------------------####-----------
----------------------|||-------------------------SSS---||-----2-2-----------------------------oooo-----------------------------K------####-----------
--------SU------!---%%%%%%%---SSSSSSSSSS------tt--------||--------2----------2--SS--------------------%%%%%%--SSSSS------------SSS---######-----------
--------------------||||||----SSSSSSSSSS------tt------U-||-----------------TT---------TT---------------||||--------------------------######--------#--
--------------------||||||--o-SSSSSSSSSS------tt--------||------------t----TT--T------TT---------------||||--------------TT----------######----K---#--
--M-----------------||||||-%%%SSSSSSSSSS-g----tt--------||------------t----TT--T------TT---------------||||-----K--------TT----------######--------#--
XXXXXXXXXXXXXXXXXXXX||||||--|-XXXXXXXXXXXXXXXXXXXX----%%%%%----XXXXXXXXXXXXXXXXXXXXXXXXXXX%%%%%%%-%%%%-||||-%%XXXXXXXXXXXXXXXXXXXXXXXXXXXXXXXXXXX--XXX
XXXXXXXXXXXXXXXXXXXX||||||--|-XXXXXXXXXXXXXXXXXXXX-----|||-----XXXXXXXXXXXXXXXXXXXXXXXXXXX||||||---||--||||--|XXXXXXXXXXXXXXXXXXXXXXXXXXXXXXXXXXX--XXX
