------------------------------------------------------------------------------------------------------------------------------------------------------
------------------------------------------------------------------------------------------------------------------------------------------------------
------------------------------------------------------------------------------------------------------------------------------------------------------
------------------------------------------------------------------------------------------------------------------------------------------------------
--------------------------------------------?---------------------------------------------------------------------------------------------------------
---------------------------------------------------------------------R----------------------oo--------------------------------------------------k-----
----------------------------------------------------------------------------SSSS-----SSSS--------------------------oo---SS---------------##----SQS--SQ
----------------------------------------------r------------------------------------------------------------------------------------------##-----------
-----------------g------------------------%%%%%%---------B-----------------------------------------%-----------------------------------####-----------
-----------------#-------------------------||||----------b-------------------K---------------------------------------------TT----------####-----------
----------S-----##----------------------%%-||||ooo-----SS#CS-----%%%-------SSSSSQ---------S--------------------%%%%--%%%---TT--------######----SQS--S?
---------------###--------------------tt|--||||--r----------------|---T-----------------------------------------||----||t--TT--------######-----------
--------------####--------------------tt|%%%%%%%%%---------K------|---T----------------------%%%%---------*-----||----||t--TT--------######-----------
-M-----------#####-------ggg----------tt|-||||||||----------------|---T----------ggg----------||----gg----*---o-||----||t--TT--------######--k------gg
XXXXXXXXXXXXXXXXXXXXXXXXXXXXXXXXXXXXXXXX|-||||||||XXXXXXXXXX%%%%%-|---XXXXXXXXXXXXXXX----X----||----XXXXXXXXX-%-||----||XXXXXXXXXXXXXXXXXXXXXXXXXXXXXX
XXXXXXXXXXXXXXXXXXXXXXXXXXXXXXXXXXXXXXXX|-||||||||XXXXXXXXXX-|||--|---XXXXXXXXXXXXXXX----X----||----XXXXXXXXX---||----||XXXXXXXXXXXXXXXXXXXXXXXXXXXXXX
