------------------------------------------------------------------------------------------------------------------------------------------------------
------------------------------------------------------------------------------------------------------------------------------------------------------
------------------------------------------------------------------------------------------------------------------------------------------------------
--------------------------------------------------SSSSSSSSSS--------------------SSSSSSSSSSSSSSSSSSSS--------------------------------------------U-----
------------------------------------------------------SS--SS------------------------------------------------------------------------------------------
----------------------ooor----------------------------SS--SS------------------------------------------------------------------------------------------
------------------SC-%%%%%--------------------------SS------------------SSSSS-------------------------------------------------------------------------
----------------------|||---------------------------SS--------------------------------------------------------------------------oo----------------SS--
----------------------|||---------------------------SS------------------------------------------------------------------------------------------------
----------------------|||---------------------------SS----oo----1----------------------S------------------------------------------------------SS------
--------------TT---2%%%%%%%----TT-------------------SSSS--SS-----------------2--SU-------------------------------------------TT----------------------#
--------------TT----||||||-----TT---------------------SS-------------------TT-------TT---tt-----------TT---------------------TT---------------------##
--------------TT----||||||--o--TT---------------------SS--------------t----TT--T----TT---tt-----------TT----TT---------------TT--------------------###
-M------------TT----||||||-%%%gTT--------------y----------------------t----TT--T---kTT--ktt-----------TT-k--TT-k----kkk--y---TT-------------------####
XXXXXXXXXXXXXXXXXXXX||||||--|-XXXXXXXX--XXXXXXXXXXXXXXXXXXXXXXXXXXXXX-XXXXXXXXXXXXXXXXXXXXXXXXXXXXXXXXXXXXXXXXXXXXXXXXXXXXXXXXXXXXXXXXXXXXXXXXXXX-XXXX
XXXXXXXXXXXXXXXXXXXX||||||--|-XXXXXXXX--XXXXXXXXXXXXXXXXXXXXXXXXXXXXX-XXXXXXXXXXXXXXXXXXXXXXXXXXXXXXXXXXXXXXXXXXXXXXXXXXXXXXXXXXXXXXXXXXXXXXXXXXX-XXXX
