------------------------------------------------------------------------------------------------------------------------------------------------------
------------------------------------------------------------------------------------------------------------------------------------------------------
------------------------------------------------------------------------------------------------------------------------------------------------------
----------SSSSSSSSSS-----------------------------------------------SSS--------------------------------------------------SSS-----SS----------SSSSSSSSSS
------------------------------------------------------------------------------------------------------------------------------------------------------
----------------------ooor-----------------------------oooo---------------------------------oo--------------------------------------------------------
---------------------%%%%%-----------------------------%%%%-----CSS------------------SUS--------------------------------US----------------------------
----------------------|||-------------------------------||--------------------------------------------------------------------------------------------
----------------------|||-------------------------------||--SS--2----------------------------------%------------------------SSS------g#---------------
----------------------|||-------------------------SSS---||-----2-2-------1----------------------------------------------------------g##---------------
--------------------%%%%%%%-----------------------------||--------2---T-------------#####-S---------------------------r-SSS---------###-------TT------
--------------------||||||------------K---------------U-||------------T----TT-------#-----------------------------%%%%%%-----------####-------TT------
--------------------||||||--o-TTTT----------------------||------------T----TT------K#--------%%%%---------*--------|||||----------#####-------TT------
-M------------------||||||-%%%TTTT-------------ggg------||------------T---kTT-------#---------||----gg----*--------|||||----------#####-------TT------
XXXXXXXXXXX--XX--X--||||||--|-XXXXXXXXXX-XXXXXXXXX----%%%%%----XXXXXXXXXXXXXXXXXXXXXXXX-------||----XXXXXXXXX--%%%-|||||XXX------XXXXXX--XXXXXXX--XXXX
XXXXXXXXXXX--XX--X--||||||--|-XXXXXXXXXX-XXXXXXXXX-----|||-----XXXXXXXXXXXXXXXXXXXXXXXX-------||----XXXXXXXXX---|--|||||XXX------XXXXXX--XXXXXXX--XXXX
