------------------------------------------------------------------------------------------------------------------------------------------------------
------------------------------------------------------------------------------------------------------------------------------------------------------
------------------------------------------------------------------------------------------------------------------------------------------------------
----------------------------------------SSSSSSSSSS-----------------SSS----------------------------------------SSSSSSSSSSSSSSSSSSSS--------------------
----------------------------------------SSSSSSSS------------------------------------------------------------------------------------------------------
----------------------ooor--------------SSSCSSSS------------------------------------------------------------------------------------------------------
---------------------%%%%%--------------SSSSSSSS---------Q-Q----CSS-----------------y------------------------R----------------------------------------
----------------------|||---------------------------------------------------------#SSS---------------r------------------------------------------------
----------------------|||-----------------------------------SS--2-----o----------##-----------------%%%%%%%-------------------------------------------
----------------------|||------------------ggg-----------------2-2--------------###1--------------oo||||||--------------------------------------------
---------Q----------%%%%%%%----TT-------SSSSSSSS---------Q-Q------2-------------###-----------------||||||----T---------------------------------------
--------------------||||||-----TT-------SSSSSSSS------------------------------#-###--SSS-------TT---||||||----T-----------SS--------------------------
--------------------||||||--o--TT-------SSSSSSSS-----------------------------##-###------------TT---||||||----T----TT-----SS-----------------------F--
--------------k-ggg-||||||-%%%gTT-------SSSSSSSS--------------------------------###---------y--TT---||||||--ooT--g-TT-----SS-----------------------#--
XXXXXXXXXXXXXXXXXXXX||||||--|-XXXXXXXX--XXXXXXXXXXXXXXXXXXXX---XXXXXXXXXXXXXXXXXXXXXXX---XXXXXXXXXXX||||||--%%XXXXXXXXXX--XX--XXXXXXXXXXXXXXXXXXXXXXXX
XXXXXXXXXXXXXXXXXXXX||||||--|-XXXXXXXX--XXXXXXXXXXXXXXXXXXXX---XXXXXXXXXXXXXXXXXXXXXXX---XXXXXXXXXXX||||||---|XXXXXXXXXX--XX--XXXXXXXXXXXXXXXXXXXXXXXX
