------------------------------------------------------------------------------------------------------------------------------------------------------
------------------------------------------------------------------------------------------------------------------------------------------------------
------------------------------------------------------------------------------------------------------------------------------------------------------
---------------------------------------------------oo--------------SSS--------------------------------------------------------------------------------
--------------------------------------------------%%%%------------------------------------------------------------------------------------------------
---------------------------------------------------||-----------------------------g-------------------------------------------------------------------
--------------------S------------------------------||-----------CSS-------------SSSSSSSS----------------SSQSSS-----oo----------SSS----------SS--------
---------------------------TT----------------------||--SSS----------------------------------------oo--------------------------------------------------
---------------------------TT----------------------||-------SS--2-------------------------------------------------------------------------------------
------------Q--?-----------XX------oo--------------||----------2-2----------------------------------------K---------------------K---------------------
---------Q---------S---TT---------o--o-------------||-------------2-------------------------------------SSSSSS-%%%%--%%%-------SSS----------SS--------
-----------------------TT--------------------------||-------------------------------------------#---------------||----||--------------------------#-TT
-----------------------TT-------------------------%||-------------------------------------------#---------------||----||-TT----------------------##-TT
-M----------------K-k--TT--------------------------||-------------------------------------------#-------------o-||----||-TT---------------------###-TT
XXXXXXXXXXXXXXXXXXXXXXXXXXXXXXXXXXXXXXXXX-XX-XX-XX-||----------XXXXXXXX----XXXXXXXXXXX---XXXXXXXXXXXXXXXXXXXXX%-||----||XXXXXXXXXXXXXXXXXXXXXXXXXXX-XX
XXXXXXXXXXXXXXXXXXXXXXXXXXXXXXXXXXXXXXXXX-XX-XX-XX-||----------XXXXXXXX----XXXXXXXXXXX---XXXXXXXXXXXXXXXXXXXXX--||----||XXXXXXXXXXXXXXXXXXXXXXXXXXX-XX
