------------------------------------------------------------------------------------------------------------------------------------------------------
------------------------------------------------------------------------------------------------------------------------------------------------------
------------------------------------------------------------------------------------------------------------------------------------------------------
------------------------------------------------------------------------------------------------------------------------------------------------------
------------------------------------------------------------------------------------------------------------------------------------------------------
------------------------------------------------------------------------------------------------------------------------------------------------------
------------------------------S-----------------------------------SSoo-------------USS-----SSS!--------------------oo-----SSC------SSSS------------SSS
------------------------------------------------------------------------------------------------------------------------------------------------------
---------------------------------------------------------TT-------------------------------------------------------------------------------------------
---------------------------------------------------TT----TT--------------1------------------------------------------------SSS----------SSSS-----------
----------Q---------SS--------##--SSC--------------TT----XX-%%%%%%----T-----------#-----------C----------------%%%%--%%%--------------------------#---
---------------------K---TT------------------------TT--------||||-----T----TT-----#-----------------------------||----||--------------------------#---
-------------------------TT------------------------TT--------||||-----T----TT-----##----------------------*-----||----||--------------------------#---
-M-----------------#-----TT-----------------y-y----TT--------||||-----T---kTT-----##--gg-------g-g--gg----*---o-||----||---------#-----------ggg--#---
XXXXXXXXXXXXX--XXXXXXXXXXXXXXXXX--XXXXXXXXXXXXXXXXXXXXXXXXXX-||||-----XXXXXXXXXX--XXXXXXXXXXXXXXXXXXXXXXXXXXX-%-||----||X----XXXXX---------XXXXXXXXXXX
XXXXXXXXXXXXX--XXXXXXXXXXXXXXXXX--XXXXXXXXXXXXXXXXXXXXXXXXXX-||||-----XXXXXXXXXX--XXXXXXXXXXXXXXXXXXXXXXXXXXX---||----||X----XXXXX---------XXXXXXXXXXX
