------------------------------------------------------------------------------------------------------------------------------------------------------
------------------------------------------------------------------------------------------------------------------------------------------------------
------------------------------------------------------------------------------------------------------------------------------------------------------
-----------------------oo---------------SSSSSSSSSS------------------------------------------------------------------------------------------SSSSSSSSSS
----------------------------------------SSSSSSSS------------------------------------------------------------------------------------------------------
----------------------------------------SSSCSSSS----------------------------------------oo------------------------------------------------------------
----------------------SSSS----S---------SSSSSSSS---------------------------g----oo--------------------------------------------------------------------
-----------------------------------------------------------------------%%%%%%-------------------------------------------------------------------------
------------------------------------------------------------------------||||---------------------------------------------------------g#---------------
-------------------------------------------ggg------------------1-------||||-----SS-------------------------------------------------g##---------------
--------------------------%%%%##--SSC---SSSSSSSS---------tt-------------||||-------------S------------%%%%%%------------------------###-------TT------
---------------------------|||----------SSSSSSSS---------tt-------------||||---------------------------||||------------------------####-------TT------
---------------------------|||----------SSSSSSSS---------tt-------------||||---------------------------||||--------B--------------#####-------TT------
-M------------k-ggg--------|||----------SSSSSSSS-----g-g-tt-------------||||-----------------------g---||||--------b-----k----ggg-#####-------TT------
XXXXXXXXXXXXXXXXXXXX%%%----|||XX--XXXXXXXXXXXXXXXXXXXXXXXXXXXXXXXXXXX---||||---------------XXXXXXXXX%%-||||-%%XXXXXXXXXXXXXXXXXXXXXXXXX--XXXXXXX--XXXX
XXXXXXXXXXXXXXXXXXXX||-----|||XX--XXXXXXXXXXXXXXXXXXXXXXXXXXXXXXXXXXX---||||---------------XXXXXXXXX|--||||--|XXXXXXXXXXXXXXXXXXXXXXXXX--XXXXXXX--XXXX
