------------------------------------------------------------------------------------------------------------------------------------------------------
------------------------------------------------------------------------------------------------------------------------------------------------------
------------------------------------------------------------------------------------------------------------------------------------------------------
----------SSSSSSSSSSSSSSSSSSSS----------------------------------------SSSSSSSSSS----------------------------------------------------------------------
----------------------------------------------------------------------------SSSS----------------------------------------------------------------------
-------------------------------------------------------oooo--------------g--SSSS--------------------oo-------------k----------------------------------
-------------------------------------------------------%%%%-------------SS--------------------------%%%-------S---SSSSSS---------------------------SSS
--------------------------------------------------------||--------------SS------------------------oo||--o----R----------------------------------------
--------------------------------------------------------||--------------SS--------------------------||-%%%--------------------------------------------
-----------------------------C--------------------SSS---||--------------SC--g-g---o-----------------||--|---------------------------------------------
----------@QQQQ--------#-#--------------------tt--------||--------------SS--SSSS-------TT-----------||--|-----------------------------------------#---
---------------------#-#-#-#-----------T------tt------U-||-----------------------------TT-------#---||-o|-----------------------------------------#---
-----------------g-#-#-#-#-#-----------T------tt--------||-----------------------------TT-------#---||%%%%%---TT----------------------------------#---
----------------g#-#-#-#-#-#-E-------kkT-g----tt--------||--gg-------g-----------------TT-------#---||-|||----TT---------k----ggg------------ggg--#---
XXXXXXXXXXXXXXXXXXXXXXXXXXXXXXXXXXXXXXXXXXXXXXXXXX----%%%%%-XXXXXXXXXXXXXXXXXXXXXXXXXXXXXXXXXXXXXXXX||-|||----XXXXXXXX--XXXXXXXXXXXXXXXXXXXXXXXXXXXXXX
XXXXXXXXXXXXXXXXXXXXXXXXXXXXXXXXXXXXXXXXXXXXXXXXXX-----|||--XXXXXXXXXXXXXXXXXXXXXXXXXXXXXXXXXXXXXXXX||-|||----XXXXXXXX--XXXXXXXXXXXXXXXXXXXXXXXXXXXXXX
