------------------------------------------------------------------------------------------------------------------------------------------------------
------------------------------------------------------------------------------------------------------------------------------------------------------
------------------------------------------------------------------------------------------------------------------------------------------------------
----------SSSSSSSSSS--------------------SSSSSSSSSSSSSSSSSSSS--------------------SSSSSSSSSSSSSSSSSSSS--------------------------------------------------
----------------------------------------SSSSSSSS------SS--SS------------------------------------------------------------------------------------------
-----------------------SSS--------------SSSCSSSS------SS--SS------------------------------------------------------------------------------------------
----------------------------------------SSSSSSSS----SS----------------------SSSS-----------------------------R---------------------------##-----------
---------------------g------------------------------SS---------------------------------------------------r-------SSS---------------------##-----------
--------------------%%%-----------------------------SS----------------------------------------------%%%%%%%----------------------------####-----------
--------------------||----SSS--------------ggg------SS----oo-----------------K---------S------------||||||--------------SS-?Q----------####-----------
--------------------||------------------SSSSSSSS----SSSS--SS---------#-----SSSSSSU------------------||||||---------------------------######-#---------
--------------------||-----------------TSSSSSSSS------SS------------##T-------------TT---tt---------||||||---------------------------######-##--------
--------------------||-----------------TSSSSSSSS------SS----TT-----###T-------------TT---tt---------||||||---------------------y-----######-###------#
-M------------------||----oo---------kkTSSSSSSSS------------TT----####T------------kTT--ktt---------||||||--oo-------------SSSSS-----######-####----##
XXXXXXXXXXX--XX--X--||---%%%--XXXXXXXXXXXXXXXXXXXXXXXXXXXXXXXXXXXXXXXXXXXXXXXXXXXXXXXXXXXXXXXXXXXXXX||||||--%%%%%%----%%-------XX-XXXXXXXXXXXXXXXXXXXX
XXXXXXXXXXX--XX--X--||----|---XXXXXXXXXXXXXXXXXXXXXXXXXXXXXXXXXXXXXXXXXXXXXXXXXXXXXXXXXXXXXXXXXXXXXX||||||---||||------|-------XX-XXXXXXXXXXXXXXXXXXXX
