------------------------------------------------------------------------------------------------------------------------------------------------------
------------------------------------------------------------------------------------------------------------------------------------------------------
------------------------------------------------------------------------------------------------------------------------------------------------------
----------SSSSSSSSSS------------oo---------------------------------SSS--------------------------------------------------------------------------------
---------------------------------------g-------------------------------------------------------------------------------------------------------------o
-----------------------------------%%%%%---------------------------------------------------------------------------k----------------------------------
------------------------------------||||------------------------CSS----------------USS------------------------S---SSSSSSSSS---------------------------
------------------------------------||||------------------------------------------------------------------------------------------oo------------SSS---
------------------------------------||||--------------------SS--2---------------------------------------------------------------------------oo--------
------------------------------%%%%%-||||-----------------o-----2-2------------------------------------------------------------------------------------
-----SSS-----------------------|||--||||-TT---SU------------------2---------------#-------------TT-----------------------------------------QSS--------
-------------------------------|||--||||-TT---------------------------------------#-------------TT----------------------------------------------------
-------------------------------|||--||||-TT---------------------------------------##------------TT--------*---TT--------------TT----------------------
-------------------------ggg---|||--||||-TT------k--k-----------------------------##--gg----k---TT--gg----*---TT--------------TT----------------------
XXXXXXXXXXX--XX--X--XXXXXXXXXX-|||--||||XXXXXXXXXX-XXXXXXXXX---XXXXXXXX----XXXXX--XXXXXXXXXXXXXXXXXXXXXXXXXXX-XXXXXXXX------XXXXXXXXXXXXXXXX----------
XXXXXXXXXXX--XX--X--XXXXXXXXXX-|||--||||XXXXXXXXXX-XXXXXXXXX---XXXXXXXX----XXXXX--XXXXXXXXXXXXXXXXXXXXXXXXXXX-XXXXXXXX------XXXXXXXXXXXXXXXX----------
