------------------------------------------------------------------------------------------------------------------------------------------------------
------------------------------------------------------------------------------------------------------------------------------------------------------
------------------------------------------------------------------------------------------------------------------------------------------------------
--------------------------------------------------SSSSSSSSSS------------------------------------------------------------------------------------------
------------------------------------------------------SS--SS------------------------------------------------------------------------------------------
------------------------------------------------------SS--SS------------------------------------------------------------------------------------------
----------------------------------------------QQQQ--SS---------------------g---------1-----SSS!--------------@?SSS--------oo---%%%--------------------
----------------------------------------------------SS-------o---o---o-%%%%%%---------------------------------------------SS----||--------------------
----------------------------------------------------SS------%%%-%%%-%%--||||----------------------------------------------------||--------------------
------------------------------------------------k---SS----oo-|---|---|--||||----------------------------------------------------||--------------------
----------Q--------------------TT-------T-----?QQQ--SSSS--SS-|---|---|--||||-------QQQQ-------C-----SU----!--!SSSSS----------SS-||--------------------
-------------------------------TT-------T-------------SS-----|---|---|--||||----------------------------------------------------||--------------------
-------------------------------TT-------T-------------SS-----|---|---|--||||----------------------------------------------------||-----------------F--
---M---------------#----------gTT-------T--------------------|---|-r-|--||||--------yy---------g-g--------k-----K---------------||-----------------#--
XXXXXXXXXXXXX--XXXXXXXXXX--XXXXXXXXXXX--XXXXXXXXXXXXXXXXXXXX%%%%%%%%%%--||||----XXXXXXXXXXXXXXXXXXXXXXXXXXXXXXXXXXXXXXXX%%-----%%%XXXXXXXXXXXXXXXXXXXX
XXXXXXXXXXXXX--XXXXXXXXXX--XXXXXXXXXXX--XXXXXXXXXXXXXXXXXXXX-|||||||||--||||----XXXXXXXXXXXXXXXXXXXXXXXXXXXXXXXXXXXXXXXX|-------||XXXXXXXXXXXXXXXXXXXX
