------------------------------------------------------------------------------------------------------------------------------------------------------
------------------------------------------------------------------------------------------------------------------------------------------------------
------------------------------------------------------------------------------------------------------------------------------------------------------
----------------------------------------------------------------------------------------------------SSSSSSSSSS----------------------------------U-----
------------------------------------------------------------------------------------------------------------------------------------------------------
------------------------------------------------------------------------------------------------------------------------------------------------------
------------------------------S------------------------------------------------------SUS---------------------------oo------------------US-------------
--------------------------------------------------------------------------------------------------------------------------------------------------SS--
-----------------g---------------------------------------B------------o-------------------------------------------------------------------------------
-----------------#---------------------------------------b---------------------------------o-----------------------------------SSS---SS-------SS------
----------S-----##------------##--SSC----TT---SU-------SS#CS------------------------#####--------TT--------TT--%%%%--%%%%------------------S---------#
---------------###-----------------------TT-----------------------------------#-----#------------TT-----#--TT---||----||----------------------------##
--------------####-----------------------TT----------------K-----------------##----K#------------TT----##--TT---||----||----------TT---------------###
-M-----------#####-----------------------TT------k-----------y----------------------#------------TT-kk-##--TT-o-||----||---------rTT--------------####
XXXXXXXXXXXXXXXXXXXXXXXXX--XXXXX--XXXXXXXXXXXXXXXXXXXXXXXXXXXXXXXXXXXXXXXXXXXXXXXXXXXXX---XXXXXXXXXXXXXXX--XX-%-||----||----XXXXXXXXXXXX-X-XXXXXX-XXXX
XXXXXXXXXXXXXXXXXXXXXXXXX--XXXXX--XXXXXXXXXXXXXXXXXXXXXXXXXXXXXXXXXXXXXXXXXXXXXXXXXXXXX---XXXXXXXXXXXXXXX--XX---||----||----XXXXXXXXXXXX-X-XXXXXX-XXXX
