------------------------------------------------------------------------------------------------------------------------------------------------------
------------------------------------------------------------------------------------------------------------------------------------------------------
------------------------------------------------------------------------------------------------------------------------------------------------------
S-----SSSS--------------------------------------------------------------------------------------------------------------------------------------------
S-----------------------------------------------------------------------------------------------------------------------------------------------------
S-----------------------------------------------------------------------------------------------------oo----------------------------------------------
S-------------------------------------------------------------USSS------SSSSS------o--o-----------------------------------oo---%%%--------------------
S-------------------------------------------------------------------------------------------------------------------------SS----||--------------------
S--------------------------------------------------------B----------------------------------------------------------------------||--------------------
S--------------------------------------------------------b-------------------------SSSS---------g-------------------------------||--------------------
S---------------!-----------TT-------------------------SS#CS-S-----TT--------2------------------TT---------------------------SS-||--------------------
S---------------------------TT---------TT-----TT-------------------TT------TT-------------------TT------------------------------||-----------------#--
S---------------------------TT---------TT-----TT-----------K-------TT-t----TT--T%%%-------------TT----------tt------------------||-------------K---#--
S--M--------------------ggg-TT-------kkTT-----TT-------------ggg---TT-t----TT--T||--------------TT----ggg---tt-k----kkk---------||-----------------#--
XXXXXXXXXXXXXXXXXXXXXXXXXXXXXXXXXXXXXXXXXXXX--XXXXXXXXXXXXXXXXXXXXXXXXXXXXXXXXXX||--------XXXXXXXXX-XXXXXXXXXXXXXXXXXXXX%%-----%%%XXXXXXXXXXXXXXX--XXX
XXXXXXXXXXXXXXXXXXXXXXXXXXXXXXXXXXXXXXXXXXXX--XXXXXXXXXXXXXXXXXXXXXXXXXXXXXXXXXX||--------XXXXXXXXX-XXXXXXXXXXXXXXXXXXXX|-------||XXXXXXXXXXXXXXX--XXX
