------------------------------------------------------------------------------------------------------------------------------------------------------
------------------------------------------------------------------------------------------------------------------------------------------------------
------------------------------------------------------------------------------------------------------------------------------------------------------
----------------------------------------------------------------------------------------------------SSSSSSSSSS----------------------------------------
------------------------------------------------------------------------------------------------------------------------------------------------------
----------------------------------------%%----------------------------------------------oo------------------------------------------------------------
----------------------------------------|---------Q-----------USSS--------------oo----------------------------?SSS------------------------------------
----------------------------------------|----oo-------------------------------------------------------------------------------------------------------
-----------------g----------------------|-------------------------------------------------------------------------------------------------------------
-----------------#----------------------|----------------------------------------SSS-------------------------------------------SSS--------------------
----------S-----##-------------TT-------|---------Q----------S-----TT--------------------S-------------------TSSSSS-----%-----------------------------
---------------###-------------TT-------|--------------------------TT----------------------------------TT----T----------------------------------------
--------------####-------------TT-------|--------------------------TT----------------------------------TT----T-------------------------------------F--
-M-----------#####------------gTT-------|------------gg----k-ggg---TT-gg---------------------------gg--TT----T--K----------------rk----------------#--
XXXXXXXXXXXXXXXXXXXXXXXXX--XXXXXXXXXXX--|----%%%%-XXXXXXXXXXXXXXXXXXXXXXXXXXXXXX-----------XXXXXXXXXXXXXXXXXXXXXXXXXXXXX----XXXXXXXX---XXXXXXXXXXXXXXX
XXXXXXXXXXXXXXXXXXXXXXXXX--XXXXXXXXXXX--|-----||--XXXXXXXXXXXXXXXXXXXXXXXXXXXXXX-----------XXXXXXXXXXXXXXXXXXXXXXXXXXXXX----XXXXXXXX---XXXXXXXXXXXXXXX
