------------------------------------------------------------------------------------------------------------------------------------------------------
------------------------------------------------------------------------------------------------------------------------------------------------------
------------------------------------------------------------------------------------------------------------------------------------------------------
----------SSSSSSSSSS------------------------------------------------------------------------------------------SSSSSSSSSS------------------------------
--------------------------------------------------?---------------------------------------------------------------------------------------------------
----------------------ooor----------------------------------------------------------------------------------------------------------------------------
---------------------%%%%%-------------------------------------------------g-------o--o-------------------------------------------SS--------SSS-------
----------------------|||-------------------------SS-------------------%%%%%%-----------------------oo------------------------------------------------
----------------------|||-----------------------------------------------||||-------------------------------------------------SSS----------------------
----------------------|||---------------------------------------1-------||||-------SSSS----o-----------------------------------------------------SSSSS
----------@QQQQ-----%%%%%%%---------------------------------------------||||---------------------TT----------TT---------r---------SS------------------
--------------------||||||------------K-T-----TT-------SSS--------------||||---------------------TT----------TT---------%%%%%%----K---#----B----------
-----------------g-#||||||--o-TTTT------T-----TT------------------------||||----%%%--------------TT----------TT----TT---|||||---------#----bSSS-------
-M--------------g#-#||||||-%%%TTTT------T-----TT------------------------||||----||---------------TT-------y--TT--g-TT---|||||---------#----B-------r--
XXXXXXXXXXXXXXXXXXXX||||||--|-XXXXXXXXXXXXXX--XXXX----------XXXXXXXXX---||||----||--------XXXXXXXXXXXXXXXXXXXXXXXXXXXXXX|||||-----XXXXXXXXXX-----XXXXX
XXXXXXXXXXXXXXXXXXXX||||||--|-XXXXXXXXXXXXXX--XXXX----------XXXXXXXXX---||||----||--------XXXXXXXXXXXXXXXXXXXXXXXXXXXXXX|||||-----XXXXXXXXXX-----XXXXX
