------------------------------------------------------------------------------------------------------------------------------------------------------
------------------------------------------------------------------------------------------------------------------------------------------------------
------------------------------------------------------------------------------------------------------------------------------------------------------
----------------------------------------------------------------------SSSSSSSSSS--------------------SSSSSSSSSS--------------------SSSSSSSSSS----------
------------------------------------------------------------------------------------------------------------------------------------------------------
--------------------------------------ooooooo-----------------------------------------------oo--------------------------------------------------------
-----------------------------------SSSS----------------------------------------------SSSS-------------------------------------------------------------
------------------------------------------------SS----------------------------TT---------------------------------SSS----------------------------------
-----------------------------------------SSSS---------------------------------TT-------------------%--------------------------SSS---------------------
---------------------------------------------------------o--------------------TT----------------------------------------------------------------------
----------------!-------------%--------------------------------------#------SCTTQ---------S----------------TT-----------%---------------------#LSS----
--------------------------------------------------------------------##--TT----TT------------------------#--TT-----------------------------TT--#-------
--------------------------------------------%%%%%-----------TT-----###--TT----TT-------------%%%%------##--TT----------------------tt-----TT--#-------
-M-------------------------------------------|||----k-------TT----####--TT---kTT-ggg----------||----kk-##--TT--------------------r-tt----kTTkk#-------
XXXXXXXXXXXXXXXXXXXXXXXXX--XXX--%%%%--%%%%---|||---XXXXXXXXXXXXXXXXXXXXXXXXXXXXXXXXXX----X----||----XXXXX--XX-%%%%----%%----XXXXXXXXXXXXXXXXXXXXXXX---
XXXXXXXXXXXXXXXXXXXXXXXXX--XXX---||----||----|||---XXXXXXXXXXXXXXXXXXXXXXXXXXXXXXXXXX----X----||----XXXXX--XX-|||------|----XXXXXXXXXXXXXXXXXXXXXXX---
