------------------------------------------------------------------------------------------------------------------------------------------------------
------------------------------------------------------------------------------------------------------------------------------------------------------
------------------------------------------------------------------------------------------------------------------------------------------------------
---------------------------------------------------oo-------------------------------------------------------------------SSSSSSSSSS--------------------
--------------------------------------------------%%%%-----------------------------------------------------------------------------------------------o
---------------------------------------------------||----------------R--------------------------------------------------------------------------------
-----------------------------U---------------------||-------------------SSSSS------USS-------------------------------------------------US-------------
---------------------------------------------------||--SSS--------------------------------------------------------------------------------------SSS---
---------------------------------------------------||---------------------------------------------------------------------------------------oo--------
-----------------------------------oo--------------||--------------------------------------o-----------------------------------------SS---------------
----------------%%%%--------##----o--o-------------||------------%%%---------2----#--------------TT-------------------r--------------------SSS--------
-----------------||----y-#####----------T-----TT---||-------------|--------TT-----#--------------TT---------------%%%%%%--SS--------------------------
-----------------||-y-######------------T-----TT--%||-------------|---t----TT--T--##-------------TT-------*--------|||||--SS------TT------------------
-M---------------||-######--------------T-----TT---||-------------|---t----TT--T--##--gg---------TT-gg----*--------|||||--SS------TT------------------
XXXXXXXXXXX--%%%%||%XXXX------XXXXXXXXXXXXXX--XXXX-||-------%%%%%-|---XXXXXXXXXX--XXXXXXXXXXXXXXXXXXXXXXXXXXX--%%%-|||||--XX--XXXXXXXXXX-X-X----------
XXXXXXXXXXX---||-||-XXXX------XXXXXXXXXXXXXX--XXXX-||--------|||--|---XXXXXXXXXX--XXXXXXXXXXXXXXXXXXXXXXXXXXX---|--|||||--XX--XXXXXXXXXX-X-X----------
