------------------------------------------------------------------------------------------------------------------------------------------------------
------------------------------------------------------------------------------------------------------------------------------------------------------
------------------------------------------------------------------------------------------------------------------------------------------------------
--------------------------------------------------------------------------------SSSSSSSSSS----------SSSSSSSSSS----------------------------------------
------------------------------------------------------------------------------------------------------------------------------------------------------
------------------------------------------------------------------------------------------------------------------------------------------------------
---------------------------------------------------------------------------1---------------------------------------oo-----SSC------------##-SSS-------
-----------------------------------------------------------------------------------------------------------------------------------------##-----------
---------------------------------------------------------------------o-----------------------------------------------------------------####-----------
-----------------------------------------------------------------y---------ggg---------S--------g-------------------------SSS----------####------SSSSS
---------Q---------%SS-----------------T---------------ooo-------##---#########-SU--------------TT-----------T-%%%%--%%%-------------######-----------
---------------------K---TT------------TT-----TT----------------###-----------#-----TT---t------TT-----TT----T--||----||-------------######-----------
-------------------------TT------------TT-----TT---------------####-----------#-----TT---t------TT-----TT----T--||----||-------------######-SSS-------
-------------%%%%--------TT-----gg-----TT-----TT--------------#####-----------#----kTT--kt------TT--g--TT----To-||----||---------#---######--------r--
XXXXXXXXXXX---||----XXXXXXXXXXXXXXXXXXXXXXXX--XXXX--XXXXXXXXXXXXXXX-----------X-XXXXXXXXXXXXXXXXXXX-XXXXXXXXXX%-||----||X----XXXXXXXXXXXXXXX-----XXXXX
XXXXXXXXXXX---||----XXXXXXXXXXXXXXXXXXXXXXXX--XXXX--XXXXXXXXXXXXXXX-----------X-XXXXXXXXXXXXXXXXXXX-XXXXXXXXXX--||----||X----XXXXXXXXXXXXXXX-----XXXXX
