------------------------------------------------------------------------------------------------------------------------------------------------------
------------------------------------------------------------------------------------------------------------------------------------------------------
------------------------------------------------------------------------------------------------------------------------------------------------------
--------------------------------------------------SSSSSSS---------------------------------------------------------------------------------------------
------------------------------------------------------------------------------------------------------------------------------------------------------
--------------------------------------oo--------------------------------------------------------------------------------------------------------k-----
--------------------USS------------SSSS-----------QQ----------------------SS--------------------------------------------SS---------------------SQS--SQ
------------------------------------------------------------------------------------------------------------------------------------------------------
-----------------------------------------------------------S---------o--------------------------------------------------------------------------------
-----------------------------------------------------------------y----------------o------------oooo------------------------TT-------------------------
------------------------------%---------------tt--QQ--QQQ--------##---SS-----SS--------TT----------------------------------TT------------------SQS--S?
---------------------B------------------------tt----------------###--------------------TT-------------------------------t--TT-------------------------
---------------------b-------B----------------tt---------------####--------------------TT-----------------*-------------t--TT-------------------------
-M------------k-ggg--B-------b-----------g----tt--------------#####--------------------TT-----------gg----*----k----kkk-t--TT-----k----------k------gg
XXXXXXXXXXXXXXXXXXXXXXXXXXXXXX--%%%%--%%XXXXXXXXXXXXXXXXX---XXXXXXX-------------XXXXXXXXXX%%%%%%%-%%XXXXXXXXX-XXXXXXXXXXXXXXXXXXXXXX---XXXXXXXXXXXXXXX
XXXXXXXXXXXXXXXXXXXXXXXXXXXXXX---||----|XXXXXXXXXXXXXXXXX---XXXXXXX-------------XXXXXXXXXX||||||---|XXXXXXXXX-XXXXXXXXXXXXXXXXXXXXXX---XXXXXXXXXXXXXXX
