------------------------------------------------------------------------------------------------------------------------------------------------------
------------------------------------------------------------------------------------------------------------------------------------------------------
------------------------------------------------------------------------------------------------------------------------------------------------------
S-----SSSS------------------------------------------------------------SSSSSSSSSS----------------------------------------------------------------------
S-----------------------------------------------------------------------------------------------------------------------------------------------------
S------------------------------------------------------oooo----------R----------K-------------------oo------------------------------------------------
S---------------------!--------------------------------%%%%---------------------SS----1-------------%%%-----------------------------------------------
S-------------------------------------------------SSSS--||--------------------TT--------------------||--o----R----------------------------------------
S-------------------------------------------------------||--------------------TT--------------------||-%%%--------------------SSS----g#---------------
S-------------------------------------------------------||--------------------TT--------------------||--|---------------------------g##---------------
S---------------%%%%S@S!S-------------------------------||-------%%%--------SCTTSS---------------tt-||--|---------------%-----------###-------#LSS----
S----------------||--------------------T--------------U-||--------|-----TT----TT------TT--T------tt-||-o|------#-------------------####-------#-------
S----------------||---------tt---------T----------------||--------|-----TT----TT------TT--T------tt-||%%%%%----#------------------#####-------#-------
S--M-------------||--g------tt-------kkT-------ggg------||--------|-----TT---kTT------TT--T------tt-||-|||-----#----ggg----------r#####-----kk#-------
XXXXXXXXXXX--%%%%||%XXXXXXXXXXXXXXXXXXXX-XXXXXXXXX----%%%%%-%%%%%-|---XXXXXXXXXXXXXXXXXXXXXXXXXXXXXX||-|||-----XXXXXXXXX----XXXXXXXXXXX--XXXXXXXXXX---
XXXXXXXXXXX---||-||-XXXXXXXXXXXXXXXXXXXX-XXXXXXXXX-----|||---|||--|---XXXXXXXXXXXXXXXXXXXXXXXXXXXXXX||-|||-----XXXXXXXXX----XXXXXXXXXXX--XXXXXXXXXX---
