------------------------------------------------------------------------------------------------------------------------------------------------------
------------------------------------------------------------------------------------------------------------------------------------------------------
------------------------------------------------------------------------------------------------------------------------------------------------------
------------------------------------------------------------------------------------------SSSSSSSSSS--------------------------------------------------
------------------------------------------------------------------------------------------------------------------------------------------------------
------------------------------------------------------------------------------------------------------------------------------------------------------
--------------------S---------------------------------------------------------------y------------------------R----------SSS-------SS------------------
---------------------------TT-----------------------------------------------------#SSS---------------r----------oooo----------------------------------
---------------------------TT----------------------------B-----------------------##-----------------%%%%%%%-------------------------------------------
---------------------------XX----------------------------b---------------1------###1----------------||||||--------------------------------------------
-------------------%---TT----------------TT---SU-------SS#CS---------#T---------###-----------------||||||----T-------------------SS------------------
-----------------------TT----------------TT-------------------------##T----TT---###--SSS------------||||||----T-------------------K---#----B----------
-----------------------TT----------------TT----------------KTT-----###T----TT---###-----------------||||||----T---------------TT------#----b-------F--
-M-----------%%%%---k--TT---------k-k----TT------k----------TT----####T---kTT---###-------------g-g-||||||--ooT---y-----------TT------#----B-------#--
XXXXXXXXXXX---||----XXXXXXXXXXXXXXXXXXX-XXXXXXXXXXXXXXXXXXXXXXXXXXXXXXXXXXXXXXXXXXXXXX---XXXXXXXXXXX||||||--%%XXXXXXXXXX----XXXXXXXXXXXXXXXXXXXXXXXXXX
XXXXXXXXXXX---||----XXXXXXXXXXXXXXXXXXX-XXXXXXXXXXXXXXXXXXXXXXXXXXXXXXXXXXXXXXXXXXXXXX---XXXXXXXXXXX||||||---|XXXXXXXXXX----XXXXXXXXXXXXXXXXXXXXXXXXXX
