------------------------------------------------------------------------------------------------------------------------------------------------------
------------------------------------------------------------------------------------------------------------------------------------------------------
------------------------------------------------------------------------------------------------------------------------------------------------------
--------------------------------------------------------------------------------SSSSSSSSSL------------------------------------------------------------
------------------------------------------------------------------------------------------------------------------------------------------------------
--------------------------------------oo-----------------------------R--------------------------------------------------------------------------------
-----------------------------------SSSS-----------------------------------SS--------ooooooSSS------%------2----------------------------US-------------
------------------------------------------------------------------------------------------------------------------------------------------------------
------------------------------------------------------------------------------------SSSSSS------------------------------------------------------------
------------Q--?--------------------------------------------------------------------SSSSSS----------o-------------------SS-?Q--------SS---------------
-------------------S----------%-----------------------S----------%%%--SS-----SS-------------%%%-----------2--------------------------------S----------
--------------------------------------------------TT--------------|--------------------------|-----------------#-----------------------------------#--
--------------------------------------------------TT--------------|--------------------------|-----------------#---------------y--TT-----------K---#--
------------------K------ggg----------------------TT------k-------|--------------------------|----------y--y---#----ggg----SSSSS--TT---------------#--
XXXXXXXXXXXXXXXXXXXXXXXXXXXXXX--%%%%--%%X-XX-XX-XXXXXXXXXXXX%%%%%-|----------------XXXXXXX---|------XXXXXXXXXX-XXXXXXXXX-------XX-XXXXXX-X-XXXXXX--XXX
XXXXXXXXXXXXXXXXXXXXXXXXXXXXXX---||----|X-XX-XX-XXXXXXXXXXXX-|||--|----------------XXXXXXX---|------XXXXXXXXXX-XXXXXXXXX-------XX-XXXXXX-X-XXXXXX--XXX
