------------------------------------------------------------------------------------------------------------------------------------------------------
------------------------------------------------------------------------------------------------------------------------------------------------------
------------------------------------------------------------------------------------------------------------------------------------------------------
------------------------------------------------------------------------------------------------------------------------------------------------------
------------------------------------------------------------------------------------------------------------------------------------------------------
----------------------------------------------------------------------------------g-------------------------------------------------------------------
------------------Q-----------S-------------------------------------------------SSSSSSSS---------------------@----------------------------------------
------------------------------------------------------------------------------------------------------------------------------------------------------
-----------------------------------------------------------------------------------------------------------------------------SSS-----g#---------------
----------------------------------------------------------------1-------------------------------------------------------------------g##---------------
------------------?---------TT##--SSC---------------------------------------------------------------SU----!--!----------r-----------###---------------
--------------TT------------TT----------------------K----------------------------------------------------------#--------%%%%%%-----####---------------
--------------TT------------TT---------------------------------------------------------------------------------#--------|||||-----#####------------F--
---M----------TT--------ggg-TT-----------------ggg---------g----------gg---------------------------g------k----#----ggg-|||||-----#####------------#--
XXXXXXXXXXXXXXXXXXXXXXXXXXXXXXXX--XXXXXX-XXXXXXXXXXXXXXXXXXXXXXXXXXXX-XXXXXXXXXXXXXXXX---X-XXXXXXXXXXXXXXXXXXX-XXXXXXXXX|||||-----XXXXX--XXXXXXXXXXXXX
XXXXXXXXXXXXXXXXXXXXXXXXXXXXXXXX--XXXXXX-XXXXXXXXXXXXXXXXXXXXXXXXXXXX-XXXXXXXXXXXXXXXX---X-XXXXXXXXXXXXXXXXXXX-XXXXXXXXX|||||-----XXXXX--XXXXXXXXXXXXX
