------------------------------------------------------------------------------------------------------------------------------------------------------
------------------------------------------------------------------------------------------------------------------------------------------------------
------------------------------------------------------------------------------------------------------------------------------------------------------
S-----SSSS-----------------------------------------oo-------------------------------------------------------------------------------------------------
S-------------------------------------------------%%%%-----------------------------------------------------------------------------------------------o
S-------------------------------------oo-----------||---------------------------K-----------oo--------------------------------------------------------
S----------------------------------SSSS------------||---------------------------SS----1----------------------R------------oo---%%%!S------------------
S--------------------------------------------------||--SSS-------------------------------------------r--------------------SS----||--------------SSS---
S--------------------------------------------------||----------------------------------------------%%%%%%%%---------------------||----------oo--------
S--------------------------------------------------||-----------------------------------------------||||||----------------------||--------------------
S---------------------------TT%--------------------||---------------------------SS--------SS--------||||||-------------------SS-||S------#--SS--------
S----------------K----------TT---------------------||---------------------------------TT------------||||||-----#----------------||------##------------
S-----------B---------------TT--------------------%||---------------------------------TT-----%%%%---||||||-----#----------------||-----###------------
S--M--------b-----------ggg-TT-----------------ggg-||-------gg-------ggg--------------TT------||----||||||--oo-#----ggg---------||----####------------
XXXXXXXXXXXXXXXXXXXXXXXXXXXXXX--%%%%--%%-XXXXXXXXX-||-------XXXXXXXXXXXXXXXXXXXXXXXXXXXXXX----||----||||||--%%-XXXXXXXXX%%-----%%%XXXXXXXXXX----------
XXXXXXXXXXXXXXXXXXXXXXXXXXXXXX---||----|-XXXXXXXXX-||-------XXXXXXXXXXXXXXXXXXXXXXXXXXXXXX----||----||||||---|-XXXXXXXXX|-------||XXXXXXXXXX----------
