------------------------------------------------------------------------------------------------------------------------------------------------------
------------------------------------------------------------------------------------------------------------------------------------------------------
------------------------------------------------------------------------------------------------------------------------------------------------------
----------------------------------------SSSSSSSSSS----------SSSSSSSSSS--------------------SSSSSSSSSS--------------------------------------------------
----------------------------------------SSSSSSSS------------SSSS--SSSS--------------------------------------------------------------------------------
----------------------------------------SSSCSSSS------------SSSS--SSSS------------g-------------------------------------------------------------------
-----------------------------US---------SSSSSSSS--------------SS---S------------SSSSSSSS----------------------------------oo---%%%%-------------------
--------------------------------------------------------------SS---S--------------------------------------TT--------------SS----||--------------------
-----------------%%%-------------------------------------TT---SS---S--o-----------------------------------TT--------------------||------SSS-----------
------------------||-----------------------ggg-----TT----TT-ooSS---SoU------------------------------------TT--------------------||--------------------
------------------||--------####--SSC---SSSSSSSS---TT----XX-SSSS---SSS-----------------------------------SXXS----------------SS-||%%%%%-------#LSS----
-------------%%%%%||---y-#####----------SSSSSSSS---TT-------------------------#-------------------------------------------------||-|||--------#-------
--------------|||-||y-######------------SSSSSSSS---TT------------------------##---------------------TT-------------B------------||-|||--------#-------
-M------------|||-||######--------------SSSSSSSS---TT-------k--g-g------------------------------g-g-TT-------------b------------||-|||------kk#-------
XXXXXXXXXXX---|||-||XXXX------XX--XXXXXXXXXXXXXXXXXXXXXXXXXXXXXXXXXXXXXXXXXXXXXXXXXXXX---XXXXXXXXXXXXXXXXXXXXXXXXXXXXXXX%%-----%%%%|||------XXXXXXX---
XXXXXXXXXXX---|||-||XXXX------XX--XXXXXXXXXXXXXXXXXXXXXXXXXXXXXXXXXXXXXXXXXXXXXXXXXXXX---XXXXXXXXXXXXXXXXXXXXXXXXXXXXXXX|-------||-|||------XXXXXXX---
