------------------------------------------------------------------------------------------------------------------------------------------------------
------------------------------------------------------------------------------------------------------------------------------------------------------
------------------------------------------------------------------------------------------------------------------------------------------------------
--------------------------------oo------SSSSSSSSSS--------------------------------------------------SSSSSSSSSS----------------------------------------
---------------------------------------g--------------------------------------------------------------------------------------------------------------
-----------------------------------%%%%%--------------------------------------------------------------------------------------------------------------
------------------------------------||||-oooo------------------------------g--------y------------------------------oo-------------%-------------------
------------------------------------||||-------------------------------%%%%%%-----#SSS----------------------------------------------------------------
------------------------------------||||-SSSS-U-------------------------||||-----##-----------------------------------------------------SSS-----------
------------------------------%%%%%-||||oS--SoS-------------------------||||----###1------------g------------------------------SSS--------------------
----------------%%%%-----------|||--||||SS--SSS----------tt----------#--||||----###-------------TT-----------T-%%%%--%%%%---------%%%%%---------------
-----------------||------------|||--||||-----------------tt---------##--||||----###--SSS--------TT-----TT----T--||----||-----------|||----------------
-----------------||------------|||--||||-----------------tt-TT-----###--||||----###-------------TT-----TT----T--||----||-----------|||-------------F--
-M---------------||------ggg---|||--||||--kk---------g-g-tt-TT----####--||||----###-------------TT--g--TT----To-||----||---------r-|||-------------#--
XXXXXXXXXXX--%%%%||%XXXXXXXXXX-|||--||||XXXXXXXXXXXXXXXXXXXXXXXXXXXXXX--||||----XXXXXX---XXXXXXXXXX-XXXXXXXXXX%-||----||----XXXXXX%|||------XXXXXXXXXX
XXXXXXXXXXX---||-||-XXXXXXXXXX-|||--||||XXXXXXXXXXXXXXXXXXXXXXXXXXXXXX--||||----XXXXXX---XXXXXXXXXX-XXXXXXXXXX--||----||----XXXXXX-|||------XXXXXXXXXX
