------------------------------------------------------------------------------------------------------------------------------------------------------
------------------------------------------------------------------------------------------------------------------------------------------------------
------------------------------------------------------------------------------------------------------------------------------------------------------
S-----SSSS------------------------------SSSSSSSSSS-----------------SSS------------------------------------------------------------SSSSSSSS------------
S---------------------------------------SSSSSSSS-------------------------o----------------------------------------------------------------------------
S---------------------------------------SSSCSSSS------------------------%%%---------------------------------------------------------------------------
S---------------------------------------SSSSSSSS----------------CSS------|--o------o--o-------------------2-------------SS----------------------------
S------------------------------------------------------------------------|--SSSS---------------------------------------------------------------y------
S--------------------------------------------------------B--SS--2-----%--|-------------------------------------------------------------------#SS--o---
S------------------------------------------ggg-----------b-----2-2-------|---------SSSS-------------o----------------------TT---------------##--------
S---------------------------------------SSSSSSSS-------SS#CS------2------|----------------------TT--------2----------------TT----------g##--##--SC----
S----------------K----------------------SSSSSSSS-------------------------|----------------------TT-------------#--------t--TT----------###--##--------
S-----------B---------------------------SSSSSSSS-----------K-------------|-----%%%%-------------TT-------------#--------t--TT--------g####--##---SSS--
S--M--------b---------------------k-k---SSSSSSSS-------------------------|------||----------k---TT------y--y---#----ggg-t--TT--------#####--##--------
XXXXXXXXXXXXXXXXXXXXXXXXX--XXXXXXXXXXXX-XXXXXXXXXXXXXXXXXXXX---XXXXXXX%%%%%%----||--------XXXXXXXXXXXXXXXXXXXX-XXXXXXXXXXXXXXXXXXXXXXXXXXX--XX------XX
XXXXXXXXXXXXXXXXXXXXXXXXX--XXXXXXXXXXXX-XXXXXXXXXXXXXXXXXXXX---XXXXXXX|||||-----||--------XXXXXXXXXXXXXXXXXXXX-XXXXXXXXXXXXXXXXXXXXXXXXXXX--XX------XX
