------------------------------------------------------------------------------------------------------------------------------------------------------
------------------------------------------------------------------------------------------------------------------------------------------------------
------------------------------------------------------------------------------------------------------------------------------------------------------
----------------------------------------------------------------------------------------------------------------------------------SSSSSSSS------------
------------------------------------------------------------------------------------------------------------------------------------------------------
----------------------------------------ooooo-------------------------------------------oo------------------------------------------------------------
---------------------------------------------------------Q-Q--------------------oo---------------------------R-------------------------------QQQQ-----
------------------------------------------------SS---------------------------------------------------r------------------------------------------------
-----------------------------------------SSSS------------------------o------------------------------%%%%%%%-------------------------------------------
-----------------------------------------------------------------y---------------SS-----------------||||||-------------------------------------y------
-------------------%--------TT---------------------------Q-Q-----##----------------------S----------||||||------!-----S----------------g##--Q?SSQQQ---
----------------------------TT--------tt------------------------###---------------------------------||||||-----------------------------###------------
----------------------------TT--------tt----%%%%%--------------####------------------------------B--||||||---------------------------g####------------
-M-----------%%%%-------ggg-TT--------tt-----|||--------------#####---gg-------------------------b--||||||--oo------------kkk--------#####------------
XXXXXXXXXXX---||----XXXXXXXXXXXXXXXXXXXX%%---|||--XXXXXXXXXXXXXXXXX---XXXXXXXXXX----------XXXXXXXXXX||||||--%%XXXXXXXXXXXXXXXXXXXXXXXXXXXX--XX--XXXXXX
XXXXXXXXXXX---||----XXXXXXXXXXXXXXXXXXXX|----|||--XXXXXXXXXXXXXXXXX---XXXXXXXXXX----------XXXXXXXXXX||||||---|XXXXXXXXXXXXXXXXXXXXXXXXXXXX--XX--XXXXXX
