------------------------------------------------------------------------------------------------------------------------------------------------------
------------------------------------------------------------------------------------------------------------------------------------------------------
------------------------------------------------------------------------------------------------------------------------------------------------------
------------------------------------------------------------------------------------------SSSSSSSSSS--------------------------------------------------
--------------------------------------------------?---------------------------------------------------------------------------------------------------
----------------------------------------ooooo-------------------------------------------------------oo------------------------------------------------
---------------------LSSS-----------------------------------------SSoo-----g-------o--o-------------%%%-----------------SS---------------##--------SSS
------------------------------------------------SSSS-------------------%%%%%%-----------------------||--o----R---SSS---------------------##-----------
-----------------------------------------SSSS---------------------------||||------------------------||-%%%-----------------------------####-----------
------------------------------------------------------------------------||||-------SSSS-------------||--|------------------TT----------####-----------
-------------------%-2-----#--------------------------------%%%%%%------||||------------------------||--|------------------TT--------######-------#---
---------------------------#---------------------------SSS---||||-------||||--------------t---------||-o|---------------t--TT--------######-------#---
---------------------------##---------------%%%%%------------||||-------||||----%%%-------t---------||%%%%%-------------t--TT--------######-------#---
-M-----------%%%%-----kk---##-----k-k--------|||-------------||||-------||||----||--------t---------||-|||--------------t--TT--------######--ggg--#---
XXXXXXXXXXX---||----XXXXXXXXXXXXXXXXXXX-%%---|||-------------||||-------||||----||--------XXXXXXXXXX||-|||----%%%%----%%XXXXXXXXXXXXXXXXXXXXXXXXXXXXXX
XXXXXXXXXXX---||----XXXXXXXXXXXXXXXXXXX-|----|||-------------||||-------||||----||--------XXXXXXXXXX||-|||----|||------|XXXXXXXXXXXXXXXXXXXXXXXXXXXXXX
