------------------------------------------------------------------------------------------------------------------------------------------------------
------------------------------------------------------------------------------------------------------------------------------------------------------
------------------------------------------------------------------------------------------------------------------------------------------------------
------------------------------------------------------------------------------------------SSSSSSSSSS--------------------------------------------------
------------------------------------------------------------------------------------------------------------------------------------------------------
----------------------------------------%%---------------------------R--------------------------------------------------------------------------------
----------------------------------------|--------------------------------------------SSSS--------------------@----------------------------------------
----------------------------------------|----oo------------------------------------------------------------------SSS----------------------------------
-----------------g----------------------|--------------------------------------g---------------------------------------------SSS----------------------
-----------------#----------------------|----------------o--------------------------------------------------------------------------------------------
----------S-----##---------------------T|------------------------%%%---------S@SQ-------------------SU----!--!----------r------------------#--#LSS----
---------------###---------------------T|-------------------------|-----------------------t-----------------------------%%%%%%------------##--#-------
--------------####---------------------T|-------------------------|-----------------------t-----------------------------|||||------------###--#-------
-------------#####--------------gg-----T|-----------k-------------|--------------ggg------t---------------k-------------|||||--------y--####kk#-------
XXXXXXXXXXXXXXXXXXXXXXXXX--XXXXXXXXXXXXX|----%%%%--XXXXXXXXX%%%%%-|----XXXXXXXXXXXXXX----XXXXXXXXXXXXXXXXXXXXX%%%%----%%|||||-----XXXXXXXXXXXXXXXXX---
XXXXXXXXXXXXXXXXXXXXXXXXX--XXXXXXXXXXXXX|-----||---XXXXXXXXX-|||--|----XXXXXXXXXXXXXX----XXXXXXXXXXXXXXXXXXXXX|||------||||||-----XXXXXXXXXXXXXXXXX---
