------------------------------------------------------------------------------------------------------------------------------------------------------
------------------------------------------------------------------------------------------------------------------------------------------------------
------------------------------------------------------------------------------------------------------------------------------------------------------
----------SSSSSSSSSSSSSSSSSSSS--------------------SSSSSSSSSS------------------------------------------------------------------------------------------
------------------------------------------------------SS--SS------------------------------------------------------------------------------------------
------------------------------------------------------SS--SS----------------------g-------------------------------------------------------------------
----------------------------------------------------SS---------------------g----SSSSSSSS---------------------------oo-----oo---%%%!S--------SS--------
----------------------------------------------------SS-------o---o---o-%%%%%%---------------------------------------------SS----||--------------------
----------------------------------------------------SS------%%%-%%%-%%--||||----------------------------------------------------||--------------------
-----------------------------C----------------------SS----oo-|---|---|--||||--------------------g-------------------------------||--------------------
----------@QQQQ--------#-#--------------------------SSSS--SS-|---|---|--||||--------------------TT-------------%%%%--%%%-----SS-||S------#--SS--------
---------------------#-#-#-#-----------T--------------SS-----|---|---|--||||--------------------TT----------g---||----||--------||------##--------#-TT
-----------------g-#-#-#-#-#-----------T--------------SS-----|---|---|--||||--------------------TT----------TT--||----||--------||-----###-------##-TT
-M--------------g#-#-#-#-#-#-E-------kkT-------y-------------|---|-r-|--||||--------------------TT----------TTo-||----||--------||----####------###-TT
XXXXXXXXXXXXXXXXXXXXXXXXXXXXXXXXXXXXXXXXXXXXXXXXXXXXXXXXXXXX%%%%%%%%%%--||||----XXXXXX---XXXXXXXXXX---XXXXXXXX%-||----||%%-----%%%XXXXXXXXXXXXXXXXX-XX
XXXXXXXXXXXXXXXXXXXXXXXXXXXXXXXXXXXXXXXXXXXXXXXXXXXXXXXXXXXX-|||||||||--||||----XXXXXX---XXXXXXXXXX---XXXXXXXX--||----|||-------||XXXXXXXXXXXXXXXXX-XX
