------------------------------------------------------------------------------------------------------------------------------------------------------
------------------------------------------------------------------------------------------------------------------------------------------------------
------------------------------------------------------------------------------------------------------------------------------------------------------
------------------------------------------------------------SSSSSSSSSSSSSSSSSSSS----------------------------------------------------------------------
------------------------------------------------------------SSSS--SSSS------SSSS----------------------------------------------------------------------
------------------------------------------------------------SSSS--SSSS---g--SSSS--g-------------------------------------------------------------------
--------------------------------------------------------------SS---S----SS------SSSSSSSS---------------------@------------SSC------------##-----------
--------------------------------------------------------------SS---S----SS---------------------------------------SSS---------------------##-----------
-----------------g---------------------------------------TT---SS---S----SS-------------------------------------------------------------####-----------
-----------------#---------------------------------TT----TT-ooSS---SoU--SC--g-g-----------------g-------------------------SSS----------####-----------
--------SUS-----##---------------------T-----------TT----XX-SSSS---SSS--SS--SSSS----------------TT--SU----!--!-----------------------######-----------
---------------###---------------------TT-----TT---TT-------------------------------------------TT-----------------------------------######-----------
--------------####---------------------TT-----TT---TT-------------------------------------------TT-----------------------------------######--------F--
--M----------#####-------ggg----gg-----TT-----TT---TT-------k--g-g------------------------------TT--------k----------------------#---######--------#--
XXXXXXXXXXXXXXXXXXXXXXXXXXXXXXXXXXXXXXXXXXXX--XXXXXXXXXXXXXXXXXXXXXXXXXXXXXXXXXXXXXXXX---XXXXXXXXXX-XXXXXXXXXX%%%%----%%X----XXXXXXXXXXXXXXXXXXXXXXXXX
XXXXXXXXXXXXXXXXXXXXXXXXXXXXXXXXXXXXXXXXXXXX--XXXXXXXXXXXXXXXXXXXXXXXXXXXXXXXXXXXXXXXX---XXXXXXXXXX-XXXXXXXXXX|||------|X----XXXXXXXXXXXXXXXXXXXXXXXXX
