------------------------------------------------------------------------------------------------------------------------------------------------------
------------------------------------------------------------------------------------------------------------------------------------------------------
------------------------------------------------------------------------------------------------------------------------------------------------------
----------------------------------------SSSSSSSSSS----------------------------------------SSSSSSSSSS--------------------------------------------------
------------------------------------------------------------------------------------------------------------------------------------------------------
------------------------------------------------------------------------------------------------------------------------------------------------------
-----------------------------------------oooo---------------------SSoo----SS---------SSSS--------------------R------------oo---%%%SS------------------
-----------------------------------------------------------------------------------------------------r----------oooo------SS----||--------------------
-----------------------------------------SSSS-U-----------------------------------------------------%%%%%%%---------------------||--------------------
----------------------------------------oS--SoS----------o------------------------------------------||||||----------------------||--------------------
-------------------%SS----------QQQQ----SS--SSS-------------%%%%%%----SS-----SS-Q-------------------||||||----T--------------SS-||SS----------#LSS----
---------------------K---TT----------K-B---------------------||||-----------------------------------||||||----T-----------------||K---#----B--#-------
-------------------------TT------------b---------------------||||-----------------------------------||||||----T-----------------||----#----b--#-------
---M---------%%%%--------TT------------b--kk--------k--------||||----------------ggg------------g-g-||||||--ooT---y-------------||----#----Bkk#-------
XXXXXXXXXXX---||----XXXXXXXXXXXXXXXXXXXXXXXXXXXXXX-XXXXXXXXX-||||---------------XXXXX----XXXXXXXXXXX||||||--%%XXXXXXXXXX%%-----%%%XXXXXXXXXXXXXXXXX---
XXXXXXXXXXX---||----XXXXXXXXXXXXXXXXXXXXXXXXXXXXXX-XXXXXXXXX-||||---------------XXXXX----XXXXXXXXXXX||||||---|XXXXXXXXXX|-------||XXXXXXXXXXXXXXXXX---
