------------------------------------------------------------------------------------------------------------------------------------------------------
------------------------------------------------------------------------------------------------------------------------------------------------------
------------------------------------------------------------------------------------------------------------------------------------------------------
------------------------------------------------------------------------------------------------------------------------SSS-----SS--------------U-----
------------------------------------------------------------------------------------------------------------------------------------------------------
----------------------ooor------------------------------------g-----------------------------oo--------------------------------------------------------
---------------------%%%%%------------------------Q-----------SSSSS------------------------------------------@----------US---------------##-----------
----------------------|||----------------------------------------------------------------------------------------------------------------##-------SS--
----------------------|||---------------------------------------------------------TT---------------%------------------------SSS--------####-----------
----------------------|||------------------------------------------------1--------TT---------------------------------------------------####---SS------
--------------------%%%%%%%------------T----------Q-------------------T-----------TT------SS--------SU----!--!--------r-SSS----------######----------#
--------------------||||||-------------T------------------------------T----TT-----TT-----T------------------------%%%%%%-------------######---------##
--------------------||||||--o----------T----------------------TT-----tT----TT---T-TT-----T---%%%%------------------|||||-------------######--------###
--------------k-ggg-||||||-%%%--gg-----T----y-y------gg----k--TT-----tT---kTT---T-TT---k-T----||----------k--------|||||-------------######-------####
XXXXXXXXXXXXXXXXXXXX||||||--|-XXXXXXXXXXXXXXXXXXXXXXXXXXXXXXXXXXXXXXXXXXXXXXXXXXXXXXXXXXXX----||----XXXXXXXXXX-%%%-|||||XXX------XXXXXXXXXXXXXXXX-XXXX
XXXXXXXXXXXXXXXXXXXX||||||--|-XXXXXXXXXXXXXXXXXXXXXXXXXXXXXXXXXXXXXXXXXXXXXXXXXXXXXXXXXXXX----||----XXXXXXXXXX--|--|||||XXX------XXXXXXXXXXXXXXXX-XXXX
