------------------------------------------------------------------------------------------------------------------------------------------------------
------------------------------------------------------------------------------------------------------------------------------------------------------
------------------------------------------------------------------------------------------------------------------------------------------------------
------------------------------SSSSSSSSSS--------------------------------------------------SSSSSSSSSS--------------------------------------------------
-----------------------------------------------------------------------------------------------------------------------------------------------------o
---------------------------------------------------------------------R--------------------------------------------------------------------------------
-------------------------------------------------------------------------------------------------------------@------------oo---%%%-----US-------------
----------------------------------------------------------------------------------------------------------------oooo------SS----||--------------SSS---
---------------------------------------S----------------------------------------------------------------------------------------||----------oo--------
---------------------------------------S------------------------------------------o---------------------------------------------||---SS---------------
----------Q----------------------------S--------------S----------%%%-------------------TT-----------SU----!--!T--------------SS-||---------SSS--------
-------------------------------#--------T-----TT--TT--------------|--------------------TT---------------------T-----------------||--------------------
-------------------------------#-#------T-----TT--TT--------------|--------------------TT---------------------T-----------------||TT------------------
-M-----------------#-----------#-#------T-----TT--TT------k-------|---gg---------------TT-------g-g-------k---T---y-------------||TT------------------
XXXXXXXXXXXXX--XXXXXXXXXX--XXXXXXXXXXXXXXXXX--XXXXXXXXXXXXXX%%%%%-|---XXXXXXXXXXXXXXXXXXXXXXXXXXXXXXXXXXXXXXXXXXXXXXXXXX%%-----%%%XXXXXX-X-X----------
XXXXXXXXXXXXX--XXXXXXXXXX--XXXXXXXXXXXXXXXXX--XXXXXXXXXXXXXX-|||--|---XXXXXXXXXXXXXXXXXXXXXXXXXXXXXXXXXXXXXXXXXXXXXXXXXX|-------||XXXXXX-X-X----------
