------------------------------------------------------------------------------------------------------------------------------------------------------
------------------------------------------------------------------------------------------------------------------------------------------------------
------------------------------------------------------------------------------------------------------------------------------------------------------
------------------------------------------------------------------------------------------------------------------------------------------------------
-------------------------------------------------------------------------o----------------------------------------------------------------------------
------------------------------------------------------------------------%%%---------------------------------------------------------------------------
----------------------!-------S------------------------------------------|--o-------------SSS------%------2---------------oo---%%%-------##--------SSS
-------------------------------------------------------------o---o---o---|--SSSS------------------------------------------SS----||-------##-----------
------------------------------------------------------------%%%-%%%-%%%--|------------------------------------------------------||-----####-----------
-------------------------------------------------------------|---|---|---|--------o-----------------o---------------------------||-----####-----------
-------------------%S@S!S-----##--SSC------------------ooo---|---|---|---|-------------TT---%%%-----------2------------------SS-||---######-------#---
-------------------------------------------------------------|---|---|---|-------------TT----|-----------------#----------------||---######-------#---
----------------------------tt-------------------------------|---|---|---|-----%-------TT----|-----------------#----------------||---######-------#---
-M-----------%%%%----g------tt--------------y-y--------------|---|-r-|---|-------------TT----|----------y--y---#----ggg---------||---######--ggg--#---
XXXXXXXXXXX---||----XXXXXXXXXXXX--XXXXXXXXXXXXXXXX--XXXXXXXX%%%%%%%%%%%%%%%%----XXXXXXXXXX---|------XXXXXXXXXX-XXXXXXXXX%%-----%%%XXXXXXXXXXXXXXXXXXXX
XXXXXXXXXXX---||----XXXXXXXXXXXX--XXXXXXXXXXXXXXXX--XXXXXXXX-||||||||||||||-----XXXXXXXXXX---|------XXXXXXXXXX-XXXXXXXXX|-------||XXXXXXXXXXXXXXXXXXXX
