------------------------------------------------------------------------------------------------------------------------------------------------------
------------------------------------------------------------------------------------------------------------------------------------------------------
------------------------------------------------------------------------------------------------------------------------------------------------------
--------------------------------oo------------------------------------SSSSSSSSSS----------SSSSSSSSSS--------------------------------------------------
---------------------------------------g--------------------------------------------------------------------------------------------------------------
-----------------------------------%%%%%----------------------g---------------------------------------oo----------------------------------------------
---------------------LSSS-----------||||----------------------SSSSS------------------SSSS---------------------?SSS-----------------------##-----------
------------------------------------||||--------------------------------------TT---------------------------------------------------------##----y------
------------------------------------||||-----------------B--------------------TT-------------------------------------------------------####--#SS--o---
------------------------------%%%%%-||||-----------------b--------------------TT-------------------------------------------------------####-##--------
----------Q----------2-----#---|||--||||---------------SS#CS----------------SCTTQ-----------------------------SSSSS------------------######-##--SC----
---------------------------#---|||--||||--------------------------------TT----TT-----------------------------------------------------######-##--------
---------------------------##--|||--||||-------------------K--TT-----t--TT----TT----------------------------tt-----------------------######-##---SSS--
-M-----------------#--kk---##--|||--||||-------y--------------TT-----t--TT---kTT-ggg------------g-g---ggg---tt--K--------k----ggg----######-##--------
XXXXXXXXXXXXX--XXXXXXXXXXXXXXX-|||--||||XXXXXXXXXXXXXXXXXXXXXXXXXXXXXXXXXXXXXXXXXXXXX----XXXXXXXXXXXXXXXXXXXXXXXXXXXXXXXXXXXXXXXXXXXXXXXXXXXXX------XX
XXXXXXXXXXXXX--XXXXXXXXXXXXXXX-|||--||||XXXXXXXXXXXXXXXXXXXXXXXXXXXXXXXXXXXXXXXXXXXXX----XXXXXXXXXXXXXXXXXXXXXXXXXXXXXXXXXXXXXXXXXXXXXXXXXXXXX------XX
