------------------------------------------------------------------------------------------------------------------------------------------------------
------------------------------------------------------------------------------------------------------------------------------------------------------
------------------------------------------------------------------------------------------------------------------------------------------------------
----------------------------------------------------------------------------------------------------------------------------------SSSSSSSSSS----------
-------------------------------------------------------------------------o----------------------------------------------------------------------------
----------------------ooor----------------------------------------------%%%-----K---------------------------------------------------------------------
---------------------%%%%%------------------------------------USSS-------|--o---SS----1----------------------@----------------------------------------
----------------------|||------------------------------------------------|--SSSS---------------------------------SSS----------------------------------
----------------------|||--------------------------------TT-----------%--|---------------------------------------------------SSS----------------------
----------------------|||----------oo--------------TT----TT--------------|----------------------------------------------------------------------------
--------SU---------%%%%%%%%-------o--o-------------TT----XX--S-----TT----|------SS---------------tt-SU----!--!----------r-------------------#---------
--------------------||||||-------------------------TT--------------TT----|------------TT--T------tt---------------------%%%%%%------------TT##--------
--------------------||||||--o----------------------TT--------------TT----|-----%------TT--T------tt---------------------|||||------tt-----TT###------#
--M----------%%%%---||||||-%%%-----------------y---TT--------ggg---TT----|------------TT--T------tt-------k-------------|||||------tt----kTT####----##
XXXXXXXXXXX---||----||||||--|-XXXXXXXXXXXXXXXXXXXXXXXXXXXXXXXXXXXXXXXX%%%%%%----XXXXXXXXXXXXXXXXXXXXXXXXXXXXXX%%%%----%%|||||-----XXXXXXXXXXXXXXXXXXXX
XXXXXXXXXXX---||----||||||--|-XXXXXXXXXXXXXXXXXXXXXXXXXXXXXXXXXXXXXXXX|||||-----XXXXXXXXXXXXXXXXXXXXXXXXXXXXXX|||------||||||-----XXXXXXXXXXXXXXXXXXXX
