------------------------------------------------------------------------------------------------------------------------------------------------------
------------------------------------------------------------------------------------------------------------------------------------------------------
------------------------------------------------------------------------------------------------------------------------------------------------------
------------------------------SSSSSSSSSS----------SSSSSSS---------------------------------------------------------------------------------------------
------------------------------SSSSSSSSSS--------------------------------------------------------------------------------------------------------------
------------------------------SSSSSSSSSS-----------------------------R--------------------------------------------------------------------------------
--------------------USS-------SSSSSSSSSS----------QQ----------------------------------------------------SSQSSS----------SS----------------------------
------------------------------------------------------------------------------------------------------------------------------------------------------
-----------------%%%---------------------------------------S----------o-----------TT-----------------------------------y------------------------------
------------------||--------------------------------------------------------------TT----------------------K------------X---TT-------------------------
--------SU--------||----------SSSSSSSSSS----------QQ--QQQ--------%%%--------------TT-------------tt-----SSSSSS--------XX---TT--------------#--#LSS----
-------------%%%%%||-B--------SSSSSSSSSS--------------------------|-----------#---TT-----TT------tt------------------XXXt--TT-------------##--#-------
--------------|||-||-b-------BSSSSSSSSSS--------------------------|----------##-T-TT-----TT------tt-----------------XXXXt--TT------------###--#-------
--M-----------|||-||-B-------bSSSSSSSSSS-------y------------------|-------------T-TT---k-TT------tt----------------XXXXXt--TT--------y--####kk#-------
XXXXXXXXXXX---|||-||XXXXXXXXXXXXXXXXXXXXXXXXXXXXXXXXXXXXX---%%%%%-|---XXXXXXXXXXXXXXXXXXXXXXXXXXXXXXXXXXXXXXXXXXXXXXXXXXXXXXXXXXXXXXXXXXXXXXXXXXXXX---
XXXXXXXXXXX---|||-||XXXXXXXXXXXXXXXXXXXXXXXXXXXXXXXXXXXXX----|||--|---XXXXXXXXXXXXXXXXXXXXXXXXXXXXXXXXXXXXXXXXXXXXXXXXXXXXXXXXXXXXXXXXXXXXXXXXXXXXX---
