------------------------------------------------------------------------------------------------------------------------------------------------------
------------------------------------------------------------------------------------------------------------------------------------------------------
------------------------------------------------------------------------------------------------------------------------------------------------------
--------------------SSSSSSSSSS--oo--------------------------------------------------------------------------------------------------------------------
--------------------SSSSSSSSSS---------g--------------------------------------------------------------------------------------------------------------
--------------------SSSSSSSSSS-----%%%%%%%-------------oooo----------R------------------oo------------------------------------------------------------
--------------------SSSSSSSSSS------|||||--------------%%%%---------------------oo---------------------------R?SSS----------------SS--------SS--------
------------------------------------|||||----oo---SSSS--||-------------------------------------------r------------------------------------------------
------------------------------------|||||---------------||------------------------------------------%%%%%%%-------------------------------------------
------------------------------%%%%%-|||||---------------||-----------------------SSS--------------oo||||||--------------SS-?Q-------------------------
---------Q---------%--SSSSSS?--|||--|||||---------------||-------%%%---------------------S----------||||||----SSSSS---------------SS--------SS--------
----------------------SSSSS----|||--|||||-------------U-||--------|----------------------------TT---||||||------------------------K---#----B------#-TT
----------------------SSSSS----|||--|||||---------------||--------|----------------------------TT---||||||---------------------y------#----b-----##-TT
-------------%%%%----------ooo-|||--|||||---------------||--------|---gg--------------------y--TT---||||||--oo--K----------SSSSS------#----B----###-TT
XXXXXXXXXXX---||-----XXXXXXXXX-|||--|||||----%%%%-----%%%%%-%%%%%-|---XXXXXXXXXX----------XXXXXXXXXX||||||--%%XXXXXXXXXX-------XX-XXXXXXXXXXXXXXXXX-XX
XXXXXXXXXXX---||-----XXXXXXXXX-|||--|||||-----||-------|||---|||--|---XXXXXXXXXX----------XXXXXXXXXX||||||---|XXXXXXXXXX-------XX-XXXXXXXXXXXXXXXXX-XX
