------------------------------------------------------------------------------------------------------------------------------------------------------
------------------------------------------------------------------------------------------------------------------------------------------------------
------------------------------------------------------------------------------------------------------------------------------------------------------
--------------------SSSSSSSSSS--------------------------------------------------------------------------------------------------------------SSSSSSSSSS
--------------------SSSSSSSSSS------------------------------------------------------------------------------------------------------------------------
--------------------SSSSSSSSSS----------ooooo----------------------------------------------------------------------k----------------------------------
--------------------SSSSSSSSSS--------------------Q---------------SSoo----SS---------SSSS-----------------2---S---SSSSSS--SSC------------##-----------
------------------------------------------------SS---------------------------------------------------------------------------------------##-----------
-----------------------------------------SSSS------------------------------------------------------------------------------------------####-----------
------------------------------------------------------------------------------------------------g---o---------------------SSS----------####-----------
----------------------SSSSSS?---------------------Q---------%%%%%%----SS-----SS-Q---------------TT--------2--------------------------######---TT------
----------------------SSSSS------------T---------------------||||-------------------------------TT-----------------------------------######---TT------
----------------------SSSSS------------T----%%%%%------------||||-------------------------------TT------------TT---------------------######---TT------
---M----------k-ggg--------ooo-------kkT-----|||-----gg----k-||||----------------ggg------------TT------y--y--TT-----------------#---######---TT------
XXXXXXXXXXXXXXXXXXXX-XXXXXXXXXXXXXXXXXXX%%---|||--XXXXXXXXXX-||||---------------XXXXX----XXXXXXXXXX-XXXXXXXXXXXXXXXXXX--X----XXXXXXXXXXXXXXXXXXX--XXXX
XXXXXXXXXXXXXXXXXXXX-XXXXXXXXXXXXXXXXXXX|----|||--XXXXXXXXXX-||||---------------XXXXX----XXXXXXXXXX-XXXXXXXXXXXXXXXXXX--X----XXXXXXXXXXXXXXXXXXX--XXXX
