------------------------------------------------------------------------------------------------------------------------------------------------------
------------------------------------------------------------------------------------------------------------------------------------------------------
------------------------------------------------------------------------------------------------------------------------------------------------------
----------------------------------------------------------------------------------------------------SSSSSSSSSS----------------------------------------
------------------------------------------------------------------------------------------------------------------------------------------------------
----------------------------------------------------------------------------------------oo------------------------------------------------------------
---------------------LSSS-----S-----------------------------------------SSSSS---oo--------------------------------------------------------------------
-------------------------------------------------------------o---o---o-------------------------------------------SSS----------------------------------
------------------------------------------------------------%%%-%%%-%%--------------------------------------------------------------------------------
-------------------------------------------------------------|---|---|-----------SSS-------------------------------------------SSS--------------------
----------------%%%%-2-----#--##--SSC----TT---SU-------ooo---|---|---|-------2-----------S-----------------TT-----------%-------------------#---------
-----------------||--------#-------------TT------------------|---|---|-----TT---------------------------#--TT-------------------------------##--------
-----------------||--------##------------TT------------------|---|---|t----TT--T-----------------B-----##--TT-------------------------------###------#
-----------------||---kk---##------------TT------k-----------|---|-r-|t----TT--T-----------------b--kk-##--TT--------------------r----------####----##
XXXXXXXXXXX--%%%%||%XXXXXXXXXXXX--XXXXXXXXXXXXXXXX--XXXXXXXX%%%%%%%%%%XXXXXXXXXX----------XXXXXXXXXXXXXXX--XX-%%%%----%%----XXXXXXXXXXXXXXXXXXXXXXXXXX
XXXXXXXXXXX---||-||-XXXXXXXXXXXX--XXXXXXXXXXXXXXXX--XXXXXXXX-|||||||||XXXXXXXXXX----------XXXXXXXXXXXXXXX--XX-|||------|----XXXXXXXXXXXXXXXXXXXXXXXXXX
