------------------------------------------------------------------------------------------------------------------------------------------------------
------------------------------------------------------------------------------------------------------------------------------------------------------
------------------------------------------------------------------------------------------------------------------------------------------------------
------------------------------SSSSSSSSSSSSSSSSSSSS----------------------------------------------------------------------SSSSSSSSSS--------------------
------------------------------SSSSSSSSSS--------------------------------------------------------------------------------------------------------------
----------------------ooor----SSSSSSSSSS----------------------------------------------------oo--------oo----------------------------------------------
------------------Q--%%%%%----SSSSSSSSSS-oooo--------------------------------------o--o-------------------------------------------SS--------SS--------
----------------------|||-----------------------------------------------------------------------------------------------------------------------------
----------------------|||----------------SSSS-U----------------------------------------------------%--------------------------------------------------
----------------------|||---------------oS--SoS--------------------------1---------SSSS---------------------------------------------------------------
------------------?-%%%%%%%---SSSSSSSSSSSS--SSS--------ooo-----------#T-------------------S---------------------------------------SS--------SS--------
--------------TT----||||||----SSSSSSSSSS----------------------------##T----TT---------------------------------------------SS------K---#----B------#-TT
--------------TT----||||||--o-SSSSSSSSSS--------------------TT-----###T----TT---%%%----------%%%%-----------tt-----B------SS----------#----b-----##-TT
-M------------TT----||||||-%%%SSSSSSSSSS--kk----------------TT----####T---kTT---||------------||------ggg---tt-----b------SS----------#----B----###-TT
XXXXXXXXXXXXXXXXXXXX||||||--|-XXXXXXXXXXXXXXXXXXXX--XXXXXXXXXXXXXXXXXXXXXXXXXXXX||------------||----XXXXXXXXXXXXXXXXXXXX--XX--XXXXXXXXXXXXXXXXXXXXX-XX
XXXXXXXXXXXXXXXXXXXX||||||--|-XXXXXXXXXXXXXXXXXXXX--XXXXXXXXXXXXXXXXXXXXXXXXXXXX||------------||----XXXXXXXXXXXXXXXXXXXX--XX--XXXXXXXXXXXXXXXXXXXXX-XX
