------------------------------------------------------------------------------------------------------------------------------------------------------
------------------------------------------------------------------------------------------------------------------------------------------------------
------------------------------------------------------------------------------------------------------------------------------------------------------
--------------------------------------------------------------------------------SSSSSSSSSS------------------------------------------------------------
------------------------------------------------------------------------------------------------------------------------------------------------------
-----------------------SSS-----------------------------oooo--------------------------------------------------------k----------------------------------
-------------------------------------------------------%%%%----------------1----------------------------SSQSSSS---SSSSSSSS----------------------------
---------------------g----------------------------------||--------------------------------------------------------------------------------------------
--------------------%%%---------------------------------||--------------------------------------------------------------------------------------------
--------------------||----SSS---------------------SSS---||-----------------ggg---------S--------g---------K----------------TT-------------------------
--------------------||----------------------------------||-----------##########-SU--------------TT------SSSSSS-------------TT-------------------------
-----------------K--||----------------tt--------------U-||----------##--------#-----TT---t------TT----------------------t--TT----------------------#--
------------B-------||----------------tt----------------||--TT-----###--------#-----TT---t------TT------------TT--------t--TT------------------K---#--
-M----------b-------||----oo----------tt----------------||--TT----####--------#----kTT--kt------TT------------TT--------t--TT----------------------#--
XXXXXXXXXXXXXXXXXXXX||---%%%--XXXXXXXXXXX-XX-XX-XX----%%%%%-XXXXXXXXXX--------X-XXXXXXXXXXXXXXXXXXX-XXXXXXXXXXXXXXXXXX--XXXXXXXXXXXXXXXXXXXXXXXXX--XXX
XXXXXXXXXXXXXXXXXXXX||----|---XXXXXXXXXXX-XX-XX-XX-----|||--XXXXXXXXXX--------X-XXXXXXXXXXXXXXXXXXX-XXXXXXXXXXXXXXXXXX--XXXXXXXXXXXXXXXXXXXXXXXXX--XXX
