------------------------------------------------------------------------------------------------------------------------------------------------------
------------------------------------------------------------------------------------------------------------------------------------------------------
------------------------------------------------------------------------------------------------------------------------------------------------------
----------SSSSSSSSSS------------------------------------------------------------ooo-----------------SSSSSSSSSS----------------------------------------
--------------------------------------------------------------------------------%%%-------------------------------------------------------------------
----------------------ooor-------------------------------------------------------|--------------------------------------------------------------------
---------------------%%%%%-------------------------------Q-Q---------------------|----------------------------------------SSC-------------------------
----------------------|||--------------------------------------------------------|----------------oo--------------------------------------------------
----------------------|||--------------------------------------------------------|---------------------------------------------------g#---------------
----------------------|||---------------------------------------1--------1-------|---%%%%---------------------------------SSS-------g##---------------
---------Q----------%%%%%%%------------------------------Q-Q----------T----------|----||-------------------TT-----------------------###---------------
--------------------||||||-------------T------------------------------T----TT---%%%%%%||--------#-------#--TT----------------------####------------#--
--------------------||||||--o----------T------------------------------T----TT----||||-||--------#------##--TT---------------------#####--------K---#--
--------------------||||||-%%%-------kkT----y-y-----------------------T---kTT----||||-||--------#---kk-##--TT--k----kkk----------######------------#--
XXXXXXXXXXX--XX--X--||||||--|-XXXXXXXXXXXXXXXXXXXXXXXXXXXXXXXXXXXXXXX-XXXXXXXXXX-||||-||%%XXXXXXXXXXXXXXX--XX-XXXXXXXXXXX----XXXXXXXXXX--XXXXXXXX--XXX
XXXXXXXXXXX--XX--X--||||||--|-XXXXXXXXXXXXXXXXXXXXXXXXXXXXXXXXXXXXXXX-XXXXXXXXXX-||||-||-|XXXXXXXXXXXXXXX--XX-XXXXXXXXXXX----XXXXXXXXXX--XXXXXXXX--XXX
