------------------------------------------------------------------------------------------------------------------------------------------------------
------------------------------------------------------------------------------------------------------------------------------------------------------
------------------------------------------------------------------------------------------------------------------------------------------------------
------------------------------SSSSSSSSSSSSSSSSSSSS-----------------SSS--------------------------------------------------------------------------------
------------------------------------------------------------------------------------------------------------------------------------------------------
------------------------------------------------------------------------------------------------------------------------------------------------------
------------------SCUSS------------------oooo-----Q-------------CSS-----------------------SSS------%---------R------------SSC-------------------------
-----------------------------------------------------------------------------------------------------r------------------------------------------------
---------------------------------------S-SSSS-U-------------SS--2-----------------TT----------------%%%%%%%-------------------------------------------
---------------------------------------SoS--SoS----------------2-2----------------TT----------------||||||----------------SSS-------------------------
--------SU----TT---2-------------------SSS--SSS---Q---------------2---------------TT--------%%%-----||||||------------r--------------------#----------
--------------TT-----B---------#--------------------------------------------------TT-----T---|------||||||--------%%%%%%------------------##----------
--------------TT-----b-------B-#-#----------------------------------------------T-TT-----T---|------||||||---------|||||-----------------###-------F--
--M-----------TT-----B-------b-#-#--------kk---------gg----k----------gg--------T-TT---k-T---|------||||||--oo-----|||||---------#---y--####-------#--
XXXXXXXXXXXXXXXXXXXXXXXXXXXXXXXXXXXXXXXXXXXXXXXXXXXXXXXXXXXX---XXXXXXXXXXXXXXXXXXXXXXXXXXX---|------||||||--%%-%%%-|||||X----XXXXXXXXXXXXXXXXXXXXXXXXX
XXXXXXXXXXXXXXXXXXXXXXXXXXXXXXXXXXXXXXXXXXXXXXXXXXXXXXXXXXXX---XXXXXXXXXXXXXXXXXXXXXXXXXXX---|------||||||---|--|--|||||X----XXXXXXXXXXXXXXXXXXXXXXXXX
