------------------------------------------------------------------------------------------------------------------------------------------------------
------------------------------------------------------------------------------------------------------------------------------------------------------
------------------------------------------------------------------------------------------------------------------------------------------------------
----------SSSSSSSSSS----------------------------------------------------------------------------------------------------------------------------------
------------------------------------------------------------------------------------------------------------------------------------------------------
----------------------------------------ooooo-------------------------------------------oo------------------------------------------------------------
--------------------USS---------------------------------------------------SSCSS-oo---------------------------------oo------------------------------SSS
------------------------------------------------SS------------------------------------------------oo--------------------------------------------------
-----------------------------------------SSSS------------B--------------------------------------------------------------------------------------------
---------------------------------------------------------b-----------------------SSS------------------------------------------------------------------
----------@QQQQ----------------------------------------SS#CS------------QQQQ--QQ---------S------------%%%%%%---%%%%--%%%--------------------------#---
---------------------B----------------K---------------------------------------------------------#------||||-----||----||-------------TT-----------#---
-----------------g-#-b-------BTTTT----------%%%%%----------K------------------------------------#------||||-----||----||-------------TT-----------#---
-M--------------g#-#-B-------bTTTT-----------|||------------gg-------g--------------------------#------||||---o-||----||-k----ggg----TT------ggg--#---
XXXXXXXXXXXXXXXXXXXXXXXXXXXXXXXXXXXXXXXX%%---|||--XXXXXXXXXXXXXXXXXXXXXXXXXXXXXX----------XXXXXXXXXX%%-||||-%%%-||----||XXXXXXXXXXXXXXXXXXXXXXXXXXXXXX
XXXXXXXXXXXXXXXXXXXXXXXXXXXXXXXXXXXXXXXX|----|||--XXXXXXXXXXXXXXXXXXXXXXXXXXXXXX----------XXXXXXXXXX|--||||--|--||----||XXXXXXXXXXXXXXXXXXXXXXXXXXXXXX
