------------------------------------------------------------------------------------------------------------------------------------------------------
------------------------------------------------------------------------------------------------------------------------------------------------------
------------------------------------------------------------------------------------------------------------------------------------------------------
-----------------------oo-----------------------------------------------------------------------------------------------SSSSSSSSSS--------------------
-----------------------------------------g------------------------------------------------------------------------------------------------------------
----------------------------------------%%-------------oooo-----------------------------oo------------------------------------------------------------
----------------------SSSS--------------|--------------%%%%---------------------oo----------------------SSQSSS--------------------!S------------------
----------------------------------------|----oo---SSSS--||-------------------------------------------------------------------------------------y------
----------------------------------------|---------------||------------o----------------------------------------------------------------------#SS--o---
----------------------------------------|---------------||------1----------------SSS----------------------K---------------------------------##--------
---------Q----------------%%%%-TT-------|---------------||-------------------------------S-------tt-----SSSSSS--------------------S------#--##--SC----
---------------------------|||-TT-------|-------------U-||--------------------#-----------T------tt-----------------------SS------------##--##--------
---------------------------|||-TT-------|---------------||-------------------##-----------T------tt-----------------------SS-----------###--##---SSS--
-M--------k---ggg----------|||gTT-------|---------------||--------------------------------T------tt------------k----kkk---SS----------####--##--------
XXXXXXXXXXXXXXXXXXXX%%%----|||XXXXXXXX--|----%%%%-----%%%%%-XXXXXXXXX-XXXXXXXXXX----------XXXXXXXXXXXXXXXXXXXXXXXXXXXXXX--XX--XXXXXXXXXXXXXXXX------XX
XXXXXXXXXXXXXXXXXXXX||-----|||XXXXXXXX--|-----||-------|||--XXXXXXXXX-XXXXXXXXXX----------XXXXXXXXXXXXXXXXXXXXXXXXXXXXXX--XX--XXXXXXXXXXXXXXXX------XX
