------------------------------------------------------------------------------------------------------------------------------------------------------
------------------------------------------------------------------------------------------------------------------------------------------------------
------------------------------------------------------------------------------------------------------------------------------------------------------
------------------------------SSSSSSSSSS--------------------------------------------------SSSSSSSSSS--------------------------------------------------
------------------------------------------------------------------------------------------------------------------------------------------------------
------------------------------------------------------------------------------------------------------------------------------------------------------
-----------------------------------------------------------------------------------o--o-------------------2--------oo-----oo---%%%-------##-----------
--------------------------------------------------------------------------------------------------------------------------SS----||-------##----y------
---------------------------------------S-----------------TT--------------------g------------------------------------------------||-----####--#SS--o---
------------Q--?-----------------------S-----------TT----TT-----1------------------SSSS-------------o---------------------------||-----####-##--------
-------------------SSS-----------------S------tt---TT----XX------------------S@S--------------------------2----%%%%--%%%-----SS-||---######-##--SC----
---------------------K---TT----#--------------tt---TT-------------------------------------t---------------------||----||--------||---######-##--------
-------------------------TT----#-#------------tt---TT---------------------------%%%-------t---------------------||----||--------||---######-##---SSS--
-M----------------K------TT----#-#-------g----tt---TT---------------------------||--------t-------------y--y--o-||----||--------||---######-##--------
XXXXXXXXXXXXXXXXXXXXXXXXXXXXXXXXXXXXXXXXXXXXXXXXXXXXXXXXXXXXXXXXXXXXX--XXXXXXXXX||--------XXXXXXXXXXXXXXXXXXXX%-||----||%%-----%%%XXXXXXXXXXXX------XX
XXXXXXXXXXXXXXXXXXXXXXXXXXXXXXXXXXXXXXXXXXXXXXXXXXXXXXXXXXXXXXXXXXXXX--XXXXXXXXX||--------XXXXXXXXXXXXXXXXXXXX--||----|||-------||XXXXXXXXXXXX------XX
