------------------------------------------------------------------------------------------------------------------------------------------------------
------------------------------------------------------------------------------------------------------------------------------------------------------
------------------------------------------------------------------------------------------------------------------------------------------------------
--------------------------------oo------------------------------------SSSSSSSSSS--------------------SSSSSSSSSS----------------------------------------
-------------------------------------g-g--------------------------------------------------------------------------------------------------------------
----------------------ooor---------%%%%%--------------------------------------------------------------------------------------------------------------
------------------Q--%%%%%----------||||----------Q---------------------------------y-------------------------------------oo---%%%-------##--------SSS
----------------------|||-----------||||---------------------o---o---o--------TT--#SSS---------------------------SSS------SS----||-------##-----------
----------------------|||-----------||||--------------------%%%-%%%-%%--------TT-##---------------------------------------------||-----####-----------
----------------------|||-----%%%%%-||||---------------------|---|---|--------TT###1--------------------------------------------||-----####-----------
--------SU--------?-%%%%%%%----|||--||||----------Q----------|---|---|------SCTT###--------------------------T---------------SS-||---######-------#---
--------------TT----||||||-----|||--||||---------------------|---|---|--TT----TT###--SSS---------------TT----T------------------||---######-------#---
--------------TT----||||||--o--|||--||||---------------------|---|---|--TT----TT###--------------B-----TT----T------------------||---######-------#---
--M-----------TT----||||||-%%%-|||--||||-------------gg----k-|---|-r-|--TT---kTT###--------------b--g--TT----T------------------||---######--ggg--#---
XXXXXXXXXXXXXXXXXXXX||||||--|--|||--||||X-XX-XX-XXXXXXXXXXXX%%%%%%%%%%XXXXXXXXXXXXXXXX---XXXXXXXXXXXXXXXXXXXXX%%%%----%%%%-----%%%XXXXXXXXXXXXXXXXXXXX
XXXXXXXXXXXXXXXXXXXX||||||--|--|||--||||X-XX-XX-XXXXXXXXXXXX-|||||||||XXXXXXXXXXXXXXXX---XXXXXXXXXXXXXXXXXXXXX|||------||-------||XXXXXXXXXXXXXXXXXXXX
