------------------------------------------------------------------------------------------------------------------------------------------------------
------------------------------------------------------------------------------------------------------------------------------------------------------
------------------------------------------------------------------------------------------------------------------------------------------------------
--------------------------------oo----------------SSSSSSS---------------------------------SSSSSSSSSS--------------------------------------------------
---------------------------------------g--------------------------------------------------------------------------------------------------------------
-----------------------------------%%%%%------------------------------------------g--------------------------------k----------------------------------
--------------------USS-------------||||----------QQ----------------------------SSSSSSSS----------------------S---SSSSSS-SSS----S!%----------------SSS
------------------------------------||||--------------------------------------------------------------------------------------------------------------
------------------------------------||||-------------------S-------------------g--------------------------------------------------------SSS-----------
------------------------------%%%%%-||||--------------------------------------------------------------------------------------------------------------
-------------------------------|||--||||----------QQ--QQQ--------------------S@S-------------------------------------------------S%%%%%-----------#---
---------------------B---------|||--||||--------------------------------------------------------------TT---------------------------|||------------#---
---------------------b-------B-|||--||||--------------------------------------------------------------TT----TTTT-------------------|||------------#---
--------------k-ggg--B-------b-|||--||||-------y------------gg-------g--------------------------g-g---TT-k--TTTT------------gg-g-g-|||-------ggg--#---
XXXXXXXXXXXXXXXXXXXXXXXXXXXXXX-|||--||||XXXXXXXXXXXXXXXXX---XXXXXXXXXX-XXXXXXXXXXXXXXX---XXXXXXXXXXXXXXXXXXXXXXXXXXXXX--XXXXXXXXXX%|||------XXXXXXXXXX
XXXXXXXXXXXXXXXXXXXXXXXXXXXXXX-|||--||||XXXXXXXXXXXXXXXXX---XXXXXXXXXX-XXXXXXXXXXXXXXX---XXXXXXXXXXXXXXXXXXXXXXXXXXXXX--XXXXXXXXXX-|||------XXXXXXXXXX
