------------------------------------------------------------------------------------------------------------------------------------------------------
------------------------------------------------------------------------------------------------------------------------------------------------------
------------------------------------------------------------------------------------------------------------------------------------------------------
------------------------------SSSSSSSSSS------------------------------------------------------------SSSSSSSSSS----------------------------------------
------------------------------SSSSSSSSSS--------------------------------------------------------------------------------------------------------------
------------------------------SSSSSSSSSS------------------------------------------------oo------------------------------------------------------------
---------------------LSSS-----SSSSSSSSSS--------------------------------SSSSS---oo---------------------------------oo---SS----------------------------
------------------------------------------------------------------------------------------------------------------------------------------------------
-------------------------------------------------------------------------------------------------------------------------------------g#---------------
---------------------------------------------------------------------------------SS---------------oo-----------------------TT-------g##---------------
---------------------2-----#--SSSSSSSSSS-------------------------------------2-----------S-----------------TT--%%%%--%%%---TT-------###-----#---------
-----------------K---------#--SSSSSSSSSST-----TT----K----------------------TT------------------TT-------#--TT---||----||t--TT------####-----##--------
------------B--------------##-SSSSSSSSSST-----TT----------------------t----TT--T---------------TT------##--TT---||----||t--TT-----#####-----###------#
-M----------b---------kk---##-SSSSSSSSSST-----TT-----------g-y--------t----TT--T------------y--TT---kk-##--TT-o-||----||t--TT-----#####-----####----##
XXXXXXXXXXXXXXXXXXXXXXXXXXXXXXXXXXXXXXXXXXXX--XXXXXXXXXXXXXXXXXXXXXXXXXXXXXXXXXX----------XXXXXXXXXXXXXXX--XX-%-||----||XXXXXXXXXXXXXXX--XXXXXXXXXXXXX
XXXXXXXXXXXXXXXXXXXXXXXXXXXXXXXXXXXXXXXXXXXX--XXXXXXXXXXXXXXXXXXXXXXXXXXXXXXXXXX----------XXXXXXXXXXXXXXX--XX---||----||XXXXXXXXXXXXXXX--XXXXXXXXXXXXX
