------------------------------------------------------------------------------------------------------------------------------------------------------
------------------------------------------------------------------------------------------------------------------------------------------------------
------------------------------------------------------------------------------------------------------------------------------------------------------
S-----SSSS----------------------oo----------------SSSSSSS----------SSS----------SSSSSSSSSL----------------------------------------SSSSSSSSSS----------
S--------------------------------------g--------------------------------------------------------------------------------------------------------------
S----------------------------------%%%%%%%------------------------------------------------------------------------------------------------------------
S--------------------LSSS-----------|||||---------QQ------------CSS--------1--------oooooo-------------------------oo----SSS----S!--------------------
S-----------------------------------|||||----oo-------------------------------------------------------------------------------------------------------
S----------------%%%----------------|||||------------------SSS--2-------------------SSSSSS------------------------------------------------------------
S-----------------||----------%%%%%-|||||----------------------2-2---------ggg------SSSSSS------------------------------------------------------------
S-----------------||-2-----#---|||--|||||---------QQ--QQQ---------2---#########-----------------TT-------------%%%%--%%%---------S--------------------
S------------%%%%%||-------#---|||--|||||-------------------------------------#-----------------TT----TT--------||----||------------------TT----------
S-------------|||-||-------##--|||--|||||-------------------------------------#-----------------TT----TT----TT--||----||-----------tt-----TT-------F--
S--M----------|||-||--kk---##--|||--|||||-------------------------------------#-------------k---TT----TT-k--TTo-||----||----gg-g-g-tt----kTT-------#--
XXXXXXXXXXX---|||-||XXXXXXXXXX-|||--|||||----%%%%-XXXXXXX------XXXXXXX--------X----XXXXXXXXXXXXXXXXXXXXXXXXXXX%-||----||XXXXXXXXXXXXXXXXXXXXXXXXXXXXXX
XXXXXXXXXXX---|||-||XXXXXXXXXX-|||--|||||-----||--XXXXXXX------XXXXXXX--------X----XXXXXXXXXXXXXXXXXXXXXXXXXXX--||----||XXXXXXXXXXXXXXXXXXXXXXXXXXXXXX
