------------------------------------------------------------------------------------------------------------------------------------------------------
------------------------------------------------------------------------------------------------------------------------------------------------------
------------------------------------------------------------------------------------------------------------------------------------------------------
--------------------SSSSSSSSSS----------------------------------------SSSSSSSSSS----------------------------------------------------------------------
--------------------SSSSSSSSSS------------------------------------------------------------------------------------------------------------------------
--------------------SSSSSSSSSS------------------------------------------------------------------------------------------------------------------k-----
--------------------SSSSSSSSSS-----------------------------------------------------------------------------------------------------------------SQS--SQ
------------------------------------------------------------------------------TT---------------------------------SSS----------------------------------
------------------------------------------------------------------------------TT--TT-----------------------------------------SSS----------------------
-----------------------------------oo-----------------------------------------TT--TT--------------oo--------------------------------------------------
---------Q---------%--SSSSSS?-----o--o-----------------ooo------------------SCTT--TT------------------------------------r------------------#---SQS--S?
----------------------SSSSS------------------K---B----------------------TT----TT--TT-----T-----TT-----------g-----------%%%%%%------------##----------
----------------------SSSSS----------------------b----------------------TT----TTT-TT-----T-----TT-----------TT----------|||||------------###----------
-M-----------%%%%----------ooo-------------------B----------gg-------g--TT---kTTT-TT---k-T--y--TT-----------TT----------|||||--------y--####-k------gg
XXXXXXXXXXX---||-----XXXXXXXXXXXXXXXXXXXXXXXXXXXXX--XXXXXXXXXXXXXXXXXXXXXXXXXXXXXXXXXXXXXXXXXXXXXXXX--XXXXXXXX%%%%----%%|||||-----XXXXXXXXXXXXXXXXXXXX
XXXXXXXXXXX---||-----XXXXXXXXXXXXXXXXXXXXXXXXXXXXX--XXXXXXXXXXXXXXXXXXXXXXXXXXXXXXXXXXXXXXXXXXXXXXXX--XXXXXXXX|||------||||||-----XXXXXXXXXXXXXXXXXXXX
