------------------------------------------------------------------------------------------------------------------------------------------------------
------------------------------------------------------------------------------------------------------------------------------------------------------
------------------------------------------------------------------------------------------------------------------------------------------------------
----------------------------------------SSSSSSSSSS--------------------------------------------------------------------------------SSSSSSSSSS----------
------------------------------------------------------------------------------------------------------------------------------------------------------
-------------------------------------------------------oooo-------------------------------------------------------------------------------------k-----
-----------------------------------------oooo----------%%%%--------------------------SUS---------------------------oo--------------------------SQS--SQ
--------------------------------------------------SSSS--||----------------------------------------------------------------------oo--------------------
-----------------------------------------SSSS-U---------||---------------------g----------------------------------------------------------------------
-----------------------------------oo---oS--SoS---------||------1-------------------------------------------------------------------------------------
----------------%%%%--------------o--o--SS--SSS---------||-------------------S@S----#####--------tt------------%%%%--%%%-----TT----------------SQS--S?
-----------------||-----------------------------------U-||--------------------------#-----T------tt-------------||----||-----TT-----------TT----------
-----------------||-------------------------------------||-------------------------K#-----T------tt-------*-----||----||-----TT----tt-----TT----------
-M---------------||------ggg--------------kk------------||--------------------------#-----T------tt-gg----*---o-||----||-y---TT----tt----kTT-k------gg
XXXXXXXXXXX--%%%%||%XXXXXXXXXXXXXXXXXXXXXXXXXXXXXX----%%%%%-XXXXXXXXX--XXXXXXXXXXXXXXXX---XXXXXXXXXXXXXXXXXXX-%-||----||XXXXXXXXXXXXXXXXXXXXXXXXXXXXXX
XXXXXXXXXXX---||-||-XXXXXXXXXXXXXXXXXXXXXXXXXXXXXX-----|||--XXXXXXXXX--XXXXXXXXXXXXXXXX---XXXXXXXXXXXXXXXXXXX---||----||XXXXXXXXXXXXXXXXXXXXXXXXXXXXXX
