------------------------------------------------------------------------------------------------------------------------------------------------------
------------------------------------------------------------------------------------------------------------------------------------------------------
------------------------------------------------------------------------------------------------------------------------------------------------------
S-----SSSS--------------------SSSSSSSSSS------------------------------------------------------------------------------------------SSSSSSSS------------
S------------------------------------------------------------------------o----------------------------------------------------------------------------
S---------------------------------------%%------------------------------%%%-----------------oo--------------------------------------------------------
S---------------------------------------|--------------------------------|--o--------------------------------------oo------------------------QQQQ-----
S---------------------------------------|----oo--------------------------|--SSSS--------------------oo------------------------------------------------
S----------------g---------------------S|----------------TT-----------%--|--------TT---------------%-------------------------SSS----------------------
S----------------#---------------------S|----------TT----TT--------------|--------TT-----------------------------------------------------------y------
S---------S-----##---------------------S|----------TT----XX--------------|--------TT------S------------------T-%%%%--%%%r--------------g##--Q?SSQQQ---
S--------------###-------------#--------|----------TT----------------T---|--------TT-----T-------------------T--||----||%%%%%%---------###------------
S-------------####-------------#-#------|----------TT--------B-------T---|-----%T-TT-----T---%%%%------------T--||----|||||||--------g####------------
S------------#####-------ggg---#-#------|----------TT--------b-------T---|------T-TT---k-T----||----------y--To-||----|||||||--------#####------------
XXXXXXXXXXXXXXXXXXXXXXXXXXXXXXXXXXXXXXXX|----%%%%-XXXXXXXXXXXXXXXX--XX%%%%%%----XXXXXXXXXX----||----XXXXXXXXXX%-||----|||||||-----XXXXXXXX--XX--XXXXXX
XXXXXXXXXXXXXXXXXXXXXXXXXXXXXXXXXXXXXXXX|-----||--XXXXXXXXXXXXXXXX--XX|||||-----XXXXXXXXXX----||----XXXXXXXXXX--||----|||||||-----XXXXXXXX--XX--XXXXXX
