------------------------------------------------------------------------------------------------------------------------------------------------------
------------------------------------------------------------------------------------------------------------------------------------------------------
------------------------------------------------------------------------------------------------------------------------------------------------------
----------------------------------------------------------------------SSSSSSSSSSSSSSSSSSSS--------------------SS-------S------------------------------
------------------------------------------------------------------------------------------------------------------------------------------------------
------------------------------------------------------------------------------------------------------------------------------------------------------
--------------------------------------------------Q-------------------------------------------------------2------------S--------------------SS--------
------------------------------------------------------------------------------TT----------------------------------------------------------------------
---------------------------------------------------------------------o--------TT-----------------------------------SSS---------------g#---------------
-----------------------------------------------------------------y------------TT-------S--------g---o--------------------------SSS--g##---------------
-------------------%-----------TT-----------------Q--------------##---------SCTTSU--------------TT--------2------------S%-----------###-----SS--------
-------------------------------TT-------------------------------###-----TT----TT----TT---t------TT-------------##------------------####-----------#-TT
-------------------------------TT------------------------------####-----TT----TT----TT---t------TT-------------##-----------------#####----------##-TT
-M-----------%%%%-------------gTT--------------------gg----k--#####-----TT---kTT---kTT--kt------TT------y--y---##----------------r#####---------###-TT
XXXXXXXXXXX---||----XXXXX--XXXXXXXXXXX--X-XX-XX-XXXXXXXXXXXXXXXXXXX---XXXXXXXXXXXXXXXXXXXXXXXXXXXXX-XXXXXXXXXX-XX------X----XXXXXXXXXXX--XXXXXXXXXX-XX
XXXXXXXXXXX---||----XXXXX--XXXXXXXXXXX--X-XX-XX-XXXXXXXXXXXXXXXXXXX---XXXXXXXXXXXXXXXXXXXXXXXXXXXXX-XXXXXXXXXX-XX------X----XXXXXXXXXXX--XXXXXXXXXX-XX
