------------------------------------------------------------------------------------------------------------------------------------------------------
------------------------------------------------------------------------------------------------------------------------------------------------------
------------------------------------------------------------------------------------------------------------------------------------------------------
-----------------------oo-----SSSSSSSSSS--------------------------------------------------------------------------------------------------------------
------------------------------------------------------------------------------------------------------------------------------------------------------
--------------------------------------------------------------------------------------------oo--------oo----------------------------------------------
----------------------SSSS----------------------------------------SSoo---------------SSSS----------------------------------------------US---SSS-------
------------------------------------------------------------------------------------------------------------------------------------------------------
---------------------------------------S---------------------------------------g-------------------%--------------------------------------------------
---------------------------------------S-----------------o--------------------------------------------------------------SS-?Q--------SS----------SSSSS
--------------------------%%%%---------S--------------------%%%%%%-----------S@SQ---------S------------------------------------------------S----------
-----------------K---------|||-#-----------------------------||||----------------------------------------------#--------------------------------------
------------B--------------|||-#-#---------------------------||||----------------------------%%%%-----------tt-#---------------y--TT--------SSS-------
---M--------b--------------|||-#-#-------------ggg--k--------||||----------------ggg----------||------ggg---tt-#----ggg----SSSSS--TT---------------r--
XXXXXXXXXXXXXXXXXXXX%%%----|||XXXXXXXXXX-XXXXXXXXX-XXXXXXXXX-||||------XXXXXXXXXXXXXX----X----||----XXXXXXXXXX-XXXXXXXXX-------XX-XXXXXX-X-X-----XXXXX
XXXXXXXXXXXXXXXXXXXX||-----|||XXXXXXXXXX-XXXXXXXXX-XXXXXXXXX-||||------XXXXXXXXXXXXXX----X----||----XXXXXXXXXX-XXXXXXXXX-------XX-XXXXXX-X-X-----XXXXX
