------------------------------------------------------------------------------------------------------------------------------------------------------
------------------------------------------------------------------------------------------------------------------------------------------------------
------------------------------------------------------------------------------------------------------------------------------------------------------
----------------------------------------------------------------------------------------------------SSSSSSSSSS------------------------------SSSSSSSSSS
------------------------------------------------------------------------------------------------------------------------------------------------------
------------------------------------------------------------------------------------------------------------------------------------------------------
---------------------LSSS--------------------------------Q-Q-------------------------SUS----------------------------------SSC------------##-----------
-----------------------------------------------------------------------------------------------------------------SSS---------------------##-----------
---------------------------------------------------------------------------------------------------------------------------------------####-----------
------------------------------------------------------------------------------------------------g-------------------------SSS----------####-----------
-------------------%-2-----#---TT------------------------Q-Q---------#--------------#####-------TT---------TT------------------------######---TT------
---------------------------#---TT-----------------------------------##--------------#-----------TT------#--TT------------------------######---TT------
---------------------------##--TT---------------------------TT-----###-------------K#-----------TT-----##--TT------------------------######---TT------
-M-----------%%%%-----kk---##-gTT-----------y-y-------------TT----####gg------------#-----------TT--kk-##--TT--------------------#---######---TT------
XXXXXXXXXXX---||----XXXXXXXXXXXXXXXXXX--XXXXXXXXXXXXXXXXXXXXXXXXXXXXXXXXXXXXXXXXXXXXXXX---XXXXXXXXX-XXXXX--XX-%%%%----%%X----XXXXXXXXXXXXXXXXXXX--XXXX
XXXXXXXXXXX---||----XXXXXXXXXXXXXXXXXX--XXXXXXXXXXXXXXXXXXXXXXXXXXXXXXXXXXXXXXXXXXXXXXX---XXXXXXXXX-XXXXX--XX-|||------|X----XXXXXXXXXXXXXXXXXXX--XXXX
