------------------------------------------------------------------------------------------------------------------------------------------------------
------------------------------------------------------------------------------------------------------------------------------------------------------
------------------------------------------------------------------------------------------------------------------------------------------------------
S-----SSSS--------------------------------------------------SSSSSSSSSS----------ooo-------SSSSSSSSSS--------------------------------------------------
S-------------------------------------------------?---------SSSS--SSSS----------%%%-------------------------------------------------------------------
S-----------------------------------------------------------SSSS--SSSS-----------|--------------------------------------------------------------------
S-----------------Q-S-------------------------QQQQ------------SS---S-------------|-----------------------------------------------------US-------------
S--------------------------TT---------------------SS----------SS---S-------------|--------------------------------------------------------------------
S--------------------------TT---------------------------------SS---S-------------|-------------------------------------------SSS----------------------
S--------------------------XX-------------------k-----------ooSS---SoU-----------|---%%%%--------------------------------------------SS---------------
S-----------------?----TT---------------T-----?QQQ----------SSSS---SSS-----------|----||--------------------------------r------------------S#---------
S-------------TT-------TT--------------TT--------------SSS----------------------%%%%%%||--t-----------TT-------#--------%%%%%%--------------##--------
S-------------TT-------TT--------------TT----------------------------------------||||-||--t-----------TT----TT-#--------|||||-----TT--------###------#
S--M----------TT----k--TT------------kkTT-------------------k--g-g----gg---------||||-||--t-----------TT-k--TT-#----ggg-|||||-----TT--------####----##
XXXXXXXXXXXXXXXXXXXXXXXXXXXXXXXXXXXXXXXXXXXXXXXXXX----------XXXXXXXXXXXXXXXXXXXX-||||-||%%XXXXXXXXXXXXXXXXXXXX-XXXXXXXXX|||||-----XXXXXX-X-XXXXXXXXXXX
XXXXXXXXXXXXXXXXXXXXXXXXXXXXXXXXXXXXXXXXXXXXXXXXXX----------XXXXXXXXXXXXXXXXXXXX-||||-||-|XXXXXXXXXXXXXXXXXXXX-XXXXXXXXX|||||-----XXXXXX-X-XXXXXXXXXXX
