------------------------------------------------------------------------------------------------------------------------------------------------------
------------------------------------------------------------------------------------------------------------------------------------------------------
------------------------------------------------------------------------------------------------------------------------------------------------------
----------SSSSSSSSSS---oo---------------SSSSSSSSSS----------------------------------------SSSSSSSSSS--------------------------------------------------
----------------------------------------SSSSSSSS------------------------------------------------------------------------------------------------------
----------------------------------------SSSCSSSS----------------------------------g-------------------------------------------------------------------
----------------------SSSS--------------SSSSSSSS--------------------------------SSSSSSSS--------------------------------SS--------!S------------------
----------------------------------------------------------------------------------------------------------TT------------------------------------------
-------------------------------------------------------------------------------g--------------------------TT------------------------------------------
-------------------------------------------ggg------------------------------------------------------------TT---------------TT-------------------------
----------@QQQQ-----------%%%%---------TSSSSSSSS-------ooo-----------#-------S@S-------------------------SXXS--------------TT-----S------#------------
---------------------------|||---------TSSSSSSSS--------------------##--------------------------------------------------t--TT-----------##------------
-----------------g-#-------|||---------TSSSSSSSS------------TT-----###------------------------------TT------------------t--TT----------###---------F--
-M--------------g#-#-------|||--gg-----TSSSSSSSS------------TT----####--------------------------g-g-TT---------k----kkk-t--TT---------####---------#--
XXXXXXXXXXXXXXXXXXXX%%%----|||XXXXXXXXXXXXXXXXXXXX--XXXXXXXXXXXXXXXXXX-XXXXXXXXXXXXXXX---XXXXXXXXXXXXXXXXXXXXXXXXXXXXXXXXXXXXXXXXXXXXXXXXXXXXXXXXXXXXX
XXXXXXXXXXXXXXXXXXXX||-----|||XXXXXXXXXXXXXXXXXXXX--XXXXXXXXXXXXXXXXXX-XXXXXXXXXXXXXXX---XXXXXXXXXXXXXXXXXXXXXXXXXXXXXXXXXXXXXXXXXXXXXXXXXXXXXXXXXXXXX
