------------------------------------------------------------------------------------------------------------------------------------------------------
------------------------------------------------------------------------------------------------------------------------------------------------------
------------------------------------------------------------------------------------------------------------------------------------------------------
------------------------------SSSSSSSSSS----------------------------------------------------------------------------------------------------SSSSSSSSSS
------------------------------------------------------------------------------------------------------------------------------------------------------
-------------------------------------------------------oooo-------------------------------------------------------------------------------------------
----------------------!--------------------------------%%%%--------------------------1-----SSS!-----------------------------------%-------------------
--------------------------------------------------SSSS--||---o---o---o--------------------------------------------------------------------------------
---------------------------------------S----------------||--%%%-%%%-%%------------------------------------------------------------------SSS-----------
---------------------------------------S----------------||---|---|---|--------------------------------------------------SS-?Q-------------------------
----------------%%%%S@S!S--------------S----------------||---|---|---|-------------QQQQ-------C-----------------!-----S-----------%%%%%-------TT------
-----------------||------------#--------T-----TT------U-||---|---|---|--------------------------------------g----------------------|||--------TT------
-----------------||---------tt-#-#------T-----TT--------||---|---|---|--------------------------------------TT-----------------y---|||--------TT------
-M---------------||--g------tt-#-#------T-----TT--------||---|---|-r-|gg------------yy---------g-g----------TT-------------SSSSS---|||--------TT------
XXXXXXXXXXX--%%%%||%XXXXXXXXXXXXXXXXXXXXXXXX--XXXX----%%%%%-%%%%%%%%%%XXXXXXXXXXXXXXXXXXXXXXXXXXXXXX--XXXXXXXXXXXXXXXXXX-------XX-%|||------XXXX--XXXX
XXXXXXXXXXX---||-||-XXXXXXXXXXXXXXXXXXXXXXXX--XXXX-----|||---|||||||||XXXXXXXXXXXXXXXXXXXXXXXXXXXXXX--XXXXXXXXXXXXXXXXXX-------XX--|||------XXXX--XXXX
