------------------------------------------------------------------------------------------------------------------------------------------------------
------------------------------------------------------------------------------------------------------------------------------------------------------
------------------------------------------------------------------------------------------------------------------------------------------------------
------------------------------------------------------------------------------------------SSSSSSSSSS----------SS-------S------------------------------
------------------------------------------------------------------------------------------------------------------------------------------------------
----------------------------------------ooooo---------------------------------------------------------------------------------------------------k-----
---------------------------------------------------------------------------1-------USS---------------------------------S-----------------------SQS--SQ
------------------------------------------------SS----------------------------------------------------------------------------------------------------
-----------------------------------------SSSS----------------------------------------------------------------------SSS-------SSS-----g#---------------
---------------------------------------------------------------------------ggg------------------------------------------------------g##---------------
----------Q-----------------TT-------------------------ooo-----------##########---#------------------------------------Sr-----------###--------SQS--S?
----------------------------TT--------tt----------------------------##--------#---#-------------------TT-------##-------%%%%%%-----####---------------
----------------------------TT--------tt----%%%%%-----------TT-----###--------#---##------------------TT----TT-##-------|||||-----#####---------------
-M-----------------#----ggg-TT--------tt-----|||------------TT----####--------#---##--gg--------g-g---TT-k--TT-##-------|||||-----#####------k------gg
XXXXXXXXXXXXX--XXXXXXXXXXXXXXXXXXXXXXXXX%%---|||----XXXXXXXXXXXXXXXXXX--------X---XXXXXXXXXXXXXXXXXXXXXXXXXXXX-XX------X|||||-----XXXXX--XXXXXXXXXXXXX
XXXXXXXXXXXXX--XXXXXXXXXXXXXXXXXXXXXXXXX|----|||----XXXXXXXXXXXXXXXXXX--------X---XXXXXXXXXXXXXXXXXXXXXXXXXXXX-XX------X|||||-----XXXXX--XXXXXXXXXXXXX
