------------------------------------------------------------------------------------------------------------------------------------------------------
------------------------------------------------------------------------------------------------------------------------------------------------------
------------------------------------------------------------------------------------------------------------------------------------------------------
S-----SSSS------------------------------SSSSSSSSSS--------------------------------------------------SSSSSSSSSS----------------------------------------
S-----------------------------------------------------------------------------------------------------------------------------------------------------
S---------------------------------------------------------------------------------------oo------------------------------------------------------------
S-------------------USS------------------oooo-----------------------------------oo---------------------------------------------SSS-----US-------------
S-----------------------------------------------------------------------------------------------------------------------------------------------------
S----------------g-----------------------SSSS-U-----------------------o-------------------------------------------------------------------------------
S----------------#-----------------oo---oS--SoS----------------------------------SSS--------------------------------------------K----SS---------------
S---------S-----##----------------o--o--SS--SSS----------------------#-------------------S-------------------T--------r--------SSS---------S--#LSS----
S--------------###---B------------------------------K---------------##--------#------------------------TT----T----%%%%%%----------------------#-------
S-------------####---b-------B------------------------------TT-----###-------##------------------B-----TT----T-----|||||-TT-------TT----------#-------
S------------#####---B-------b------------kk---------------gTT----####---------------------------b--g--TT----T-----|||||-TT-------TT--------kk#-------
XXXXXXXXXXXXXXXXXXXXXXXXXXXXXXXXXXXXXXXXXXXXXXXXXXXXXXXXXXXXXXXXXXXXXXXXXXXXXXXX----------XXXXXXXXXXXXXXXXXXXX-%%%-|||||XXXXXXXXXXXXXXXX-X-XXXXXXXX---
XXXXXXXXXXXXXXXXXXXXXXXXXXXXXXXXXXXXXXXXXXXXXXXXXXXXXXXXXXXXXXXXXXXXXXXXXXXXXXXX----------XXXXXXXXXXXXXXXXXXXX--|--|||||XXXXXXXXXXXXXXXX-X-XXXXXXXX---
