------------------------------------------------------------------------------------------------------------------------------------------------------
------------------------------------------------------------------------------------------------------------------------------------------------------
------------------------------------------------------------------------------------------------------------------------------------------------------
--------------------------------------------------SSSSSSSSSS--------------------SSSSSSSSSS------------------------------------------------------------
------------------------------------------------------SS--SS------------------------------------------------------------------------------------------
------------------------------------------------------SS--SS------------------------------------------------------------------------------------------
----------------------------------------------------SS------------SSoo--SSSSS--------------SSS!-------------------------SSS------------US-------------
----------------------------------------------------SS----------------------------------------------oo------------------------------------------------
----------------------------------------------------SS------------------------------------------------------------------------------------------------
----------------------------------------------------SS----oo---------------------------S---------------------------------------------SS---------------
----------------!-----------------------------------SSSS--SS%%%%%%-----------2--SU------------C--------------T-----------------------------S----------
--------------------------------------tt--------------SS-----||||----------TT-------TT---t-------------------T-#--------------------------------------
--------------------------------------tt--------------SS-----||||-----t----TT--T----TT---t-------------------T-#--------------TT--TT---------------F--
-M------------------------------------tt---------------------||||-----t----TT--T---kTT--kt-----g-g--------y--T-#----ggg-------TT--TT---------------#--
XXXXXXXXXXXXXXXXXXXXXXXXX--XXXXXXXXXXXXXX-XX-XX-XXXXXXXXXXXX-||||-----XXXXXXXXXXXXXXXXXXXXXXXXXXXXXXXXXXXXXXXX-XXXXXXXXX----XXXXXXXXXXXX-X-XXXXXXXXXXX
XXXXXXXXXXXXXXXXXXXXXXXXX--XXXXXXXXXXXXXX-XX-XX-XXXXXXXXXXXX-||||-----XXXXXXXXXXXXXXXXXXXXXXXXXXXXXXXXXXXXXXXX-XXXXXXXXX----XXXXXXXXXXXX-X-XXXXXXXXXXX
