------------------------------------------------------------------------------------------------------------------------------------------------------
------------------------------------------------------------------------------------------------------------------------------------------------------
------------------------------------------------------------------------------------------------------------------------------------------------------
------------------------------SSSSSSSSSS--------------------------------------------------------------------------------------------------------------
------------------------------SSSSSSSSSS--------------------------------------------------------------------------------------------------------------
------------------------------SSSSSSSSSS------------------------------------------------oo------------------------------------------------------------
--------------------S---------SSSSSSSSSS----------------------------------------oo--------SSS------%------2-----------US----------!S------------------
---------------------------TT---------------------------------------------------------------------------------------------------oo--------------------
---------------------------TT----------------------------------------o--------------------------------------------------------------------------------
---------------------------XX------------------------------------y-------1-------SS-----------------o---------------E---------------------------------
----------------%%%%---TT-----SSSSSSSSSS---------------ooo-------##---T------------------S--%%%-----------2--------TT--------TT---S------#------------
-----------------||----TT-----SSSSSSSSSS------------------------###---T----TT----------------|---------------------TT--t-----TT---------##------------
-----------------||----TT-----SSSSSSSSSS-----------------------####---T----TT----------------|---------------------TT--t-----TT--------###---------F--
-M---------------||-k--TT-----SSSSSSSSSS-------ggg------------#####---T---kTT----------------|----------y--y----g--TT--t-y---TT-------####---------#--
XXXXXXXXXXX--%%%%||%XXXXXXXXXXXXXXXXXXXX-XXXXXXXXX--XXXXXXXXXXXXXXX---XXXXXXXXXX-------------|------XXXXXXXXXXXXXXXXXXXXXXXXXXXXXXXXXXXXXXXXXXXXXXXXXX
XXXXXXXXXXX---||-||-XXXXXXXXXXXXXXXXXXXX-XXXXXXXXX--XXXXXXXXXXXXXXX---XXXXXXXXXX-------------|------XXXXXXXXXXXXXXXXXXXXXXXXXXXXXXXXXXXXXXXXXXXXXXXXXX
