------------------------------------------------------------------------------------------------------------------------------------------------------
------------------------------------------------------------------------------------------------------------------------------------------------------
------------------------------------------------------------------------------------------------------------------------------------------------------
--------------------------------------------------------------------------------ooo-----------------SSSSSSSSSS----------------------------------------
--------------------------------------------------------------------------------%%%-------------------------------------------------------------------
----------------------------------------%%---------------------------------------|--------------------------------------------------------------------
------------------------------S---------|-----------------------------------SSSS-|---------SSS!---------------------------SSC-----%----------QQQQ-----
----------------------------------------|----oo----------------------------------|--------------------------------------------------------------------
----------------------------------------|----------------------------------------|------------------------------------------------------SSS-----------
----------------------------------------|----------------o-------------------K---|---%%%%---------------------------------SSS------------------y------
---------Q---------%--------TT##--SSC---|----------------------------#-----SSSSS-|----||------C------------TT---------r-----------%%%%%-----Q?SSQQQ---
----------------------------TT----------|---------------------------##T---------%%%%%%||----------------#--TT-----%%%%%%-----------|||----------------
----------------------------TT----------|-------------------TT-----###T----------||||-||---------------##--TT------|||||-----------|||----------------
-M-----------%%%%-------ggg-TT----------|-----------k-------TT----####T----------||||-||-------g-g--kk-##--TT------|||||---------#-|||----------------
XXXXXXXXXXX---||----XXXXXXXXXXXX--XXXXXX|----%%%%--XXXXXXXXXXXXXXXXXXXXXXXXXXXXX-||||-||%%XXXXXXXXXXXXXXX--XX--%%%-|||||X----XXXXX%|||------XX--XXXXXX
XXXXXXXXXXX---||----XXXXXXXXXXXX--XXXXXX|-----||---XXXXXXXXXXXXXXXXXXXXXXXXXXXXX-||||-||-|XXXXXXXXXXXXXXX--XX---|--|||||X----XXXXX-|||------XX--XXXXXX
