------------------------------------------------------------------------------------------------------------------------------------------------------
------------------------------------------------------------------------------------------------------------------------------------------------------
------------------------------------------------------------------------------------------------------------------------------------------------------
-------------------------------------------------------------------SSS--------------------SSSSSSSSSS--------------------------------------------U-----
--------------------------------------------?---------------------------------------------------------------------------------------------------------
----------------------------------------------------------------------------------------oo------------------------------------------------------------
---------------------LSSS-------------------------Q-------------CSS---------SSSSoo---------------------------------oo----SSS----S!--------------------
----------------------------------------------r---------------------------------------------------------------------------------------------------SS--
------------------------------------------%%%%%%------------SS--2--------------------------------------------------------------------g#---------------
-------------------------------------------||||----------------2-2-----------K---SS-------------------------------------------------g##-------SS------
-------------------%-2-----#-----------T%%-||||oooQ---------------2--------SSSSS---------S---------------------%%%%--%%%---------S--###--------------#
---------------------------#-----------T|--||||--r--------------------T-------------------t-----------TT--------||----||-----------####-------------##
---------------------------##----------T|%%%%%%%%%--------------------T-------------------t-----------TT----TT--||----||----------#####------------###
-M-----------%%%%-----kk---##---gg-----T|-||||||||---gg----k----------T-------------------t-----------TT-k--TTo-||----||----gg-g-g#####-----------####
XXXXXXXXXXX---||----XXXXXXXXXXXXXXXXXXXX|-||||||||XXXXXXXXXX---XXXXXXXXXXXXXXXXX----------XXXXXXXXXXXXXXXXXXXX%-||----||XXXXXXXXXXXXXXX--XXXXXXXX-XXXX
XXXXXXXXXXX---||----XXXXXXXXXXXXXXXXXXXX|-||||||||XXXXXXXXXX---XXXXXXXXXXXXXXXXX----------XXXXXXXXXXXXXXXXXXXX--||----||XXXXXXXXXXXXXXX--XXXXXXXX-XXXX
