------------------------------------------------------------------------------------------------------------------------------------------------------
------------------------------------------------------------------------------------------------------------------------------------------------------
------------------------------------------------------------------------------------------------------------------------------------------------------
--------------------------------oo----------------SSSSSSS-----------------------ooo-------------------------------------------------------------------
-------------------------------------g-g----------------------------------------%%%-------------------------------------------------------------------
-----------------------SSS---------%%%%%-----------------------------------------|----------oo--------------------------------------------------------
------------------------------------||||----------QQ-----------------------------|----------------------SSQSSS--------------------%-------------------
---------------------g--------------||||-----------------------------------------|----------------------------------------------oo--------------------
--------------------%%%-------------||||-------------------S---------------------|-----------------%------------------------------------SSS-----------
--------------------||----SSS-%%%%%-||||-----------------------------------------|---%%%%-----------------K-------------------------------------------
----------------%%%%||---------|||--||||----------QQ--QQQ------------T-----------|----||--S-------------SSSSSS--!-----S------TT---%%%%%-----#---------
-----------------||-||---------|||--||||-----------------------------T----------%%%%%%||-------------------------------------TT----|||------##--------
-----------------||-||---------|||--||||-----------------------------T-----------||||-||-----%%%%----------------------------TT----|||------###------#
-M---------------||-||----oo---|||--||||-------ggg------------ggg----Tgg---------||||-||------||-------------------------y---TT----|||------####----##
XXXXXXXXXXX--%%%%||%||---%%%---|||--||||-XXXXXXXXXXXXXXXX---XXXXXXXXXXXXXXXXXXXX-||||-||%%----||----XXXXXXXXXXXXXXXXXXXXXXXXXXXXXX%|||------XXXXXXXXXX
XXXXXXXXXXX---||-||-||----|----|||--||||-XXXXXXXXXXXXXXXX---XXXXXXXXXXXXXXXXXXXX-||||-||-|----||----XXXXXXXXXXXXXXXXXXXXXXXXXXXXXX-|||------XXXXXXXXXX
