------------------------------------------------------------------------------------------------------------------------------------------------------
------------------------------------------------------------------------------------------------------------------------------------------------------
------------------------------------------------------------------------------------------------------------------------------------------------------
S-----SSSS------------------------------------------------------------SSSSSSSSSSSSSSSSSSSS----------------------------------------SSSSSSSSSS----------
S----------------------------------------g----------------------------------SSSS----------------------------------------------------------------------
S---------------------------------------%%-------------------------------g--SSSS----------------------------------------------------------------------
S-------------------S-------------------|-------------------------------SS----------------SSS------%---------R----------SSS------------------QQQQ-----
S--------------------------TT-----------|----oo-------------------------SS-------------------------------r--------------------------------------------
S--------------------------TT-----------|----------------------------o--SS--------------------------%%%%%%%-------------------------------------------
S--------------------------XX-----------|------------------------y------SC--g-g--------S------------||||||-------------------------------------y------
S---------Q------------TT------TT-------|------------------------##-----SS--SSSSSU----------%%%-----||||||----------------------------------Q?SSQQQ---
S----------------------TT------TT-------|-----------K-----------###-----------------TT---t---|------||||||--------------------------------TT----------
S----------------------TT------TT-------|----------------------####-----------------TT---t---|------||||||---------B----------TT---tt-----TT----------
S------------------#k--TT-----gTT-------|------------------g--#####----------------kTT--kt---|------||||||--oo-----b----------TT---tt----kTT----------
XXXXXXXXXXXXX--XXXXXXXXXXXXXXXXXXXXXXX--|----%%%%-XXXXXXXXXXXXXXXXX---XXXXXXXXXXXXXXXXXXXX---|------||||||--%%XXXXXXXXXX----XXXXXXXXXXXXXXXXXX--XXXXXX
XXXXXXXXXXXXX--XXXXXXXXXXXXXXXXXXXXXXX--|-----||--XXXXXXXXXXXXXXXXX---XXXXXXXXXXXXXXXXXXXX---|------||||||---|XXXXXXXXXX----XXXXXXXXXXXXXXXXXX--XXXXXX
