------------------------------------------------------------------------------------------------------------------------------------------------------
------------------------------------------------------------------------------------------------------------------------------------------------------
------------------------------------------------------------------------------------------------------------------------------------------------------
------------------------------------------------------------------------------------------------------------------------------------------------------
------------------------------------------------------------------------------------------------------------------------------------------------------
-----------------------SSS----------------------------------------------------------------------------------------------------------------------------
--------------------------------------------------------------USSS---------g------------------------------------------------------!S------------------
---------------------g-------------------------------------------------%%%%%%-----------------------------TT----oooo----------------------------------
--------------------%%%-------------------------------------------------||||------TT----------------------TT------------------------------------------
--------------------||----SSS----------------------------o--------------||||------TT----------------------TT------------------------------------------
--------SU------%%%%||---------------------------------------S-----TT---||||------TT------------TT-------SXXS-T-------------------S------#--#---------
-----------------||-||----------------K----------------------------TT---||||------TT-----T------TT------------T-------------------------##--##--------
-----------------||-||--------TTTT---------------------------------TT---||||----T-TT-----T------TT--TT--------T------------------------###--###------#
--M--------------||-||----oo--TTTT-------------ggg--k--------ggg---TT---||||----T-TT---k-T--k---TT--TT--------T---y------k----ggg-----####--####----##
XXXXXXXXXXX--%%%%||%||---%%%--XXXXXXXXXX-XXXXXXXXX-XXXXXXXXXXXXXXXXXXX--||||----XXXXXXXXXXXXXXXXXXXXXXXXXXXXXXXXXXXXXXXXXXXXXXXXXXXXXXXXXXXXXXXXXXXXXX
XXXXXXXXXXX---||-||-||----|---XXXXXXXXXX-XXXXXXXXX-XXXXXXXXXXXXXXXXXXX--||||----XXXXXXXXXXXXXXXXXXXXXXXXXXXXXXXXXXXXXXXXXXXXXXXXXXXXXXXXXXXXXXXXXXXXXX
