------------------------------------------------------------------------------------------------------------------------------------------------------
------------------------------------------------------------------------------------------------------------------------------------------------------
------------------------------------------------------------------------------------------------------------------------------------------------------
S-----SSSS------------------------------------------------------------SSSSSSSSSS--------------------SSSSSSSSSS----------------------------------------
S-------------------------------------------?-------------------------------SSSS----------------------------------------------------------------------
S------------------------------------------------------------------------g--SSSS--------oo--oo--------------------------------------------------------
S--------------------LSSS-----------------------------------------------SS------oo--------------------------------------------------------------------
S---------------------------------------------r-------------------------SS----------------------------------------------------------------------------
S-----------------------------------------%%%%%%------------------------SS-------------------------%-------------------------SSS----------------------
S------------------------------------------||||-------------------------SC--g-g--SSS------------------------------------------------------------------
S---------------!----2-----#-----------T%%-||||ooo-------------------T--SS--SSSS---------SSS-----------------T--------r-r-------------------#---------
S--------------------------#-----------T|--||||--r--K----------------T---------------------------------TT----T----%%%%%%%%%%%%--------------##--------
S--------------------------##----------T|%%%%%%%%%-------------------T-----------------------%%%%------TT----T-----||||||||||---------------###------#
S--M------------------kk---##---gg-----T|-||||||||---------g--ggg----T------------------------||----g--TT----T-----||||||||||-----k---------####----##
XXXXXXXXXXXXXXXXXXXXXXXXXXXXXXXXXXXXXXXX|-||||||||XXXXXXXXXXXXXXXXXXXXXXXXXXXXXX--------------||----XXXXXXXXXX-%%%-||||||||||-----XX---XXXXXXXXXXXXXXX
XXXXXXXXXXXXXXXXXXXXXXXXXXXXXXXXXXXXXXXX|-||||||||XXXXXXXXXXXXXXXXXXXXXXXXXXXXXX--------------||----XXXXXXXXXX--|--||||||||||-----XX---XXXXXXXXXXXXXXX
