------------------------------------------------------------------------------------------------------------------------------------------------------
------------------------------------------------------------------------------------------------------------------------------------------------------
------------------------------------------------------------------------------------------------------------------------------------------------------
----------SSSSSSSSSS------------------------------------------------------------SSSSSSSSSS------------------------------------------------------------
------------------------------------------------------------------------------------------------------------------------------------------------------
-------------------------------------------------------------------------------------------------------------------k----------------------------------
------------------------------S-------------------------------------------------------------------------------S---SSSSSS--oo---%%%--------------------
--------------------------------------------------------------------------------------------------------------------------SS----||--------------------
--------------------------------------------------------------------------------------------------------------------------------||--------------------
---------------------------------------------------------------------------------------S---o------------------------------------||--------------------
------------------------------##--SSC--------------------------------T----------SU---------------TT---%%%%%%-----------------SS-||--------------------
----------------------------------------------------K----------------T--------------TT---t-------TT----||||---------------------||--------------------
---------------------------------------------------------------------T--------------TT---t-------TT----||||---TT----------------||-----------------F--
-M-----------------------ggg-------------------ggg---------g--ggg----Tgg-----------kTT--kt-------TT----||||---TT----------------||k----------------#--
XXXXXXXXXXX--XX--X--XXXXXXXXXXXX--XXXXXX-XXXXXXXXXXXXXXXXXXXXXXXXXXXXXXXXXXXXXXXXXXXXXXXXXXXXXXXXXXX%%-||||-%%XXXXXXXX--%%-----%%%XX---XXXXXXXXXXXXXXX
XXXXXXXXXXX--XX--X--XXXXXXXXXXXX--XXXXXX-XXXXXXXXXXXXXXXXXXXXXXXXXXXXXXXXXXXXXXXXXXXXXXXXXXXXXXXXXXX|--||||--|XXXXXXXX--|-------||XX---XXXXXXXXXXXXXXX
