------------------------------------------------------------------------------------------------------------------------------------------------------
------------------------------------------------------------------------------------------------------------------------------------------------------
------------------------------------------------------------------------------------------------------------------------------------------------------
----------------------------------------SSSSSSSSSS------------------------------SSSSSSSSSL--------------------------------------------------SSSSSSSSSS
------------------------------------------------------------------------------------------------------------------------------------------------------
--------------------------------------------------------------g-----------------------------oo--------------------------------------------------------
-----------------------------U-----------oooo-----------------SSSSS-----------------oooooo--------------SSQSSS-------------------------US-------------
------------------------------------------------------------------------------------------------------------------------------------------------------
-----------------------------------------SSSS-U--------------------------------g----SSSSSS---------%--------------------------SSS---------------------
----------------------------------------oS--SoS----------o--------------------------SSSSSS----------------K--------------------------SS---------------
----------------%%%%--------##--QQQQ----SS--SSS------------------------------S@S----------SS------------SSSSSS--------r-%------------------S--TT------
-----------------||----y-#####-------K-B--------------------------------------------------------------------------%%%%%%----------------------TT------
-----------------||-y-######-----------b----------------------TT-----t-----------------------%%%%------------------|||||----------TT----------TT------
-M---------------||-######-------------b--kk--------k---------TT-----t------------------------||-------------------|||||---------rTT----------TT------
XXXXXXXXXXX--%%%%||%XXXX------XXXXXXXXXXXXXXXXXXXX-XXXXXXXXXXXXXXXXXXX-XXXXXXXXX---XXXXXXX----||----XXXXXXXXXX-%%%-|||||----XXXXXXXXXXXX-X-XXXXX--XXXX
XXXXXXXXXXX---||-||-XXXX------XXXXXXXXXXXXXXXXXXXX-XXXXXXXXXXXXXXXXXXX-XXXXXXXXX---XXXXXXX----||----XXXXXXXXXX--|--|||||----XXXXXXXXXXXX-X-XXXXX--XXXX
