------------------------------------------------------------------------------------------------------------------------------------------------------
------------------------------------------------------------------------------------------------------------------------------------------------------
------------------------------------------------------------------------------------------------------------------------------------------------------
----------------------------------------------------------------------------------------------------SSSSSSSSSS----------------------------------U-----
------------------------------------------------------------------------------------------------------------------------------------------------------
-----------------------SSS--------------------------------------------------------------oo------------------------------------------------------------
--------------------------------------------------------------------------------oo---------------------------------oo---SS----------------------------
---------------------g----------------------------------------------------------------------------------------------------------------------------SS--
-----------------g--%%%----------------------------------B--------------------------------------------------------------------------------------------
-----------------#--||----SSS----------------------------b-----------------------SSS---------------------------------------TT-----------------SS------
----------S-----##--||----------QQQQ-------------------SS#CS-----------------------------S------TT---------TT--%%%%--%%%---TT--------------#---------#
---------------###--||---------------K-B--------------------------------------------------------TT------#--TT---||----||t--TT-------------##--------##
--------------####--||-----------------b-------------------K------------------------------------TT-----##--TT---||----||t--TT------------###-------###
-M-----------#####--||----oo-----------b-------y-------------y------------------------------k---TT--kk-##--TT-o-||----||t--TT--------y--####------####
XXXXXXXXXXXXXXXXXXXX||---%%%--XXXXXXXXXXXXXXXXXXXXXXXXXXXXXXXXXXXXXXXXX----XXXXX----------XXXXXXXXXXXXXXX--XX-%-||----||XXXXXXXXXXXXXXXXXXXXXXXXX-XXXX
XXXXXXXXXXXXXXXXXXXX||----|---XXXXXXXXXXXXXXXXXXXXXXXXXXXXXXXXXXXXXXXXX----XXXXX----------XXXXXXXXXXXXXXX--XX---||----||XXXXXXXXXXXXXXXXXXXXXXXXX-XXXX
