------------------------------------------------------------------------------------------------------------------------------------------------------
------------------------------------------------------------------------------------------------------------------------------------------------------
------------------------------------------------------------------------------------------------------------------------------------------------------
--------------------SSSSSSSSSSSSSSSSSSSSSSSSSSSSSS------------------------------ooo-------SSSSSSSSSS--------------------------------------------------
--------------------SSSSSSSSSS----------SSSSSSSS--------------------------------%%%-------------------------------------------------------------------
--------------------SSSSSSSSSS----------SSSCSSSS---------------------------------|------------------oo------------------------------------------------
--------------------SSSSSSSSSS----------SSSSSSSS--Q------------------------------|------------------%%%--------------------------------------QQQQ-----
---------------------------------------------------------------------------------|------------------||--o----R----------------------------------------
---------------------------------------S-----------------------------oo----------|------------------||-%%%--------------------SSS----g#---------------
------------Q--?-----------------------S---ggg-------------------y---------------|---%%%%-----------||--|---------------------------g##--------y------
-------------------S--SSSSSS?----------SSSSSSSSS--Q--------------##--------------|----||------------||--|-------------r-%-----------###-----Q?SSQQQ---
----------------------SSSSS----#--------SSSSSSSS----------------###-----------#-%%%%%%||------------||-o|---------%%%%%%-----------####---------------
----------------------SSSSS----#-#------SSSSSSSS---------------####----------##--||||-||------------||%%%%%--------|||||----------#####---------------
-M----------------K--------ooo-#-#------SSSSSSSS-----gg----k--#####--------------||||-||--------g-g-||-|||---------|||||---------r#####---------------
XXXXXXXXXXXXXXXXXXXX-XXXXXXXXXXXXXXXXXXXXXXXXXXXXXXXXXXXXXXXXXXXXXX---XXXXXXXXXX-||||-||%%XXXXXXXXXX||-|||-----%%%-|||||----XXXXXXXXXXX--XXXXX--XXXXXX
XXXXXXXXXXXXXXXXXXXX-XXXXXXXXXXXXXXXXXXXXXXXXXXXXXXXXXXXXXXXXXXXXXX---XXXXXXXXXX-||||-||-|XXXXXXXXXX||-|||------|--|||||----XXXXXXXXXXX--XXXXX--XXXXXX
