------------------------------------------------------------------------------------------------------------------------------------------------------
------------------------------------------------------------------------------------------------------------------------------------------------------
------------------------------------------------------------------------------------------------------------------------------------------------------
--------------------------------------------------------------------------------SSSSSSSSSL------------------------------------------------------------
------------------------------------------------------------------------------------------------------------------------------------------------------
------------------------------------------------------------------------------------------------------------------------------------------------------
---------------------LSSS-----------------------------------------------------------oooooo-------------------------------SSS----S!-------##--QQQQ-----
----------------------------------------------------------------------------------------------------oo-----------------------------------##-----------
------------------------------------------------------------------------------------SSSSSS---------------------------------------------####-----------
---------------------------------------------------------o------1-------------------SSSSSS------g--------------------------------------####----y------
---------------------2-----#---TT---------------------------------------------------------------TT-----------T--------r----------S---######-Q?SSQQQ---
---------------------------#---TT-------T-----TT------------------------------------------------TT-----------T----%%%%%%-------------######-----------
---------------------------##--TT-------T-----TT------------------------------------------------TT-----------T-----|||||-------------######-----------
-M--------k---ggg-----kk---##-gTT-------T-----TT----k-----------------gg------------------------TT--------y--T-----|||||----gg-g-g---######-----------
XXXXXXXXXXXXXXXXXXXXXXXXXXXXXXXXXXXXXX--XXXX--XXXX-XXXXXXXXXXXXXXXXXX-XXXXXXXXXX---XXXXXXXXXXXXXXXX-XXXXXXXXXX-%%%-|||||XXXXXXXXXXXXXXXXXXXXXX--XXXXXX
XXXXXXXXXXXXXXXXXXXXXXXXXXXXXXXXXXXXXX--XXXX--XXXX-XXXXXXXXXXXXXXXXXX-XXXXXXXXXX---XXXXXXXXXXXXXXXX-XXXXXXXXXX--|--|||||XXXXXXXXXXXXXXXXXXXXXX--XXXXXX
