------------------------------------------------------------------------------------------------------------------------------------------------------
------------------------------------------------------------------------------------------------------------------------------------------------------
------------------------------------------------------------------------------------------------------------------------------------------------------
------------------------------------------------------------------------------------------------------------------------------------------------------
------------------------------------------------------------------------------------------------------------------------------------------------------
---------------------------------------------------------------------R--------------------------------------------------------------------------------
--------------------USS-----------------------------------------------------SSSS---USS-----------------------------------SSS----S!----------SSS-------
------------------------------------------------------------------------------------------------------------------------------------------------------
------------------------------------------------------------------------------------------------------------------------------------------------------
-----------------------------------------------------------------------------K-------------------------------------------------------------------SSSSS
--------------------------------QQQQ-----TT---SU------S----------%%%-------SSSSS--#-----------------------------------r----------S--------------------
---------------------B---------------K-B-TT-------TT--------------|---T-----------#-------------------------------%%%%%%------------------------------
---------------------b-------B---------b-TT-------TT--------------|---T-----------##----------------------*--------|||||--------------------SSS-------
-M------------k-ggg--B-------b---------b-TT------kTT------k-------|---T-----------##--gg-----------ggg----*--------|||||----gg-g-gk----------------r--
XXXXXXXXXXXXXXXXXXXXXXXXXXXXXXXXXXXXXXXXXXXXXXXXXXXXXXXXXXXX%%%%%-|---XXXXXXXXXX--XXXXXXXX-XXXXXXXXXXXXXXXXXX--%%%-|||||XXXXXXXXXXXX---XXXXX-----XXXXX
XXXXXXXXXXXXXXXXXXXXXXXXXXXXXXXXXXXXXXXXXXXXXXXXXXXXXXXXXXXX-|||--|---XXXXXXXXXX--XXXXXXXX-XXXXXXXXXXXXXXXXXX---|--|||||XXXXXXXXXXXX---XXXXX-----XXXXX
