------------------------------------------------------------------------------------------------------------------------------------------------------
------------------------------------------------------------------------------------------------------------------------------------------------------
------------------------------------------------------------------------------------------------------------------------------------------------------
--------------------------------------------------SSSSSSS----------SSS----------ooo-------------------------------------------------------------------
--------------------------------------------------------------------------------%%%-------------------------------------------------------------------
----------------------------------------%%---------------------------------------|------------------oo------------------------------------------------
---------------------LSSS---------------|---------QQ------------CSS--------------|---------SSS!-----%%%-------------------------------------SS--------
--------------------------------o----ooo|----oo----------------------------------|------------------||--o----R----------------------------------------
----------------------------------------|------------------SSS--2--------------g-|------------------||-%%%-------------y------SSS----g#---------------
----------------------------------------|----------------------2-2---------------|---%%%%-----------||--|--------------X------------g##---------------
-------------------%-2-----#----------%%|---------QQ--QQQ---------2----------S@S-|----||------C-----||--|-------------XX%-----------###-----SS--------
---------------------------#-----------||---------------------------------------%%%%%%||------------||-o|------------XXX-----------####-----------#-TT
---------------------------##----------||----------------------------------------||||-||------------||%%%%%---------XXXX----------#####----------##-TT
-M-----------%%%%-----kk---##--%%%%%%%-||----------------------------------------||||-||-------g-g--||-|||---------XXXXX---------r#####---------###-TT
XXXXXXXXXXX---||----XXXXXXXXXX--|||||--||----%%%%-XXXXXXX------XXXXXXX-XXXXXXXXX-||||-||%%XXXXXXXXXX||-|||----XXXXXXXXXX----XXXXXXXXXXX--XXXXXXXXXX-XX
XXXXXXXXXXX---||----XXXXXXXXXX--|||||--||-----||--XXXXXXX------XXXXXXX-XXXXXXXXX-||||-||-|XXXXXXXXXX||-|||----XXXXXXXXXX----XXXXXXXXXXX--XXXXXXXXXX-XX
