------------------------------------------------------------------------------------------------------------------------------------------------------
------------------------------------------------------------------------------------------------------------------------------------------------------
------------------------------------------------------------------------------------------------------------------------------------------------------
------------------------------------------------------------------------------------------------------------------------------------------------------
-------------------------------------------------------------------------o----------------------------------------------------------------------------
--------------------------------------------------------------g---------%%%---------------------------------------------------------------------------
--------------------------------------------------------------SSSSS------|--o------USS----SSS------%---------------oo--------------------##-----------
-------------------------------------------------------------------------|--SSSS---------------------------------------------------------##-----------
----------------------------------------------------------------------%--|---------------------------------------------------SSS-------####-----------
-----------------------------------oo------------------------------------|-------------------------------------------------------------####-----------
--------------------SS------------o--o-------------------tt--------------|--------#---------%%%-------%%%%%%---%%%%--%%%r------------######---#LSS----
---------------------K---TT-------------T-----TT---------tt--------------|--------#----------|---------||||-----||----||%%%%%%-------######---#-------
-------------------------TT-------------T-----TT---------tt---TT-----t---|-----%--##---------|---------||||-----||----|||||||--------######---#-------
-M--------k---ggg--------TT-------------T-----TT-----g-g-tt---TT-----t---|--------##--gg-----|---------||||---o-||----|||||||--------######-kk#-------
XXXXXXXXXXXXXXXXXXXXXXXXXXXXXXXXXXXXXXXXXXXX--XXXXXXXXXXXXXXXXXXXXXXXX%%%%%%------XXXXXXXX---|------%%-||||-%%%-||----|||||||-----XXXXXXXXXXXXXXXXX---
XXXXXXXXXXXXXXXXXXXXXXXXXXXXXXXXXXXXXXXXXXXX--XXXXXXXXXXXXXXXXXXXXXXXX|||||-------XXXXXXXX---|------|--||||--|--||----|||||||-----XXXXXXXXXXXXXXXXX---
