------------------------------------------------------------------------------------------------------------------------------------------------------
------------------------------------------------------------------------------------------------------------------------------------------------------
------------------------------------------------------------------------------------------------------------------------------------------------------
----------------------------------------SSSSSSSSSSSSSSSSS-----------------------SSSSSSSSSS------------------------------SSS-----SS--------------------
-----------------------------------------------------------------------------------------------------------------------------------------------------o
--------------------------------------------------------------------------------------------oo--------------------------------------------------------
-----------------------------------------oooo-----QQ--------------SSoo-----1--------------------------------------------US-------------US-------------
-----------------------------------------------------------------------------------------------------------------SSS----------------------------SSS---
-----------------------------------------SSSS-U------------S---------------------------------------%------------------------SSS-------------oo--------
-----------------------------------oo---oS--SoS----------------------------ggg---------S---------------------------------------------SS---------------
----------Q---------SS------------o--o--SS--SSS---QQ--QQQ---%%%%%%----#########-SU--------SS----------------------------SSS----------------SSS--------
---------------------K---TT----------------------------------||||-------------#-----TT---t------------------------------------------------------------
-------------------------TT----------------------------------||||-------------#-----TT---t---%%%%---------*-----------------------TT------------------
-M-----------------#-----TT---------------kk-----------------||||-------------#----kTT--kt----||----gg----*-----------------------TT------------------
XXXXXXXXXXXXX--XXXXXXXXXXXXXXXXXXXXXXXXXXXXXXXXXXXXXXXXXX----||||-------------X-XXXXXXXXXX----||----XXXXXXXXX-%%%%----%%XXX------XXXXXXX-X-X----------
XXXXXXXXXXXXX--XXXXXXXXXXXXXXXXXXXXXXXXXXXXXXXXXXXXXXXXXX----||||-------------X-XXXXXXXXXX----||----XXXXXXXXX-|||------|XXX------XXXXXXX-X-X----------
