------------------------------------------------------------------------------------------------------------------------------------------------------
------------------------------------------------------------------------------------------------------------------------------------------------------
------------------------------------------------------------------------------------------------------------------------------------------------------
----------SSSSSSSSSS--------------------------------------------------------------------------------SSSSSSSSSS----------SSS-----SS--------------------
------------------------------------------------------------------------------------------------------------------------------------------------------
------------------------------------------------------------------------------------------------------------------------------------------------------
-----------------------------U---------------------------Q-Q-------------------------1-----------------------------oo---US--------!S------------------
------------------------------------------------------------------------------------------------------------------------------------------------------
---------------------------------------------------------------------oo-----------------------------------------------------SSS-----------------------
-----------------------------------------------------------------y------------------------------------------------------------------------------------
----------@QQQQ-------------##-TT------------------------Q-Q-----##----------------QQQQ----------tt--------TT--%%%%--%%%SSS-------S------#------------
-----------------------y-#####-TT------------K---B--------------###-----------#-----------T------tt-----#--TT---||----||----------------##------------
-----------------g-#y-######---TT----------------b-------------####----------##-----------T------tt----##--TT---||----||---------------###---------F--
---M------------g#-#######----gTT----------------B------------#####-----------------yy----T------tt-kk-##--TT-o-||----||--------------####---------#--
XXXXXXXXXXXXXXXXXXXXXXXX------XXXXXXXX--XXXXXXXXXXXXXXXXXXXXXXXXXXX---XXXXXXXXXXXXXXXXXXXXXXXXXXXXXXXXXXX--XX-%-||----||XXX------XXXXXXXXXXXXXXXXXXXXX
XXXXXXXXXXXXXXXXXXXXXXXX------XXXXXXXX--XXXXXXXXXXXXXXXXXXXXXXXXXXX---XXXXXXXXXXXXXXXXXXXXXXXXXXXXXXXXXXX--XX---||----||XXX------XXXXXXXXXXXXXXXXXXXXX
