------------------------------------------------------------------------------------------------------------------------------------------------------
------------------------------------------------------------------------------------------------------------------------------------------------------
------------------------------------------------------------------------------------------------------------------------------------------------------
S-----SSSS--------------------SSSSSSSSSS-----------oo-----------------SSSSSSSSSS----------SSSSSSSSSS--------------------------------------------------
S-----------------------------SSSSSSSSSS----------%%%%-----------------------------------------------------------------------------------------------o
S---------------------ooor----SSSSSSSSSS-----------||-----------------------------------oo----------oo------------------------------------------------
S--------------------%%%%%----SSSSSSSSSS-----------||---------------------------oo------------------%%%-----------------------------------------------
S---------------------|||--------------------------||--SSS--------------------TT--------------------||--o----R----------------------------------SSS---
S----------------g----|||--------------------------||-------------------------TT--------------------||-%%%----------------------------------oo--------
S----------------#----|||--------------------------||-------------------------TT-SSS----------------||--|---------------------------------------------
S---------S-----##--%%%%%%%---SSSSSSSSSS------tt---||----------------T------SCTT---------S----------||--|-----------------------------------SS--------
S--------------###--||||||----SSSSSSSSSS------tt---||----------------T--TT----TT----------t---------||-o|---------------------------------------------
S-------------####--||||||--o-SSSSSSSSSS------tt--%||----------------T--TT----TT----------t---------||%%%%%--------B----------------------------------
S--M---------#####--||||||-%%%SSSSSSSSSS-g----tt---||---------ggg----T--TT---kTT----------t---------||-|||---------b------kkk-----k-------------------
XXXXXXXXXXXXXXXXXXXX||||||--|-XXXXXXXXXXXXXXXXXXXX-||-------XXXXXXXXXXXXXXXXXXXX----------XXXXXXXXXX||-|||----XXXXXXXXXXXXXXXXXXXXXX---XXXXX----------
XXXXXXXXXXXXXXXXXXXX||||||--|-XXXXXXXXXXXXXXXXXXXX-||-------XXXXXXXXXXXXXXXXXXXX----------XXXXXXXXXX||-|||----XXXXXXXXXXXXXXXXXXXXXX---XXXXX----------
