------------------------------------------------------------------------------------------------------------------------------------------------------
------------------------------------------------------------------------------------------------------------------------------------------------------
------------------------------------------------------------------------------------------------------------------------------------------------------
------------------------------------------------------------SSSSSSSSSS----------------------------------------SSSSSSSSSS------------------------------
------------------------------------------------------------SSSS--SSSS--------------------------------------------------------------------------------
------------------------------------------------------------SSSS--SSSS--------------------------------------------------------------------------k-----
-----------------------------U--------------------------------SS---S--------SSSS-----SUS--------------------------------SSS-------!S-----------SQS--SQ
--------------------------------------------------------------SS---S----------------------------------------------------------------------------------
-----------------g--------------------------------------------SS---S----------------------------------------------------------------------------------
-----------------#---------------------------------------o--ooSS---SoU-------K------------------------------------------------------------------------
----------S-----##----------##------------------------------SSSS---SSS-----SSSSS----#####-------------%%%%%%--T-------------------S------#-----SQS--S?
---------------###-----y-#####---------------K---B--------------------T-------------#------------------||||---T-------------------------##------------
--------------####--y-######---------------------b--------------------T------------K#------------------||||---T----TT---------TT-------###------------
-M-----------#####--######--------k-k------------B--k-------k--g-g----T-------------#--------------g---||||---T--g-TT---------TT------####---k------gg
XXXXXXXXXXXXXXXXXXXXXXXX------XXXXXXXXX-XXXXXXXXXX-XXXXXXXXXXXXXXXXXXXXXXXXXXXXXXXXXXXX----XXXXXXXXX%%-||||-%%XXXXXXXXXX----XXXXXXXXXXXXXXXXXXXXXXXXXX
XXXXXXXXXXXXXXXXXXXXXXXX------XXXXXXXXX-XXXXXXXXXX-XXXXXXXXXXXXXXXXXXXXXXXXXXXXXXXXXXXX----XXXXXXXXX|--||||--|XXXXXXXXXX----XXXXXXXXXXXXXXXXXXXXXXXXXX
