------------------------------------------------------------------------------------------------------------------------------------------------------
------------------------------------------------------------------------------------------------------------------------------------------------------
------------------------------------------------------------------------------------------------------------------------------------------------------
S-----SSSS--------------------------------------------------------------------------------------------------------------SSSSSSSSSS--------------------
S-----------------------------------------------------------------------------------------------------------------------------------------------------
S-------------------------------------oo----------------------------------------------------oo--------------------------------------------------------
S--------------------LSSS----------SSSS------------------Q-Q----------------------------------------------------------------------%-------------------
S-----------------------------------------------------------------------------------------------------------------------------------------------------
S----------------g-------------------------------------------------------------g-------------------%------------------------------------SSS-----------
S----------------#----------------------------------------------------------------o-------------------------------------------------------------------
S---------S-----##---2-----#--%--------------------------Q-Q-----------------S@S-------TT-S---------------------!-----S-----------%%%%%-------#LSS----
S--------------###---------#-----------------------------------------T-----------------TT-------------TT------------------SS-------|||--------#-------
S-------------####---------##--------------------------------B-------T-----------------TT----%%%%-----TT----TT------------SS-------|||--------#-------
S------------#####----kk---##------------------y-------------b-------T-----------------TT-----||------TT-k--TT------------SS-------|||------kk#-------
XXXXXXXXXXXXXXXXXXXXXXXXXXXXXX--%%%%--%%XXXXXXXXXXXXXXXXXXXXXXXXXX--XX-XXXXXXXXXXXXXXXXXXX----||----XXXXXXXXXXXXXXXXXXXX--XX--XXXX%|||------XXXXXXX---
XXXXXXXXXXXXXXXXXXXXXXXXXXXXXX---||----|XXXXXXXXXXXXXXXXXXXXXXXXXX--XX-XXXXXXXXXXXXXXXXXXX----||----XXXXXXXXXXXXXXXXXXXX--XX--XXXX-|||------XXXXXXX---
