------------------------------------------------------------------------------------------------------------------------------------------------------
------------------------------------------------------------------------------------------------------------------------------------------------------
------------------------------------------------------------------------------------------------------------------------------------------------------
S-----SSSS--------------------------------------------------------------------------------------------------------------SSSSSSSSSS--------------------
S-----------------------------------------------------------------------------------------------------------------------------------------------------
S---------------------------------------------------------------------------------------oo------------------------------------------------------------
S-------------------------------------------------------------------------------oo--------------------------------------------------------------------
S-----------------------------------------------------------------------------------------------------------------------------------------------------
S--------------------------------------------------------B-----------o--------------------------------------------------------------------------------
S--------------------------------------------------------b-------y-------1-------SSS------------g-----------------------------------------------------
S------------------%-------------------T---------------SS#CS-----##---T------------------S------TT-----------------------------------------#----------
S--------------------------------------T------------------------###---T----TT-------------------TT----TT------------------SS--------------##-------#--
S--------------------------------------T-------------------K---####---T----TT-------------------TT----TT----TT------------SS-------------###---K---#--
S--M---------%%%%---------------gg-----T----------------------#####---T---kTT-------------------TT----TT-k--TT-k----kkk---SS---------y--####-------#--
XXXXXXXXXXX---||----XXXXX--XXXXXXXXXXXXXX-XX-XX-XXXXXXXXXXXXXXXXXXX---XXXXXXXXXX----------XXXXXXXXX-XXXXXXXXXXXXXXXXXXXX--XX--XXXXXXXXXXXXXXXXXXX--XXX
XXXXXXXXXXX---||----XXXXX--XXXXXXXXXXXXXX-XX-XX-XXXXXXXXXXXXXXXXXXX---XXXXXXXXXX----------XXXXXXXXX-XXXXXXXXXXXXXXXXXXXX--XX--XXXXXXXXXXXXXXXXXXX--XXX
