------------------------------------------------------------------------------------------------------------------------------------------------------
------------------------------------------------------------------------------------------------------------------------------------------------------
------------------------------------------------------------------------------------------------------------------------------------------------------
--------------------------------oo------SSSSSSSSSS----------------------------------------SSSSSSSSSS--------------------------------------------U-----
---------------------------------------gSSSSSSSS------------------------------------------------------------------------------------------------------
-----------------------------------%%%%%SSSCSSSS---------------------R------------g-------------------oo----------------------------------------------
----------------------!-------------||||SSSSSSSS--------------------------------SSSSSSSS---------------------------------SSS----S!--------------------
------------------------------------||||-------------------------------------------------------------------------SSS------------------------------SS--
------------------------------------||||--------------------------------------------------------------------------------------------------------------
------------Q--?--------------%%%%%-||||---ggg-----------o------------------------------------------------------------------------------------SS------
-------------------SS@S!S------|||--||||SSSSSSSS-----------------%%%-------------------------------------------------------------S-------------------#
-------------------------------|||--||||SSSSSSSS------------------|------------------------------------------------------------------TT-------------##
----------------------------tt-|||--||||SSSSSSSS------------------|-----------------------------------------tt-----------------------TT------------###
-M----------------K--g------tt-|||--||||SSSSSSSS----k-------------|---gg------------------------g-g---ggg---tt--------------gg-g-g---TT-----------####
XXXXXXXXXXXXXXXXXXXXXXXXXXXXXX-|||--||||XXXXXXXXXX-XXXXXXXXX%%%%%-|---XXXXXXXXXXXXXXXX---XXXXXXXXXXXXXXXXXXXXX%%%%----%%XXXXXXXXXXXXXXXXXXXXXXXXX-XXXX
XXXXXXXXXXXXXXXXXXXXXXXXXXXXXX-|||--||||XXXXXXXXXX-XXXXXXXXX-|||--|---XXXXXXXXXXXXXXXX---XXXXXXXXXXXXXXXXXXXXX|||------|XXXXXXXXXXXXXXXXXXXXXXXXX-XXXX
