------------------------------------------------------------------------------------------------------------------------------------------------------
------------------------------------------------------------------------------------------------------------------------------------------------------
------------------------------------------------------------------------------------------------------------------------------------------------------
------------------------------SSSSSSSSSS----------------------------------------ooo-------------------------------------------------------------------
--------------------------------------------------------------------------------%%%-------------------------------------------------------------------
----------------------------------------%%---------------------------R-----------|--------------------------------------------------------------------
----------------------------------------|---------------------------------SSCSS--|--------------------------------------------------------------------
----------------------------------------|----oo----------------------------------|----------------oo------TT------------------------------------------
---------------------------------------S|----------------TT----------------------|------------------------TT------------------SSS---------------------
---------------------------------------S|----------TT----TT----------------------|---%%%%-----------------TT------------------------------------------
----------------!----------------------S|----------TT----XX------%%%----QQQQ--QQ-|----||-----------------SXXS-----------%-----------------------------
-------------------------------#--------|----------TT-------------|-------------%%%%%%||--------#-----------------------------------------------------
-------------------------------#-#------|----------TT-------------|--------------||||-||--------#---TT---------------------------------------------F--
-M-----------------------ggg---#-#------|----------TT-------------|--------------||||-||--------#---TT---------k----kkk----------rk----------------#--
XXXXXXXXXXXXXXXXXXXXXXXXXXXXXXXXXXXXXXXX|----%%%%-XXXXXXXXXX%%%%%-|---XXXXXXXXXX-||||-||%%XXXXXXXXXXXXXXXXXXXXXXXXXXXXXX----XXXXXXXX---XXXXXXXXXXXXXXX
XXXXXXXXXXXXXXXXXXXXXXXXXXXXXXXXXXXXXXXX|-----||--XXXXXXXXXX-|||--|---XXXXXXXXXX-||||-||-|XXXXXXXXXXXXXXXXXXXXXXXXXXXXXX----XXXXXXXX---XXXXXXXXXXXXXXX
