------------------------------------------------------------------------------------------------------------------------------------------------------
------------------------------------------------------------------------------------------------------------------------------------------------------
------------------------------------------------------------------------------------------------------------------------------------------------------
--------------------------------------------------------------------------------SSSSSSSSSL------------------------------------------------------------
------------------------------------------------------------------------------------------------------------------------------------------------------
------------------------------------------------------------------------------------------------------------------------------------------------------
----------------------!-----------------------------------------------------SSSS----oooooo------------------------------SSS---------------------------
--------------------------------o----ooo------------------------------------------------------------oo------------------------------------------------
------------------------------------------------------------------------------------SSSSSS------------------------------------------------------------
-----------------------------------------------------------------------------K------SSSSSS-----oooo---------------------------------------------------
----------------%%%%S@S!S-------------%%------tt-------ooo-----------------SSSSS-----------------------------T--------r-----------------------#LSS----
-----------------||--------------------|------tt----------------------T--------------------------------------T----%%%%%%----------------------#-------
-----------------||---------tt---------|------tt----------------------T--------------------------------------T-----|||||------TT--------------#-------
-----------------||--g------tt-%%%%%%%-|-g----tt------------gg-------gT-----------------------------------y--T-----|||||------TT--k---------kk#-------
XXXXXXXXXXX--%%%%||%XXXXXXXXXX--|||||--|XXXXXXXXXX--XXXXXXXXXXXXXXXXXXXXXXXXXXXX---XXXXXXX%%%%%%%-%%XXXXXXXXXX-%%%-|||||----XXXXXXXX---XXXXXXXXXXXX---
XXXXXXXXXXX---||-||-XXXXXXXXXX--|||||--|XXXXXXXXXX--XXXXXXXXXXXXXXXXXXXXXXXXXXXX---XXXXXXX||||||---|XXXXXXXXXX--|--|||||----XXXXXXXX---XXXXXXXXXXXX---
