------------------------------------------------------------------------------------------------------------------------------------------------------
------------------------------------------------------------------------------------------------------------------------------------------------------
------------------------------------------------------------------------------------------------------------------------------------------------------
------------------------------SSSSSSSSSS-----------oo---------------------------SSSSSSSSSL------------------------------------------------------U-----
------------------------------SSSSSSSSSS----?-----%%%%------------------------------------------------------------------------------------------------
------------------------------SSSSSSSSSS-----------||---------g---------------------------------------------------------------------------------------
---------------------LSSS-----SSSSSSSSSS-----------||---------SSSSS---------SSSS----oooooo--------------------?SSS------SS----------------------------
----------------------------------------------r----||--SSS----------------------------------------------------------------------------------------SS--
------------------------------------------%%%%%%---||-------------------------------SSSSSS------------------------------------------------------------
-------------------------------------------||||----||------------------------K------SSSSSS--------oo-----------------------TT-----------------SS------
---------------------2-----#--SSSSSSSSSS%%-||||ooo-||----------------------SSSSS----------------------%%%%%%--SSSSS--------TT------------------------#
-----------------K---------#--SSSSSSSSSS|--||||--r-||-----------------T------------------------TT------||||-------------t--TT-----------------------##
------------B--------------##-SSSSSSSSSS|%%%%%%%%%%||---------TT-----tT------------------------TT------||||-------------t--TT----------------------###
-M----------b---------kk---##-SSSSSSSSSS|-||||||||-||---------TT-----tT---------------------y--TT------||||-----K-------t--TT---------------------####
XXXXXXXXXXXXXXXXXXXXXXXXXXXXXXXXXXXXXXXX|-||||||||-||-------XXXXXXXXXXXXXXXXXXXX---XXXXXXXXXXXXXXXXX%%-||||-%%XXXXXXXXXXXXXXXXXXXXXXXXXXXXXXXXXXX-XXXX
XXXXXXXXXXXXXXXXXXXXXXXXXXXXXXXXXXXXXXXX|-||||||||-||-------XXXXXXXXXXXXXXXXXXXX---XXXXXXXXXXXXXXXXX|--||||--|XXXXXXXXXXXXXXXXXXXXXXXXXXXXXXXXXXX-XXXX
