------------------------------------------------------------------------------------------------------------------------------------------------------
------------------------------------------------------------------------------------------------------------------------------------------------------
------------------------------------------------------------------------------------------------------------------------------------------------------
S-----SSSS--------------------SSSSSSSSSS----------------------------------------SSSSSSSSSL----------------------------------------SSSSSSSSSS----------
S-----------------------------SSSSSSSSSS--------------------------------------------------------------------------------------------------------------
S-----------------------------SSSSSSSSSSooooo-----------------g---------------------------------------------------------------------------------------
S-----------------------------SSSSSSSSSS----------------------SSSSS-----------------oooooo-------------------------oo-----------------------SS--------
S-----------------------------------------------SS--------------------------------------------------oo------------------------------------------------
S----------------------------------------SSSS---------------------------------------SSSSSS------------------------------------------------------------
S-----------------------------------------------------------------------------------SSSSSS------------------------------------------------------------
S---------------%%%%SS--------SSSSSSSSSS---------------------------------------------------------------------T-%%%%--%%%--------------------SS--------
S----------------||--K---TT---SSSSSSSSSS------------K--------------------------------------------------------T--||----||------------------TT------#-TT
S----------------||------TT---SSSSSSSSSS----%%%%%-------------TT-----t---------------------------------------T--||----||-----------tt-----TT-----##-TT
S--M-------------||------TT---SSSSSSSSSS-----|||-----------g--TT-----t-----------------------------g------y--To-||----||-k----ggg--tt----kTT----###-TT
XXXXXXXXXXX--%%%%||%XXXXXXXXXXXXXXXXXXXX%%---|||--XXXXXXXXXXXXXXXXXXXXX----XXXXX---XXXXXXX-XXXXXXXXXXXXXXXXXXX%-||----||XXXXXXXXXXXXXXXXXXXXXXXXXXX-XX
XXXXXXXXXXX---||-||-XXXXXXXXXXXXXXXXXXXX|----|||--XXXXXXXXXXXXXXXXXXXXX----XXXXX---XXXXXXX-XXXXXXXXXXXXXXXXXXX--||----||XXXXXXXXXXXXXXXXXXXXXXXXXXX-XX
