------------------------------------------------------------------------------------------------------------------------------------------------------
------------------------------------------------------------------------------------------------------------------------------------------------------
------------------------------------------------------------------------------------------------------------------------------------------------------
S-----SSSS----------------------oo------------------------------------SSSSSSSSSS--------------------SSSSSSSSSS----------------------------------------
S--------------------------------------g-g----------------------------------SSSS---------------------------------------------------------------------o
S----------------------------------%%%%%%%-------------------------------g--SSSS----------------------------------------------------------------------
S--------------------LSSS-----------|||||-------------------------SSoo--SS--------------------------------------------US-SSS----S!-------##-----------
S-----------------------------------|||||----oo-------------------------SS---------------------------------------------------------------##-----SSS---
S-----------------------------------|||||----------------B--------------SS-------------------------------------------------------------####-oo--------
S-----------------------------%%%%%-|||||----------------b--------------SC--g-g---o-------------g-------------------E------------------####-----------
S---------------!----2-----#---|||--|||||--------------SS#CS%%%%%%------SS--SSSS-------TT-------TT---------TT------TT------------S---######-SS--------
S--------------------------#---|||--|||||--------------------||||----------------------TT-------TT------#--TT------TT--t-------------######-----------
S--------------------------##--|||--|||||------------------K-||||----------------------TT-------TT-----##--TT------TT--t-------------######-----------
S--M------------------kk---##--|||--|||||--------------------||||----------------------TT-------TT--kk-##--TT---g--TT--t----gg-g-g---######-----------
XXXXXXXXXXXXXXXXXXXXXXXXXXXXXX-|||--|||||----%%%%-XXXXXXXXXX-||||-----XXXXXXXXXXXXXXXXXXXXXXXXXXXXX-XXXXX--XX-XXXXXXXXXXXXXXXXXXXXXXXXXXXXXX----------
XXXXXXXXXXXXXXXXXXXXXXXXXXXXXX-|||--|||||-----||--XXXXXXXXXX-||||-----XXXXXXXXXXXXXXXXXXXXXXXXXXXXX-XXXXX--XX-XXXXXXXXXXXXXXXXXXXXXXXXXXXXXX----------
