------------------------------------------------------------------------------------------------------------------------------------------------------
------------------------------------------------------------------------------------------------------------------------------------------------------
------------------------------------------------------------------------------------------------------------------------------------------------------
------------------------------------------------------------------------------------------------------------------------------------------------------
------------------------------------------------------------------------------------------------------------------------------------------------------
--------------------------------------------------------------------------------------------oo--------------------------------------------------------
---------------------------------------------------------Q-Q------------------------y--------------------------------------------------US-------------
----------------------------------------------------------------------------------#SSS--------------oo------------------------------------------------
-----------------%%%--------------------------------------------------o----------##----------------%--------------------------------------------------
------------------||---------------oo-------------------------------------------###1-------------------------------------------SSS---SS---------------
------------------||--------------o--o-------------------Q-Q---------#----------###-------SS-----------------T----------%------------------S----------
-------------%%%%%||------------------------------------------------##--------#-###--SSS---------------------T-#--------------------------------------
--------------|||-||----------------------------------------TT-----###-------##-###----------%%%%------------T-#------------------TT---------------F--
-M------------|||-||-----ggg----------------y-y-------------TT----####----------###-----------||----------y--T-#----ggg----------rTT---------------#--
XXXXXXXXXXX---|||-||XXXXXXXXXXXXXXXXXXXXXXXXXXXXXXXXXXXXXXXXXXXXXXXXXXXXXXXXXXXXXXXXXX---X----||----XXXXXXXXXX-XXXXXXXXX----XXXXXXXXXXXX-X-XXXXXXXXXXX
XXXXXXXXXXX---|||-||XXXXXXXXXXXXXXXXXXXXXXXXXXXXXXXXXXXXXXXXXXXXXXXXXXXXXXXXXXXXXXXXXX---X----||----XXXXXXXXXX-XXXXXXXXX----XXXXXXXXXXXX-X-XXXXXXXXXXX
