------------------------------------------------------------------------------------------------------------------------------------------------------
------------------------------------------------------------------------------------------------------------------------------------------------------
------------------------------------------------------------------------------------------------------------------------------------------------------
------------------------------------------------------------SSSSSSSSSSSSSSSSSSSSSSSSSSSSSS--------------------SSSSSSSSSS------------------------------
------------------------------------------------------------SSSS--SSSS--------------------------------------------------------------------------------
------------------------------------------------------------SSSS--SSSS--------------------------------------------------------------------------------
--------------------USS---------------------------------------SS---S-------------------------------------------------------------------US----------SSS
--------------------------------------------------------------SS---S----------TT----------------------------------------------------------------------
---------------------------------------------------------TT---SS---S----------TT----------------------------------------------------------------------
---------------------------------------------------TT----TT-ooSS---SoU--------TT-------S--------------------------------SS-?Q--------SS---------------
--------SU------------------------------------tt---TT----XX-SSSS---SSS------SCTTSU--------------TT----%%%%%%--T----------------------------S------#---
---------------------B-----------------T------tt---TT-------------------TT----TT----TT---t------TT-----||||---T-----------------------------------#---
---------------------b-------B---------T------tt---TT-------------------TT----TT----TT---t------TT-----||||---T----TT----------y--TT--------------#---
--M-------k---ggg----B-------b-------kkT-g----tt---TT-------k--g-g------TT---kTT---kTT--kt--k---TT-----||||---T--g-TT------SSSSS--TT---------ggg--#---
XXXXXXXXXXXXXXXXXXXXXXXXXXXXXXXXXXXXXXXXXXXXXXXXXXXXXXXXXXXXXXXXXXXXXXXXXXXXXXXXXXXXXXXXXXXXXXXXXXXX%%-||||-%%XXXXXXXXXX-------XX-XXXXXX-X-XXXXXXXXXXX
XXXXXXXXXXXXXXXXXXXXXXXXXXXXXXXXXXXXXXXXXXXXXXXXXXXXXXXXXXXXXXXXXXXXXXXXXXXXXXXXXXXXXXXXXXXXXXXXXXXX|--||||--|XXXXXXXXXX-------XX-XXXXXX-X-XXXXXXXXXXX
