------------------------------------------------------------------------------------------------------------------------------------------------------
------------------------------------------------------------------------------------------------------------------------------------------------------
------------------------------------------------------------------------------------------------------------------------------------------------------
--------------------SSSSSSSSSS----------------------------------------SSSSSSSSSS----------------------------------------SSSSSSSSSS--------------------
------------------------------------------------------------------------------------------------------------------------------------------------------
------------------------------------------------------------------------------------------------------------------------------------------------------
--------------------------------------------------Q-----------USSS------------------------SSS------%-----------------------------------US-------------
------------------------------------------------------------------------------TT---------------------------------SSS----------------------------------
------------------------------------------------------------------------------TT----------------------------------------------------------------------
-----------------------------C-----oo-----------------------------------------TT--o--------------------------------------------------SS---------------
-----SSS---------------#-#--------o--o------------Q----------S-----TT-------SCTT-------TT---%%%-------%%%%%%-------------------------------S----------
---------------------#-#-#-#------------T-----TT-------------------TT---TT----TT-------TT----|---------||||---------------SS--------------------------
---------------------#-#-#-#------------T-----TT-------------------TT---TT----TT-------TT----|---------||||---------------SS------TT---------------F--
--------------k-ggg--#-#-#-#-E----------T-----TT-----gg----k-ggg---TT---TT---kTT-------TT----|---------||||---------------SS------TT---------------#--
XXXXXXXXXXXXXXXXXXXXXXXXXXXXXXXXXXXXXXXXXXXX--XXXXXXXXXXXXXXXXXXXXXXXXXXXXXXXXXXXXXXXXXXXX---|------%%-||||-%%%%%%----%%--XX--XXXXXXXXXX-X-XXXXXXXXXXX
XXXXXXXXXXXXXXXXXXXXXXXXXXXXXXXXXXXXXXXXXXXX--XXXXXXXXXXXXXXXXXXXXXXXXXXXXXXXXXXXXXXXXXXXX---|------|--||||--||||------|--XX--XXXXXXXXXX-X-XXXXXXXXXXX
