------------------------------------------------------------------------------------------------------------------------------------------------------
------------------------------------------------------------------------------------------------------------------------------------------------------
------------------------------------------------------------------------------------------------------------------------------------------------------
--------------------SSSSSSSSSS-------------------------------------SSS----------ooo-------------------------------------------------------------------
-------------------------------------------------------------------------o------%%%-------------------------------------------------------------------
------------------------------------------------------------------------%%%------|--------------------------------------------------------------------
--------------------------------------------------Q-------------CSS------|--o----|---------------------------------------------SSS--------------------
-------------------------------------------------------------------------|--SSSS-|----------------oo------TT------------------------------------------
------------------------------------------------------------SS--2-----%--|-------|------------------------TT------------------------------------------
-----------------------------C---------------------------------2-2-------|-------|---%%%%-----------------TT--------------------K---------------------
-------------------%---#-#------------------------Q---------------2------|-------|----||-----------------SXXS---!-----S--------SSS--------------------
---------------------#-#-#-#-----------T---------------------------------|------%%%%%%||--------#-----------------------------------------------------
---------------------#-#-#-#-----------T---------------------------------|-----%-||||-||--------#---TT-------------------TT------------------------F--
-------------%%%%----#-#-#-#-E-------kkT----y-y------gg----k-------------|-------||||-||--------#---TT-------------------TT-------k----------------#--
XXXXXXXXXXX---||----XXXXXXXXXXXXXXXXXXXXXXXXXXXXXXXXXXXXXXXX---XXXXXXX%%%%%%-----||||-||%%XXXXXXXXXXXXXXXXXXXXXXXXXXXXXXXXXXXXXXXXXX---XXXXXXXXXXXXXXX
XXXXXXXXXXX---||----XXXXXXXXXXXXXXXXXXXXXXXXXXXXXXXXXXXXXXXX---XXXXXXX|||||------||||-||-|XXXXXXXXXXXXXXXXXXXXXXXXXXXXXXXXXXXXXXXXXX---XXXXXXXXXXXXXXX
