------------------------------------------------------------------------------------------------------------------------------------------------------
------------------------------------------------------------------------------------------------------------------------------------------------------
------------------------------------------------------------------------------------------------------------------------------------------------------
------------------------------------------------------------------------------------------------------------------------SSSSSSSSSS----------SSSSSSSSSS
------------------------------------------------------------------------------------------------------------------------------------------------------
-----------------------SSS----------------------------------------------------------------------------------------------------------------------------
---------------------------------------------------------Q-Q------------------------y-------------------------?SSS----------------!S------------------
---------------------g------------------------------------------------------------#SSS--------------oo------------------------------------------------
--------------------%%%----------------------------------------------------------##-------------------------------------------------------------------
--------------------||----SSS---------------------------------------------------###1------------------------------------------------------------------
---------Q----------||-----------------------------------Q-Q---------#----------###-------------TT-----------TSSSSS---------------S------#----TT------
-----------------K--||----------------tt----------------------------##----------###--SSS--------TT-----------T------------SS------------##----TT------
------------B-------||----------------tt--------------------TT-----###----------###-------------TT-----------T------------SS-----------###----TT------
-M----------b-------||----oo----------tt-------ggg----------TT----####gg--------###---------k---TT--------y--T--K---------SS----------####----TT------
XXXXXXXXXXXXXXXXXXXX||---%%%--XXXXXXXXXX-XXXXXXXXXXXXXXXXXXXXXXXXXXXXXXXXXXXXXXXXXXXXX---XXXXXXXXXXXXXXXXXXXXXXXXXXXXXXX--XX--XXXXXXXXXXXXXXXXXX--XXXX
XXXXXXXXXXXXXXXXXXXX||----|---XXXXXXXXXX-XXXXXXXXXXXXXXXXXXXXXXXXXXXXXXXXXXXXXXXXXXXXX---XXXXXXXXXXXXXXXXXXXXXXXXXXXXXXX--XX--XXXXXXXXXXXXXXXXXX--XXXX
