------------------------------------------------------------------------------------------------------------------------------------------------------
------------------------------------------------------------------------------------------------------------------------------------------------------
------------------------------------------------------------------------------------------------------------------------------------------------------
------------------------------SSSSSSSSSS--------------------SSSSSSSSSS----------------------------------------SS-------S----------SSSSSSSSSS----------
------------------------------SSSSSSSSSS--------------------SSSS--SSSS--------------------------------------------------------------------------------
------------------------------SSSSSSSSSS---------------oooo-SSSS--SSSS--------------------------------------------------------------------------------
------------------------------SSSSSSSSSS---------------%%%%---SS---S----SSSSS------USS---------------------------------S------------------------------
--------------------------------------------------------||----SS---S----------------------------------------------------------------------------------
-----------------%%%------------------------------------||----SS---S-----------------------------------------------SSS--------------------------------
------------------||------------------------------SSS---||--ooSS---SoU---------------------------------------------------------SSS--------------------
------------------||----------SSSSSSSSSS-TT---SU--------||--SSSS---SSS-------2----#------------------------------------S%---------------------#LSS----
-------------%%%%%||----------SSSSSSSSSS-TT-----------U-||-----------------TT-----#-------------------TT-------##-------------------------TT--#-------
--------------|||-||----------SSSSSSSSSS-TT-------------||------------t----TT--T--##-------------B----TT----TT-##------------------tt-----TT--#-------
-M------------|||-||----------SSSSSSSSSS-TT------k------||--k--g-g----t----TT--T--##--gg---------b----TT-k--TT-##----------------r-tt----kTTkk#-------
XXXXXXXXXXX---|||-||XXXXX--XXXXXXXXXXXXXXXXXXXXXXX----%%%%%-XXXXXXXXXXXXXXXXXXXX--XXXXXXXXXXXXXXXXXXXXXXXXXXXX-XX------X----XXXXXXXXXXXXXXXXXXXXXXX---
XXXXXXXXXXX---|||-||XXXXX--XXXXXXXXXXXXXXXXXXXXXXX-----|||--XXXXXXXXXXXXXXXXXXXX--XXXXXXXXXXXXXXXXXXXXXXXXXXXX-XX------X----XXXXXXXXXXXXXXXXXXXXXXX---
