------------------------------------------------------------------------------------------------------------------------------------------------------
------------------------------------------------------------------------------------------------------------------------------------------------------
------------------------------------------------------------------------------------------------------------------------------------------------------
----------------------------------------SSSSSSSSSS-----------------SSS----------ooo---------------------------SS-------S----------SSSSSSSS------------
--------------------------------------------------------------------------------%%%-------------------------------------------------------------------
-----------------------SSS-------------------------------------------------------|--------------------------------------------------------------------
------------------SC---------------------oooo-------------------CSS-------SSCSS--|-------------------------------------S-SSS----S!--------------------
---------------------g-----------------------------------------------------------|--------------------------------------------------------------------
--------------------%%%------------------SSSS-U-------------SS--2----------------|---------------------------------SSS--------------------------------
--------------------||----SSS-----------oS--SoS----------------2-2---------------|---%%%%-------------------------------------------------------------
--------SU----TT---2||----------QQQQ----SS--SSS--------ooo--------2-----QQQQ--QQ-|----||--------------%%%%%%-----------S---------S-----g##----#LSS----
--------------TT----||---------------K-B----------------------------------------%%%%%%||---------------||||----##----------------------###----#-------
--------------TT----||-----------------b-----------------------------------------||||-||---------------||||----##--------------------g####----#-------
--M-----------TT----||----oo-----------b--kk-------------------------------------||||-||-----------g---||||----##-----------gg-g-g---#####--kk#-------
XXXXXXXXXXXXXXXXXXXX||---%%%--XXXXXXXXXXXXXXXXXXXX--XXXXXXXX---XXXXXXXXXXXXXXXXX-||||-||%%-XXXXXXXXX%%-||||-%%-XX------XXXXXXXXXXXXXXXXXXX--XXXXXXX---
XXXXXXXXXXXXXXXXXXXX||----|---XXXXXXXXXXXXXXXXXXXX--XXXXXXXX---XXXXXXXXXXXXXXXXX-||||-||-|-XXXXXXXXX|--||||--|-XX------XXXXXXXXXXXXXXXXXXX--XXXXXXX---
