------------------------------------------------------------------------------------------------------------------------------------------------------
------------------------------------------------------------------------------------------------------------------------------------------------------
------------------------------------------------------------------------------------------------------------------------------------------------------
----------SSSSSSSSSSSSSSSSSSSS------------------------------------------------------------------------------------------------------------------------
--------------------SSSSSSSSSS------------------------------------------------------------------------------------------------------------------------
--------------------SSSSSSSSSS------------------------------------------------------------------------------------------------------------------------
--------------------SSSSSSSSSS-------------------------------------------------------SUS------------------2--------oo-------------SS--------SS--------
------------------------------------------------------------------------------------------------------------------------------------------------------
------------------------------------------------------------------------------------------------------------------------------------------------------
----------------------------------------------------------------------------------------------------o--------------------------SSS--------------------
----------------------SSSSSS?-----------------tt------S--------------T--------------#####-------TT--------2----%%%%--%%%%---------SS--------SS--------
----------------------SSSSS-----------K-------tt--TT-----------------T--------------#-----------TT--------------||----||----------K---#----B------#-TT
----------------------SSSSS---TTTT------------tt--TT-----------------T-------------K#-----------TT--------------||----||--------------#----b-----##-TT
---------------------------oooTTTT-------g----tt--TT------k---ggg----Tgg------------#-------k---TT------y--y--o-||----||---------r----#----B----###-TT
XXXXXXXXXXX--XX--X---XXXXXXXXXXXXXXXXXXXXXXXXXXXXXXXXXXXXXXXXXXXXXXXXXXXXXXXXXXXXXXXXXX---XXXXXXXXXXXXXXXXXXXX%-||----||----XXXXXXXXXXXXXXXXXXXXXXX-XX
XXXXXXXXXXX--XX--X---XXXXXXXXXXXXXXXXXXXXXXXXXXXXXXXXXXXXXXXXXXXXXXXXXXXXXXXXXXXXXXXXXX---XXXXXXXXXXXXXXXXXXXX--||----||----XXXXXXXXXXXXXXXXXXXXXXX-XX
