------------------------------------------------------------------------------------------------------------------------------------------------------
------------------------------------------------------------------------------------------------------------------------------------------------------
------------------------------------------------------------------------------------------------------------------------------------------------------
----------SSSSSSSSSS----------------------------------------------------------------------------------------------------------------------------------
-----------------------------------------g------------------------------------------------------------------------------------------------------------
--------------------------------------oo%%------------------------------------------------------------oo----------------------------------------------
-----------------------------U-----SSSS-|-----------------------------------SSSS-----1---------------------------------------------SSSS---------------
----------------------------------------|----oo-----------------------------------------------------------------oooo----------------------------------
----------------------------------------|-------------------------------------------------------------------------------------------------------------
----------------------------------------|------------------------------------K------------------------------------------SS-?Q----------SSSS-----------
----------------------------##%---------|-------------S--------------#-----SSSSS---QQQQ-----------------------T-------------------------------#LSS----
-----------------------y-#####----------|---------TT----------------##T---------------------------------------T-------------------------------#-------
--------------------y-######------------|---------TT--------TT-----###T--------------------------B----------ttT----------------y--------------#-------
-M------------------######--------------|---------TT------k-TT----####T-------------yy-----------b----ggg---ttT---y--------SSSSS------------kk#-------
XXXXXXXXXXX--XX--X--XXXX--------%%%%--%%|----%%%%-XXXXXXXXXXXXXXXXXXXXXXXXXXXXXXXXXXXXXXXXXXXXXXXXXXXXXXXXXXXXXXXXXXXXXX-------XX----------XXXXXXXX---
XXXXXXXXXXX--XX--X--XXXX---------||----||-----||--XXXXXXXXXXXXXXXXXXXXXXXXXXXXXXXXXXXXXXXXXXXXXXXXXXXXXXXXXXXXXXXXXXXXXX-------XX----------XXXXXXXX---
