------------------------------------------------------------------------------------------------------------------------------------------------------
------------------------------------------------------------------------------------------------------------------------------------------------------
------------------------------------------------------------------------------------------------------------------------------------------------------
--------------------------------------------------SSSSSSS---------------------------------------------------------------SSS-----SS--------------------
------------------------------------------------------------------------------------------------------------------------------------------------------
----------------------------------------ooooo-------------------------------------g-------------------------------------------------------------------
-----------------------------U--------------------QQ----------------------------SSSSSSSS----------------SSQSSS?SSS------US----------------------------
------------------------------------------------SS---------------------------------------------------------------------------------------------y------
-----------------------------------------SSSS--------------S-------------------g--------------------------------------------SSS--------------#SS--o---
------------------------------------------------------------------------------------------------g---------K---------------------------------##--------
---------Q------!-----------##-TT-----------------QQ--QQQ--------------------S@S----------------TT------SSSSSSSSSSS-----SSS-----------------##--SC----
-----------------------y-#####-TT---------------------------------------------------------------TT------------------------------------------##--------
--------------------y-######---TT-----------%%%%%-----------------------------------------------TT------------------------------------------##---SSS--
--------------------######----gTT------------|||-------------y----------------------------------TT--------------K-----------------k---------##--------
XXXXXXXXXXXXXXXXXXXXXXXX------XXXXXXXX--%%---|||--XXXXXXX---XXXXXXXXXX-XXXXXXXXXXXXXXX---XXXXXXXXXX-XXXXXXXXXXXXXXXXXXXXXXX------XXX---XXXXXXX------XX
XXXXXXXXXXXXXXXXXXXXXXXX------XXXXXXXX--|----|||--XXXXXXX---XXXXXXXXXX-XXXXXXXXXXXXXXX---XXXXXXXXXX-XXXXXXXXXXXXXXXXXXXXXXX------XXX---XXXXXXX------XX
