------------------------------------------------------------------------------------------------------------------------------------------------------
------------------------------------------------------------------------------------------------------------------------------------------------------
------------------------------------------------------------------------------------------------------------------------------------------------------
----------SSSSSSSSSSSSSSSSSSSSSSSSSSSSSSSSSSSSSSSS-----------------SSS------------------------------SSSSSSSSSS----------------------------------------
--------------------SSSSSSSSSSSSSSSSSSSS-------------------------------------------------------------------------------------------------------------o
--------------------SSSSSSSSSSSSSSSSSSSS----------------------------------------------------oo--------------------------------------------------------
--------------------SSSSSSSSSSSSSSSSSSSS-oooo-------------------CSS-------------------------------------------?SSS------------------------------------
------------------------------------------------------------------------------------------------------------------------------------------------SSS---
-----------------------------------------SSSS-U-------------SS--2--------------g-------------------%----------------------------------------oo--------
----------------------------------------oS--SoS----------------2-2----------------o--------------------------------------------SSS--------------------
---------Q@QQQQ-------SSSSSS?-SSSSSSSSSSSS--SSS----------tt-------2----------S@S-------TT-S----------------TT-SSSSS-----%-------------------SS--------
----------------------SSSSS---SSSSSSSSSS-----------------tt----------------------------TT---------------#--TT------------------------TT---------------
-----------------g-#--SSSSS---SSSSSSSSSS-----------------tt----------------------------TT----%%%%------##--TT------------------------TT---------------
----------------g#-#-------oooSSSSSSSSSS--kk---------g-g-tt----------------------------TT-----||----kk-##--TT---K----------------r---TT---------------
XXXXXXXXXXXXXXXXXXXX-XXXXXXXXXXXXXXXXXXXXXXXXXXXXXXXXXXXXXXX---XXXXXXX-XXXXXXXXXXXXXXXXXXX----||----XXXXX--XX-XXXXXXXXXX----XXXXXXXXXXXXXXXX----------
XXXXXXXXXXXXXXXXXXXX-XXXXXXXXXXXXXXXXXXXXXXXXXXXXXXXXXXXXXXX---XXXXXXX-XXXXXXXXXXXXXXXXXXX----||----XXXXX--XX-XXXXXXXXXX----XXXXXXXXXXXXXXXX----------
