------------------------------------------------------------------------------------------------------------------------------------------------------
------------------------------------------------------------------------------------------------------------------------------------------------------
------------------------------------------------------------------------------------------------------------------------------------------------------
S-----SSSS--------------------SSSSSSSSSS--------------------------------------------------------------------------------------------------------------
S-----------------------------------------------------------------------------------------------------------------------------------------------------
S---------------------ooor--------------------------------------------------------------------------oo------------------------------------------------
S--------------------%%%%%------------------------Q-----------------------SSCSS-----y---------------%%%---------------------------!S------------------
S---------------------|||---------------------------------------------------------#SSS--------------||--o----R----------------------------------------
S----------------g----|||--------------S-----------------------------------------##-----------------||-%%%-------------y-----SSS----------------------
S----------------#----|||--------------S----------------------------------------###1------------g---||--|--------------X------------------------------
S---------S-----##--%%%%%%%------------S----------Q---------------------QQQQ--QQ###-------------TT--||--|-------------XXr---------S------#------------
S--------------###--||||||-----#------------------------------------------------###--SSS--------TT--||-o|------------XXX%%%%%%----------##------------
S-------------####--||||||--o--#-#----------------------------------------------###-------------TT--||%%%%%---------XXXX|||||----------###---------F--
S--M---------#####--||||||-%%%-#-#-------------ggg---gg----kgg-------g----------###-------------TT--||-|||---------XXXXX|||||---------####---------#--
XXXXXXXXXXXXXXXXXXXX||||||--|-XXXXXXXXXX-XXXXXXXXXXXXXXXXXXXXXXXXXXXXXXXXXXXXXXXXXXXXX---XXXXXXXXXX-||-|||----XXXXXXXXXX|||||-----XXXXXXXXXXXXXXXXXXXX
XXXXXXXXXXXXXXXXXXXX||||||--|-XXXXXXXXXX-XXXXXXXXXXXXXXXXXXXXXXXXXXXXXXXXXXXXXXXXXXXXX---XXXXXXXXXX-||-|||----XXXXXXXXXX|||||-----XXXXXXXXXXXXXXXXXXXX
