------------------------------------------------------------------------------------------------------------------------------------------------------
------------------------------------------------------------------------------------------------------------------------------------------------------
------------------------------------------------------------------------------------------------------------------------------------------------------
--------------------SSSSSSSSSS------------------------------------------------------------SSSSSSSSSS--------------------------------------------U-----
-------------------------------------------------------------------------o----------------------------------------------------------------------------
------------------------------------------------------------------------%%%---------------------------------------------------------------------------
----------------------------------------------QQQQQ-----------USSS-------|--o--------1------------------------?SSS------SS---------------##-----------
-------------------------------------------------------------------------|--SSSS---------------------------------------------------------##-------SS--
----------------------------------------------------------------------%--|-------------------------------------------------------------####-----------
-----------------------------C------------------k------------------------|-------------------------------------------------TT----------####---SS------
----------Q------------#-#-----TT-------T-----?QQQQ----------S-----TT----|---------QQQQ-----------------------SSSSS--------TT--------######----------#
---------------------#-#-#-#---TT-------T--------------------------TT----|----------------------------TT----------------t--TT--------######---------##
---------------------#-#-#-#---TT-------T--------------------------TT----|-----%----------------------TT----TT----------t--TT--------######--------###
-M-----------------#-#-#-#-#-EgTT-------T------------gg----k-ggg---TT----|----------yy----------g-g---TT-k--TT--K-------t--TT--------######-------####
XXXXXXXXXXXXX--XXXXXXXXXXXXXXXXXXXXXXX--XXXXXXXXXXXXXXXXXXXXXXXXXXXXXX%%%%%%----XXXXXXXXXXXXXXXXXXXXXXXXXXXXXXXXXXXXXXXXXXXXXXXXXXXXXXXXXXXXXXXXX-XXXX
XXXXXXXXXXXXX--XXXXXXXXXXXXXXXXXXXXXXX--XXXXXXXXXXXXXXXXXXXXXXXXXXXXXX|||||-----XXXXXXXXXXXXXXXXXXXXXXXXXXXXXXXXXXXXXXXXXXXXXXXXXXXXXXXXXXXXXXXXX-XXXX
