------------------------------------------------------------------------------------------------------------------------------------------------------
------------------------------------------------------------------------------------------------------------------------------------------------------
------------------------------------------------------------------------------------------------------------------------------------------------------
-----------------------oo-----SSSSSSSSSS----------SSSSSSS-----------------------------------------------------SSSSSSSSSS------------------------------
-----------------------------------------------------------------------------------------------------------------------------------------------------o
--------------------------------------------------------------g---------------------------------------------------------------------------------------
------------------Q---SSSS------------------------QQ----------SSSSS-------SS---------1--------------------------------------------%-------------------
----------------------------------------------------------------------------------------------------oo------------------------------------------SSS---
---------------------------------------S-------------------S----------------------------------------------------------------------------SSS-oo--------
---------------------------------------S--------------------------------------------------------g-----------------------SS-?Q-------------------------
--------SU--------?-------%%%%---------S-TT---SU--QQ--QQQ-------------SS-----SS----QQQQ---------TT-----------TT-------------------%%%%%-----SS--------
--------------TT-----------|||-#---------TT-----------------------------------------------------TT-----------TT--------------------|||----------------
--------------TT-----------|||-#-#-------TT-------------------TT-----t--------------------------TT-----------TT----TT----------y---|||----------------
--M-----------TT-----------|||-#-#-------TT------k------------TT-----t--------------yy----------TT--------y--TT--g-TT------SSSSS---|||----------------
XXXXXXXXXXXXXXXXXXXX%%%----|||XXXXXXXXXXXXXXXXXXXXXXXXXXX---XXXXXXXXXX----------XXXXXXXXXXXXXXXXXXX-XXXXXXXXXXXXXXXXXXXX-------XX-%|||----------------
XXXXXXXXXXXXXXXXXXXX||-----|||XXXXXXXXXXXXXXXXXXXXXXXXXXX---XXXXXXXXXX----------XXXXXXXXXXXXXXXXXXX-XXXXXXXXXXXXXXXXXXXX-------XX--|||----------------
