------------------------------------------------------------------------------------------------------------------------------------------------------
------------------------------------------------------------------------------------------------------------------------------------------------------
------------------------------------------------------------------------------------------------------------------------------------------------------
--------------------SSSSSSSSSS-------------------------------------SSS--------------------SSSSSSSSSS------------------------------SSSSSSSS------------
--------------------SSSSSSSSSS-------------------------------------------o----------------------------------------------------------------------------
--------------------SSSSSSSSSS----------ooooo---------------------------%%%---------------------------------------------------------------------------
--------------------SSSSSSSSSS----------------------------------CSS------|--o------o--o-------------------2---------------SSC---------------SS--------
------------------------------------------------SS-----------------------|--SSSS----------------------------------------------------------------------
-----------------g-----------------------SSSS---------------SS--2-----%--|----------------------------------------------------------------------------
-----------------#---------------------------------------------2-2-------|---------SSSS-------------o---------------------SSS-------------------------
----------S-----##----SSSSSS?--------------------------ooo--------2------|--------------------------------2----------------------------g##--SS--------
---------------###----SSSSS------------T---------------------------------|----------------t--------------------#-----------------------###--------#-TT
--------------####----SSSSS------------T----%%%%%------------------------|-----%%%%-------t--------------------#---------------------g####-------##-TT
-M-----------#####---------ooo-------kkT-----|||-------------------------|------||--------t-------------y--y---#----ggg----------#---#####------###-TT
XXXXXXXXXXXXXXXXXXXX-XXXXXXXXXXXXXXXXXXX%%---|||----XXXXXXXX---XXXXXXX%%%%%%----||--------XXXXXXXXXXXXXXXXXXXX-XXXXXXXXXX----XXXXXXXXXXXXX--XXXXXXX-XX
XXXXXXXXXXXXXXXXXXXX-XXXXXXXXXXXXXXXXXXX|----|||----XXXXXXXX---XXXXXXX|||||-----||--------XXXXXXXXXXXXXXXXXXXX-XXXXXXXXXX----XXXXXXXXXXXXX--XXXXXXX-XX
