------------------------------------------------------------------------------------------------------------------------------------------------------
------------------------------------------------------------------------------------------------------------------------------------------------------
------------------------------------------------------------------------------------------------------------------------------------------------------
----------------------------------------------------------------------------------------------------SSSSSSSSSS----------SSSSSSSSSS--------------------
------------------------------------------------------------------------------------------------------------------------------------------------------
-----------------------SSS--------------------------------------------------------g-------------------------------------------------------------------
---------------------------------------------------------Q-Q--------------SSCSS-SSSSSSSS-------------------------------------------------##-----------
---------------------g------------------------------------------------------------------------------------------oooo---------------------##-----------
-----------------%%%%%%----------------------------------------------o-----------------------------------------------------------------####-----------
------------------||||----SSS------------------------------------y-----------------------------oooo------------------------------------####-----------
---------Q--------||||-----------------------------------Q-Q-----##-----QQQQ--QQ-----------------------------TT----------------------######-----------
-------------%%%%%||||-----------------T------------------------###------------------------------------TT----TT-----------SS---------######--------#--
--------------|||-||||-----------------T-----------------------####------------------------------------TT----TT-----------SS---------######----K---#--
-M------------|||-||||----oo---------kkT----------------------#####---------------------------------g--TT----TT---y-------SS---------######--------#--
XXXXXXXXXXX---|||-||||---%%%--XXXXXXXXXXX-XX-XX-XXXXXXXXXXXXXXXXXXX---XXXXXXXXXXXXXXXX---X%%%%%%%-%%XXXXXXXXXXXXXXXXXXXX--XX--XXXXXXXXXXXXXXXXXXX--XXX
XXXXXXXXXXX---|||-||||----|---XXXXXXXXXXX-XX-XX-XXXXXXXXXXXXXXXXXXX---XXXXXXXXXXXXXXXX---X||||||---|XXXXXXXXXXXXXXXXXXXX--XX--XXXXXXXXXXXXXXXXXXX--XXX
