------------------------------------------------------------------------------------------------------------------------------------------------------
------------------------------------------------------------------------------------------------------------------------------------------------------
------------------------------------------------------------------------------------------------------------------------------------------------------
------------------------------------------------------------------------------------------SSSSSSSSSS--------------------SSSSSSSSSS--------------------
------------------------------------------------------------------------------------------------------------------------------------------------------
----------------------ooor-----------------------------oooo-------------------------------------------------------------------------------------------
---------------------%%%%%-----------------------------%%%%-------SSoo--SSSSS--------SUS---------------------------oo--------------SSSS---------------
----------------------|||-------------------------SSSS--||------------------------------------------oo------------------------------------------------
----------------------|||-------------------------------||--------------------------------------------------------------------------------------------
----------------------|||-------------------------------||-----------------------------------------------------------------------------SSSS-----------
--------------------%%%%%%%-----QQQQ--------------------||--%%%%%%-----------2------#####--------------------T-%%%%--%%%------------------------------
--------------------||||||-----------K-B-----K---B----U-||---||||----------TT-------#------------------------T--||----||--SS-----------------------#--
--------------------||||||--o----------b---------b------||---||||-----t----TT--T---K#------------------------T--||----||--SS-------------------K---#--
-M------------k-ggg-||||||-%%%---------b---------B------||---||||-----t----TT--T----#-----------g-g-------y--To-||----||--SS-----------------------#--
XXXXXXXXXXXXXXXXXXXX||||||--|-XXXXXXXXXXXXXXXXXXXX----%%%%%--||||-----XXXXXXXXXXXXXXXXX---XXXXXXXXXXXXXXXXXXXX%-||----||--XX--XXXX---------XXXXXX--XXX
XXXXXXXXXXXXXXXXXXXX||||||--|-XXXXXXXXXXXXXXXXXXXX-----|||---||||-----XXXXXXXXXXXXXXXXX---XXXXXXXXXXXXXXXXXXXX--||----||--XX--XXXX---------XXXXXX--XXX
