------------------------------------------------------------------------------------------------------------------------------------------------------
------------------------------------------------------------------------------------------------------------------------------------------------------
------------------------------------------------------------------------------------------------------------------------------------------------------
--------------------------------oo------------------------------------SSSSSSSSSS----------------------------------------------------------------U-----
-------------------------------------g-g--------------------------------------------------------------------------------------------------------------
-----------------------------------%%%%%------------------------------------------------oo------------------------------------------------------------
------------------------------------||||------QQQQ----------------SSoo----------oo------------------------------------------------%-------------------
------------------------------------||||--------------------------------------TT---------------------------------SSS------------oo----------------SS--
------------------------------------||||--------------------------------------TT--------------------------------------------------------SSS-----------
------------------------------%%%%%-||||--------k-----------------------------TT-SSS----------------------------------------------------------SS------
-------------------%-----------|||--||||T-----?QQQ----------%%%%%%----------SCTT---------S------TT---------------------------TT---%%%%%--------------#
-------------------------------|||--||||T-----------K--------||||-------TT----TT----------------TT----------g----------------TT----|||--------------##
-------------------------------|||--||||T--------------------||||-------TT----TT----------------TT----------TT---------------TT----|||-------------###
-------------%%%%--------ggg---|||--||||T------------------g-||||-------TT---kTT------------k---TT----------TT-----------y---TT----|||------------####
XXXXXXXXXXX---||----XXXXXXXXXX-|||--||||XXXXXXXXXXXXXXXXXXXX-||||-----XXXXXXXXXX----------XXXXXXXXXX--XXXXXXXX%%%%----%%XXXXXXXXXX%|||------XXXXX-XXXX
XXXXXXXXXXX---||----XXXXXXXXXX-|||--||||XXXXXXXXXXXXXXXXXXXX-||||-----XXXXXXXXXX----------XXXXXXXXXX--XXXXXXXX|||------|XXXXXXXXXX-|||------XXXXX-XXXX
