------------------------------------------------------------------------------------------------------------------------------------------------------
------------------------------------------------------------------------------------------------------------------------------------------------------
------------------------------------------------------------------------------------------------------------------------------------------------------
------------------------------------------------------------------------------------------------------------------------------------------------------
------------------------------------------------------------------------------------------------------------------------------------------------------
----------------------------------------%%-------------oooo-------------------------------------------------------------------------------------------
---------------------LSSS---------------|--------------%%%%-----------------SSSS---o--o----SSS!-------------------------SS---------------##--QQQQ-----
----------------------------------------|----oo---SSSS--||-------------------------------------------------------------------------------##-----------
----------------------------------------|---------------||-----------------------------------------------------------------------------####-----------
----------------------------------------|---------------||-------------------K-----SSSS------------------------------------TT----------####----y------
----------Q----------2-----#------------|---------------||-----------#-----SSSSS--------------C-------%%%%%%---------------TT--------######-Q?SSQQQ---
---------------------------#----------tt|-------------U-||----------##T--------------------------------||||-------------t--TT--------######-----------
---------------------------##---------tt|---------------||--TT-----###T---------%%%--------------------||||-------------t--TT--------######-----------
---M---------------#--kk---##---------tt|---------------||--TT----####T---------||-------------g-g-----||||----k----kkk-t--TT--------######-----------
XXXXXXXXXXXXX--XXXXXXXXXXXXXXXXXXXXXXXXX|----%%%%-----%%%%%-XXXXXXXXXXXXXXXXXXXX||--------XXXXXXXXXX%%-||||-%%XXXXXXXXXXXXXXXXXXXXXXXXXXXXXXXX--XXXXXX
XXXXXXXXXXXXX--XXXXXXXXXXXXXXXXXXXXXXXXX|-----||-------|||--XXXXXXXXXXXXXXXXXXXX||--------XXXXXXXXXX|--||||--|XXXXXXXXXXXXXXXXXXXXXXXXXXXXXXXX--XXXXXX
