------------------------------------------------------------------------------------------------------------------------------------------------------
------------------------------------------------------------------------------------------------------------------------------------------------------
------------------------------------------------------------------------------------------------------------------------------------------------------
--------------------------------------------------------------------------------ooo-------------------------------------------------------------------
--------------------------------------------------------------------------------%%%-------------------------------------------------------------------
-----------------------SSS-------------------------------------------------------|--------------------------------------------------------------k-----
---------------------------------------------------------------------------1-----|-------------------------------------------------------------SQS--SQ
---------------------g-----------------------------------------------------------|--------------------------------------------------------------------
--------------------%%%----------------------------------TT----------------------|--------------------------------------------------------------------
--------------------||----SSS----------------------TT----TT----------------ggg---|---%%%%--o-----------------------------------SSS--------------------
--------------------||------------------------tt---TT----XX-----------#########--|----||---------TT---------------------%------------------#---SQS--S?
-----------------K--||----------------K-------tt---TT----------------T--------#-%%%%%%||---------TT---------g-----------------------------##----------
------------B-------||--------TTTT------------tt---TT--------B-------T--------#--||||-||---------TT---------TT---------------------------###----------
-M----------b-------||----oo--TTTT-------g----tt---TT--------b-------T--------#--||||-||---------TT---------TT-k----kkk----------r---y--####-k------gg
XXXXXXXXXXXXXXXXXXXX||---%%%--XXXXXXXXXXXXXXXXXXXXXXXXXXXXXXXXXXXX--XX--------X--||||-||%%XXXXXXXXXX--XXXXXXXXXXXXXXXXXX----XXXXXXXXXXXXXXXXXXXXXXXXXX
XXXXXXXXXXXXXXXXXXXX||----|---XXXXXXXXXXXXXXXXXXXXXXXXXXXXXXXXXXXX--XX--------X--||||-||-|XXXXXXXXXX--XXXXXXXXXXXXXXXXXX----XXXXXXXXXXXXXXXXXXXXXXXXXX
