------------------------------------------------------------------------------------------------------------------------------------------------------
------------------------------------------------------------------------------------------------------------------------------------------------------
------------------------------------------------------------------------------------------------------------------------------------------------------
-----------------------oo---------------SSSSSSSSSS----------------------------------------------------------------------------------------------------
----------------------------------------SSSSSSSS------------------------------------------------------------------------------------------------------
----------------------------------------SSSCSSSS----------------------------------------oo--oo--------------------------------------------------------
----------------------SSSS--------------SSSSSSSS------------------------SSSSS---oo------------------------------------US--SSC---------------SS--------
----------------------------------------------------------------------------------------------------------TT------------------------------------------
---------------------------------------------------------B-----------------------------------------%------TT------------------------------------------
-----------------------------------oo------ggg-----------b-----------------------SS-----------------------TT--------E-----SSS-------------------------
----------Q---------------%%%%----o--o--SSSSSSSS-------SS#CS---------T-------2-----------SSS-------------SXXS------TT-----------------------SS--------
---------------------------|||----------SSSSSSSS---------------------T-----TT--------------------------------------TT--t-------------TT-----------#-TT
---------------------------|||----------SSSSSSSS-----------K---------Tt----TT--T-------------%%%%---TT-------------TT--t-------------TT----------##-TT
-M-----------------#-------|||----------SSSSSSSS--------------ggg----Tt----TT--T--------------||----TT----------g--TT--t---------#---TT---------###-TT
XXXXXXXXXXXXX--XXXXX%%%----|||XXXXXXXXXXXXXXXXXXXXXXXXXXXXXXXXXXXXXXXXXXXXXXXXXX--------------||----XXXXXXXXXXXXXXXXXXXXX----XXXXXXXXXXXXXXXXXXXXXX-XX
XXXXXXXXXXXXX--XXXXX||-----|||XXXXXXXXXXXXXXXXXXXXXXXXXXXXXXXXXXXXXXXXXXXXXXXXXX--------------||----XXXXXXXXXXXXXXXXXXXXX----XXXXXXXXXXXXXXXXXXXXXX-XX
