------------------------------------------------------------------------------------------------------------------------------------------------------
------------------------------------------------------------------------------------------------------------------------------------------------------
------------------------------------------------------------------------------------------------------------------------------------------------------
S-----SSSSSSSSSSSSSS---oo-------oo----------------------------------------------SSSSSSSSSS----------SSSSSSSSSS--------------------SSSSSSSSSS----U-----
S------------------------------------g-g--------------------------------------------------------------------------------------------------------------
S----------------------------------%%%%%---------------oooo-------------------------------------------------------------------------------------------
S---------------------SSSS----------||||---------------%%%%---------------SSCSS------------SSS!--------------------------SSS----S!--------------------
S-----------------------------------||||----------SSSS--||------------------------------------------------------oooo------------------------------SS--
S-----------------------------------||||----------------||--------------------------------------------------------------------------------------------
S-----------------------------%%%%%-||||----------------||-----------------------------S------------------------------------------------------SS------
S---------@QQQQ-----------%%%%-|||--||||----------------||--------------QQQQ--QQSU------------C------------TT-T------------------S-------------------#
S--------------------------|||-|||--||||--------------U-||--------------------------TT---t--------------#--TT-T---------------------------TT--------##
S----------------g-#-------|||-|||--||||----------------||--------------------------TT---t-------------##--TT-T--------------------tt-----TT-------###
S---------------g#-#-------|||-|||--||||-------ggg------||---y---------------------kTT--kt-----g-g--kk-##--TT-T---y---------gg-g-g-tt----kTT------####
XXXXXXXXXXXXXXXXXXXX%%%----|||-|||--||||-XXXXXXXXX----%%%%%-XXXXXXXXXXXXXXXXXXXXXXXXXXXXXXXXXXXXXXXXXXXXX--XX-XXXXXXXXXXXXXXXXXXXXXXXXXXXXXXXXXXX-XXXX
XXXXXXXXXXXXXXXXXXXX||-----|||-|||--||||-XXXXXXXXX-----|||--XXXXXXXXXXXXXXXXXXXXXXXXXXXXXXXXXXXXXXXXXXXXX--XX-XXXXXXXXXXXXXXXXXXXXXXXXXXXXXXXXXXX-XXXX
