------------------------------------------------------------------------------------------------------------------------------------------------------
------------------------------------------------------------------------------------------------------------------------------------------------------
------------------------------------------------------------------------------------------------------------------------------------------------------
------------------------------SSSSSSSSSS----------------------------------------SSSSSSSSSL--------------------SSSSSSSSSS------------------------------
------------------------------------------------------------------------------------------------------------------------------------------------------
--------------------------------------------------------------g-------------------------------------oo------------------------------------------k-----
--------------------------------------------------Q-----------SSSSS---------SSSS----oooooo----------%%%--------------------------------US------SQS--SQ
----------------------------------------------------------------------------------------------------||--o----R------------------oo--------------------
---------------------------------------S--------------------------------------------SSSSSS----------||-%%%--------------------------------------------
---------------------------------------S-------------------------------------K------SSSSSS----------||--|----------------------------SS---------------
-----SSS-----------%-------------------S------tt--Q------------------------SSSSS-----------------tt-||--|-----T--------------TT------------S---SQS--S?
-------------------------------#--------------tt----------------------T-------------------T------tt-||-o|-----T--------------TT-----------------------
-------------------------------#-#------------tt--------------TT-----tT-------------------T------tt-||%%%%%---T----TT--------TT---TT------------------
-------------%%%%--------ggg---#-#-------g----tt-----gg----k--TT-----tT-------------------T------tt-||-|||----T--g-TT----y---TT---TT---------k------gg
XXXXXXXXXXX---||----XXXXXXXXXXXXXXXXXXXXXXXXXXXXXXXXXXXXXXXXXXXXXXXXXXXXXXXXXXXX---XXXXXXXXXXXXXXXXX||-|||----XXXXXXXXXXXXXXXXXXXXXXXXXX-X-XXXXXXXXXXX
XXXXXXXXXXX---||----XXXXXXXXXXXXXXXXXXXXXXXXXXXXXXXXXXXXXXXXXXXXXXXXXXXXXXXXXXXX---XXXXXXXXXXXXXXXXX||-|||----XXXXXXXXXXXXXXXXXXXXXXXXXX-X-XXXXXXXXXXX
