------------------------------------------------------------------------------------------------------------------------------------------------------
------------------------------------------------------------------------------------------------------------------------------------------------------
------------------------------------------------------------------------------------------------------------------------------------------------------
------------------------------SSSSSSSSSS----------------------------------------------------------------------SS-------SSSSSSSSSSS--------------------
------------------------------SSSSSSSSSS--------------------------------------------------------------------------------------------------------------
----------------------ooor----SSSSSSSSSS-----------------------------R----------------------oo--------oo----------------------------------------------
------------------SC-%%%%%----SSSSSSSSSS---------------------------------------------1---------------------------------S------------------------------
----------------------|||-----------------------------------------------------------------------------------------------------------------------------
----------------------|||--------------------------------B------------o----------------------------%---------------SSS---------------g#---------------
----------------------|||--------------------------------b--------------------------------------------------------------------------g##---------------
--------SU----TT---2%%%%%%%---SSSSSSSSSS---------------SS#CS-----%%%---------------QQQQ---SS---------------------------S------------###---------------
--------------TT----||||||----SSSSSSSSSS--------------------------|-----------#--------------------------------##---------SS-------####------------#--
--------------TT----||||||--o-SSSSSSSSSS-------------------K------|----------##--------------%%%%-----------tt-##---------SS------#####--------K---#--
--M-----------TT----||||||-%%%SSSSSSSSSS--------------------------|-----------------yy--------||------ggg---tt-##---------SS------#####------------#--
XXXXXXXXXXXXXXXXXXXX||||||--|-XXXXXXXXXXX-XX-XX-XXXXXXXXXXXX%%%%%-|---XXXXXXXXXXXXXXXXXXXX----||----XXXXXXXXXX-XX------X--XX--XXXXXXXXX--XXXXXXXX--XXX
XXXXXXXXXXXXXXXXXXXX||||||--|-XXXXXXXXXXX-XX-XX-XXXXXXXXXXXX-|||--|---XXXXXXXXXXXXXXXXXXXX----||----XXXXXXXXXX-XX------X--XX--XXXXXXXXX--XXXXXXXX--XXX
