------------------------------------------------------------------------------------------------------------------------------------------------------
------------------------------------------------------------------------------------------------------------------------------------------------------
------------------------------------------------------------------------------------------------------------------------------------------------------
------------------------------------------------------------------------------------------SSSSSSSSSSSSSSSSSSSS----------------------------------------
--------------------------------------------------?---------------------------------------------------------------------------------------------------
----------------------ooor-------------------------------------------R--------------------------------------------------------------------------------
---------------------%%%%%---------------------------------------------------------USS----------------------------------SS--------!S------------------
----------------------|||-------------------------SS-------------------------------------------------------------SSS----------------------------------
----------------------|||------------------------------------------------------g----------------------------------------------------------------------
----------------------|||----------oo--------------------------------------------------------------------------------------TT-------------------------
-------------------%%%%%%%%-------o--o---------------------------%%%---------S@S--#--------------------------T-------------TT-----S------#------------
--------------------||||||-----------------------------SSS--------|---------------#-------t------------TT----T----------t--TT-----------##------------
--------------------||||||--o-------------------------------------|---------------##------t------------TT----T----------t--TT----------###---------F--
-M-----------%%%%---||||||-%%%------------------------------------|---------------##--gg--t---------g--TT----T----------t--TT---------####---------#--
XXXXXXXXXXX---||----||||||--|-XXXXXXXXXXX-XX-XX-XX----------%%%%%-|----XXXXXXXXX--XXXXXXXXXXXXXXXXXXXXXXXXXXXX%%%%----%%XXXXXXXXXXXXXXXXXXXXXXXXXXXXXX
XXXXXXXXXXX---||----||||||--|-XXXXXXXXXXX-XX-XX-XX-----------|||--|----XXXXXXXXX--XXXXXXXXXXXXXXXXXXXXXXXXXXXX|||------|XXXXXXXXXXXXXXXXXXXXXXXXXXXXXX
