------------------------------------------------------------------------------------------------------------------------------------------------------
------------------------------------------------------------------------------------------------------------------------------------------------------
------------------------------------------------------------------------------------------------------------------------------------------------------
S-----SSSS----------SSSSSSSSSS--oo-----------------oo-------SSSSSSSSSS--------------------SSSSSSSSSS--------------------------------------------------
S--------------------------------------g----------%%%%------SSSS--SSSS-------------------------------------------------------------------------------o
S----------------------------------%%%%%-----------||-------SSSS--SSSS--------------------------------------------------------------------------------
S-----------------Q-----------------||||-----------||---------SS---S-------g-------o--o-----------------SSQSSS-----------------SSS!S------------------
S-----------------------------------||||-----------||--SSS----SS---S---%%%%%%-------------------------------------------------------------------SSS---
S-----------------------------------||||-----------||---------SS---S----||||-------------------------------------------y--------------------oo--------
S----------------------------C%%%%%-||||-----------||-------ooSS---SoU--||||-------SSSS-------------------K------------X--------K---------------------
S-----------------?----#-#-----|||--||||-----------||-------SSSS---SSS--||||----------------------------SSSSSS--------XX-------SSSS------#--SS--------
S-------------TT-----#-#-#-#---|||--||||-----K---B-||-------------------||||--------------t--------------------------XXX----------------##------------
S-------------TT-----#-#-#-#---|||--||||---------b%||-------------------||||----%%%-------t-------------------------XXXX-TT------------###------------
S-------------TT-----#-#-#-#-E-|||--||||---------B-||-------k--g-g------||||----||--------t------------------------XXXXX-TT-----------####------------
XXXXXXXXXXXXXXXXXXXXXXXXXXXXXX-|||--||||XXXXXXXXXX-||-------XXXXXXXXXX--||||----||--------XXXXXXXXXXXXXXXXXXXXXXXXXXXXXXXXXXXXXXXXXXXXXXXXXX----------
XXXXXXXXXXXXXXXXXXXXXXXXXXXXXX-|||--||||XXXXXXXXXX-||-------XXXXXXXXXX--||||----||--------XXXXXXXXXXXXXXXXXXXXXXXXXXXXXXXXXXXXXXXXXXXXXXXXXX----------
