------------------------------------------------------------------------------------------------------------------------------------------------------
------------------------------------------------------------------------------------------------------------------------------------------------------
------------------------------------------------------------------------------------------------------------------------------------------------------
S-----SSSSSSSSSSSSSS------------oo------------------------------------------------------------------SSSSSSSSSS----------------------------------------
S--------------------------------------g--------------------------------------------------------------------------------------------------------------
S----------------------------------%%%%%--------------------------------------------------------------------------------------------------------------
S-----------------------------------||||----------------------------------SS-------USS-----------------------------oo--------------------##-----------
S-----------------------------------||||----------------------------------------------------------------------------------------oo-------##-----------
S-----------------------------------||||-----------------TT----------o-----------------------------------------------------------------####-----------
S-----------------------------%%%%%-||||-----------TT----TT------y------------------------------g--------------------------------------####-----------
S---------@QQQQ----------------|||--||||-----------TT----XX------##---SS-----SS---#-------------TT-----------T-%%%%--%%%-----TT------######-----------
S------------------------------|||--||||-----------TT-----------###---------------#-------------TT-----TT----T--||----||-----TT------######-----------
S----------------g-#-----------|||--||||-----------TT----------####---------------##------------TT-----TT----T--||----||-----TT------######--------F--
S---------------g#-#-----ggg---|||--||||----y-y----TT---------#####---------------##--gg--------TT--g--TT----To-||----||-y---TT------######--------#--
XXXXXXXXXXXXXXXXXXXXXXXXXXXXXX-|||--||||XXXXXXXXXXXXXXXXXXXXXXXXXXX---------------XXXXXXXXXXXXXXXXX-XXXXXXXXXX%-||----||XXXXXXXXXXXXXXXXXXXXXXXXXXXXXX
XXXXXXXXXXXXXXXXXXXXXXXXXXXXXX-|||--||||XXXXXXXXXXXXXXXXXXXXXXXXXXX---------------XXXXXXXXXXXXXXXXX-XXXXXXXXXX--||----||XXXXXXXXXXXXXXXXXXXXXXXXXXXXXX
