------------------------------------------------------------------------------------------------------------------------------------------------------
------------------------------------------------------------------------------------------------------------------------------------------------------
------------------------------------------------------------------------------------------------------------------------------------------------------
--------------------------------oo---------------------------------SSS--------------------------------------------------SSS-----SSSSSSSSSS------------
---------------------------------------g--------------------------------------------------------------------------------------------------------------
-----------------------------------%%%%%--------------------------------------------------------------------------------------------------------------
------------------SCUSS-------------||||------QQQQ--------------CSS---------SSSS---USS--------------------2-----------USUS----------------------------
------------------------------------||||--------------------------------------------------------------------------------------------------------------
------------------------------------||||--------------------SS--2-----------------------------------------------------------SSS-----------------------
------------------------------%%%%%-||||--------k--------------2-2-----------K----------------------o---------------E---------------------------------
--------------TT---2-----------|||--||||T-----?QQQ-------tt-------2--------SSSSS--#-------------TT--------2--------TT---SSS------------g##--#---------
--------------TT-----B---------|||--||||T----------------tt-----------T-----------#-------------TT-----------------TT--t---------------###--##--------
--------------TT-----b-------B-|||--||||T----------------tt-----------T-----------##------------TT-----------------TT--t-------------g####--###------#
-M------------TT-----B-------b-|||--||||T------------g-g-tt-----------T-----------##--gg----k---TT------y--y----g--TT--t-------------#####--####----##
XXXXXXXXXXXXXXXXXXXXXXXXXXXXXX-|||--||||XXXXXXXXXXXXXXXXXXXX---XXXXXXXXXXXXXXXXX--XXXXXXXXXXXXXXXXXXXXXXXXXXXXXXXXXXXXXXXXX------XXXXXXXXX--XXXXXXXXXX
XXXXXXXXXXXXXXXXXXXXXXXXXXXXXX-|||--||||XXXXXXXXXXXXXXXXXXXX---XXXXXXXXXXXXXXXXX--XXXXXXXXXXXXXXXXXXXXXXXXXXXXXXXXXXXXXXXXX------XXXXXXXXX--XXXXXXXXXX
