------------------------------------------------------------------------------------------------------------------------------------------------------
------------------------------------------------------------------------------------------------------------------------------------------------------
------------------------------------------------------------------------------------------------------------------------------------------------------
---------------------------------------------------oo---------------------------SSSSSSSSSS------------------------------------------------------------
--------------------------------------------------%%%%-----------------------------------------------------------------------------------------------o
----------------------------------------%%---------||--------------------------------------------------------------k----------------------------------
---------------------LSSS---------------|----------||----------------------g---------------SSS!---------------S---SSSSSS--oo---%%%--------------------
----------------------------------------|----oo----||--SSS-------------%%%%%%-----------------------------TT--------------SS----||--------------SSS---
----------------------------------------|----------||-------------------||||------------------------------TT--------------------||---g#-----oo--------
----------------------------------------|----------||-------------------||||-----------S------------------TT--------------------||--g##---------------
----------Q----------2-----#------------|----------||----------------T--||||----SU------------C----------SXXS----------------SS-||--###-----SS--------
---------------------------#------------|----------||----------------T--||||--------TT---t--------------------------------------||-####---------------
---------------------------##-----------|---------%||----------------T--||||--------TT---t----------TT--------TT----------------||#####---------------
-------------------#--kk---##-----k-k---|----------||---------ggg----T--||||-------kTT--kt-----g-g--TT--------TT----------------||#####---------------
XXXXXXXXXXXXX--XXXXXXXXXXXXXXXXXXXXXXXX-|----%%%%--||-------XXXXXXXXXX--||||----XXXXXXXXXXXXXXXXXXXXXXXXXXXXXXXXXXXXXX--%%-----%%%XXXXX--XXX----------
XXXXXXXXXXXXX--XXXXXXXXXXXXXXXXXXXXXXXX-|-----||---||-------XXXXXXXXXX--||||----XXXXXXXXXXXXXXXXXXXXXXXXXXXXXXXXXXXXXX--|-------||XXXXX--XXX----------
