------------------------------------------------------------------------------------------------------------------------------------------------------
------------------------------------------------------------------------------------------------------------------------------------------------------
------------------------------------------------------------------------------------------------------------------------------------------------------
----------SSSSSSSSSS--------------------SSSSSSSSSSSSSSSSS-------------SSSSSSSSSS------------------------------SSSSSSSSSS------------------------------
----------------------------------------------------------------------------SSSS----------------------------------------------------------------------
-------------------------------------------------------------------------g--SSSS------------oo--------------------------------------------------------
-----------------------------------------oooo-----QQ--------------SSoo--SS----------y------------------------R----------------------------------------
------------------------------------------------------------------------SS--------#SSS-------------------r------------------------oo------------------
-----------------------------------------SSSS-U------------S------------SS-------##----------------%%%%%%%%-------------------------------------------
----------------------------------------oS--SoS-------------------------SC--g-g-###1----------------||||||---------------------SSS--------------------
---------Q@QQQQ-----SS------------------SS--SSS---QQ--QQQ---%%%%%%------SS--SSSS###-------S---------||||||----T---------%------------------Q----------
---------------------K---TT-----------K----------------------||||---------------###--SSS------------||||||----T---------------------------------------
-----------------g-#-----TT---TTTT---------------------------||||---------------###----------%%%%---||||||----T----TT------------------------------F--
-M--------------g#-#-----TT---TTTT--------kk-----------------||||---------------###-----------||----||||||--ooT--g-TT------------r-----------------#--
XXXXXXXXXXXXXXXXXXXXXXXXXXXXXXXXXXXXXXXXXXXXXXXXXXXXXXXXX----||||-----XXXXXXXXXXXXXXXX---X----||----||||||--%%XXXXXXXXXX----XXXXXXXXXXXXXXXXXXXXXXXXXX
XXXXXXXXXXXXXXXXXXXXXXXXXXXXXXXXXXXXXXXXXXXXXXXXXXXXXXXXX----||||-----XXXXXXXXXXXXXXXX---X----||----||||||---|XXXXXXXXXX----XXXXXXXXXXXXXXXXXXXXXXXXXX
