------------------------------------------------------------------------------------------------------------------------------------------------------
------------------------------------------------------------------------------------------------------------------------------------------------------
------------------------------------------------------------------------------------------------------------------------------------------------------
--------------------------------oo--------------------------------------------------------SSSSSSSSSSSSSSSSSSSS----------------------------------------
-------------------------------------g-g--------------------------------------------------------------------------------------------------------------
-----------------------------------%%%%%%%-------------oooo-------------------------------------------------------------------------------------------
------------------------------------|||||--------------%%%%-------SSoo-----g---------SSSS---------------------------------SSC-----%-------------------
------------------------------------|||||----oo---SSSS--||-------------%%%%%%-------------------------------------------------------------------------
-----------------%%%----------------|||||---------------||--------------||||-------------------------------------------y----------------SSS-----------
------------------||----------%%%%%-|||||---------------||--------------||||-------------------------------------------X--SSS-------------------------
------------------||-----------|||--|||||---------------||--%%%%%%------||||----Q----------------------------T--------XX----------%%%%%-----#---------
-------------%%%%%||-----------|||--|||||-------------U-||---||||-------||||--------------t------------TT----T-------XXX-----------|||------##--------
--------------|||-||-----------|||--|||||---------------||---||||-------||||--------------t------------TT----T------XXXX-----------|||------###------#
--------------|||-||-----------|||--|||||---------------||---||||-------||||-----ggg------t---------g--TT----T-----XXXXX---------#-|||------####----##
XXXXXXXXXXX---|||-||XXXXX--XXX-|||--|||||----%%%%-----%%%%%--||||-------||||----XXXXX----XXXXXXXXXXXXXXXXXXXXXXXXXXXXXXXX----XXXXX%|||------XXXXXXXXXX
XXXXXXXXXXX---|||-||XXXXX--XXX-|||--|||||-----||-------|||---||||-------||||----XXXXX----XXXXXXXXXXXXXXXXXXXXXXXXXXXXXXXX----XXXXX-|||------XXXXXXXXXX
