------------------------------------------------------------------------------------------------------------------------------------------------------
------------------------------------------------------------------------------------------------------------------------------------------------------
------------------------------------------------------------------------------------------------------------------------------------------------------
----------------------------------------SSSSSSSSSS----------------------------------------------------------------------------------------------------
------------------------------------------------------------------------------------------------------------------------------------------------------
-------------------------------------------------------oooo-------------------------------------------------------------------------------------------
-----------------------------U-----------oooo----------%%%%--------------------------SUS------------------------------------------!S--------SSS-------
--------------------------------------------------------||--------------------------------------------------------------------------------------------
-----------------%%%---------------------SSSS-U---------||--------------------------------------------------------------------SSS---------------------
------------------||---------------oo---oS--SoS---SSS---||----------------------------------------oo---------------------------------------------SSSSS
------------------||--------##----o--o--SS--SSS---------||-----------T--------------#####-----------------------!-----S-%---------S------#------------
-------------%%%%%||---y-#####------------------------U-||-----------T--------------#----------TT---------------------------------------##------------
--------------|||-||y-######----------------------------||-----------T-------------K#----------TT---------*----------------------------###--SSS-------
-M------------|||-||######----------------kk------------||----ggg----Tgg------------#-------y--TT---gg----*----------------------r----####---------r--
XXXXXXXXXXX---|||-||XXXX------XXXXXXXXXXXXXXXXXXXX----%%%%%-XXXXXXXXXXXXXXXXXXXXXXXXXXX---XXXXXXXXXXXXXXXXXXX-XXXXXXXXXX----XXXXXXXXXXXXXXXX-----XXXXX
XXXXXXXXXXX---|||-||XXXX------XXXXXXXXXXXXXXXXXXXX-----|||--XXXXXXXXXXXXXXXXXXXXXXXXXXX---XXXXXXXXXXXXXXXXXXX-XXXXXXXXXX----XXXXXXXXXXXXXXXX-----XXXXX
