------------------------------------------------------------------------------------------------------------------------------------------------------
------------------------------------------------------------------------------------------------------------------------------------------------------
------------------------------------------------------------------------------------------------------------------------------------------------------
--------------------SSSSSSSSSS--------------------------------------------------------------------------------SSSSSSSSSS------------------------------
--------------------SSSSSSSSSS-----------g------------------------------------------------------------------------------------------------------------
--------------------SSSSSSSSSS----------%%------------------------------------------------------------------------------------------------------------
--------------------SSSSSSSSSS----------|----------------Q-Q------------SSSSS------o--o----------------------R----------------------------------------
----------------------------------------|----oo------------------------------------------------------r----------------------------oo------------------
----------------------------------------|-----------------------------------------------------------%%%%%%%-------------------SSS---------------------
----------------------------------------|------------------------------------------SSSS-----------oo||||||--------------------------------------------
----------------!-----SSSSSS?--TT-------|----------------Q-Q-----------------2----------------------||||||----T---------%------------------Q----------
----------------------SSSSS----TT-------|----------------------------------TT------------------TT---||||||----T------------------------------------#--
----------------------SSSSS----TT-------|-----------------------------t----TT--T%%%------------TT---||||||----T----TT--------------------------K---#--
-M-------------------------ooogTT-------|--------------------y--------t----TT--T||----------y--TT---||||||--ooT--g-TT------------r-----------------#--
XXXXXXXXXXXXXXXXXXXX-XXXXXXXXXXXXXXXXX--|----%%%%-XXXXXXXXXXXXXXXXXXXXXXXXXXXXXX||--------XXXXXXXXXX||||||--%%XXXXXXXXXX----XXXXXXXXXXXXXXXXXXXXX--XXX
XXXXXXXXXXXXXXXXXXXX-XXXXXXXXXXXXXXXXX--|-----||--XXXXXXXXXXXXXXXXXXXXXXXXXXXXXX||--------XXXXXXXXXX||||||---|XXXXXXXXXX----XXXXXXXXXXXXXXXXXXXXX--XXX
