------------------------------------------------------------------------------------------------------------------------------------------------------
------------------------------------------------------------------------------------------------------------------------------------------------------
------------------------------------------------------------------------------------------------------------------------------------------------------
----------------------------------------------------------------------SSSSSSSSSS----------------------------------------SSSSSSSSSS--------------------
----------------------------------------------------------------------------SSSS----------------------------------------------------------------------
-------------------------------------------------------oooo--------------g--SSSS--------oo------------------------------------------------------------
------------------SCS----------------------------------%%%%-------------SS------oo---------SSS!-------------------------------------------------------
---------------------------TT---------------------------||--------------SS--------------------------------TT------------------------------------------
---------------------------TT---------------------------||--------------SS--------------------------------TT-----------y-------------g#---------------
---------------------------XX---------------------SSS---||------1-------SC--g-g--SSS----------------------TT-----------X------------g##---------------
--------------TT---2---TT-------QQQQ--------------------||--------------SS--SSSS---------S----C----------SXXS---------XX------------###---------------
--------------TT-------TT------------K-B--------------U-||-----------------------------------------------------------XXX--SS-------####------------#--
--------------TT-------TT--------------b----------------||------------------------------------------TT--------------XXXX--SS------#####--------K---#--
-M------------TT----k--TT--------------b-------ggg------||-------------------------------------g-g--TT-------------XXXXX--SS------#####------------#--
XXXXXXXXXXXXXXXXXXXXXXXXXXXXXXXXXXXXXXXX-XXXXXXXXX----%%%%%-XXXXXXXXX-XXXXXXXXXX----------XXXXXXXXXXXXXXXXXXXXXXXXXXXXXX--XX--XXXXXXXXX--XXXXXXXX--XXX
XXXXXXXXXXXXXXXXXXXXXXXXXXXXXXXXXXXXXXXX-XXXXXXXXX-----|||--XXXXXXXXX-XXXXXXXXXX----------XXXXXXXXXXXXXXXXXXXXXXXXXXXXXX--XX--XXXXXXXXX--XXXXXXXX--XXX
