------------------------------------------------------------------------------------------------------------------------------------------------------
------------------------------------------------------------------------------------------------------------------------------------------------------
------------------------------------------------------------------------------------------------------------------------------------------------------
--------------------------------oo----------------SSSSSSSSSS------------------------------------------------------------------------------------------
---------------------------------------g--------------SS--SS------------------------------------------------------------------------------------------
-----------------------------------%%%%%--------------SS--SS------------------------------------------------------------------------------------------
------------------SC----------------||||------QQQQ--SS--------USSS--------------------------------------------------------oo---%%%-------##-----------
------------------------------------||||------------SS-----------------------------------------------------------SSS------SS----||-------##-----------
------------------------------------||||------------SS----------------------------TT--------------------------------------------||-----####-----------
------------------------------%%%%%-||||--------k---SS----oo----------------------TT--------------oo----------------------------||-----####-----------
--------------TT---2SS---------|||--||||T-----?QQQ--SSSS--SS-S-----TT-------------TT-----------------------------------------SS-||---######---#LSS----
--------------TT-----K---TT----|||--||||T-------------SS-----------TT-------------TT-----T-----TT-------------------------------||---######---#-------
--------------TT---------TT----|||--||||T-------------SS-----------TT-----------T-TT-----T-----TT---------*---------------------||---######---#-------
-M------------TT---------TT----|||--||||T--------------------ggg---TT-gg--------T-TT---k-T--y--TT---gg----*---------------------||---######-kk#-------
XXXXXXXXXXXXXXXXXXXXXXXXXXXXXX-|||--||||XXXXXXXXXXXXXXXXXXXXXXXXXXXXXXXXXXXXXXXXXXXXXXXXXXXXXXXXXXXXXXXXXXXXX-%%%%----%%%%-----%%%XXXXXXXXXXXXXXXXX---
XXXXXXXXXXXXXXXXXXXXXXXXXXXXXX-|||--||||XXXXXXXXXXXXXXXXXXXXXXXXXXXXXXXXXXXXXXXXXXXXXXXXXXXXXXXXXXXXXXXXXXXXX-|||------||-------||XXXXXXXXXXXXXXXXX---
