------------------------------------------------------------------------------------------------------------------------------------------------------
------------------------------------------------------------------------------------------------------------------------------------------------------
------------------------------------------------------------------------------------------------------------------------------------------------------
----------------------------------------SSSSSSSSSSSSSSSSSSSS-------SSS--------------------------------------------------------------------------------
------------------------------------------------------SS--SS------------------------------------------------------------------------------------------
------------------------------------------------------SS--SS------------------------------------------------------------------------------------------
----------------------!------------------oooo-------SS----------CSS-------SS-------USS----------------------------------SS------------------SS--------
----------------------------------------------------SS------------------------------------------------------------------------------------------------
-----------------g-----------------------SSSS-U-----SS------SS--2-------------------------------------------------------------------------------------
-----------------#----------------------oS--SoS-----SS----oo---2-2---------------------------------------------------------TT-------------------------
----------S-----##--S@S!S--------------TSS--SSS-----SSSS--SS------2---SS-----SS---#-------------------%%%%%%---------------TT---------------SS--------
---------------###---------------------T--------------SS--------------------------#--------------------||||----#--------t--TT---------------------#-TT
--------------####----------tt---------T--------------SS--------------------------##-------------------||||----#--------t--TT--------------------##-TT
-M-----------#####---g------tt--gg-----T--kk--------------------------------------##--gg-----------g---||||----#----ggg-t--TT-----k-------------###-TT
XXXXXXXXXXXXXXXXXXXXXXXXXXXXXXXXXXXXXXXXXXXXXXXXXXXXXXXXXXXX---XXXXXXX------------XXXXXXXX-XXXXXXXXX%%-||||-%%-XXXXXXXXXXXXXXXXXXXXX---XXXXXXXXXXXX-XX
XXXXXXXXXXXXXXXXXXXXXXXXXXXXXXXXXXXXXXXXXXXXXXXXXXXXXXXXXXXX---XXXXXXX------------XXXXXXXX-XXXXXXXXX|--||||--|-XXXXXXXXXXXXXXXXXXXXX---XXXXXXXXXXXX-XX
