------------------------------------------------------------------------------------------------------------------------------------------------------
------------------------------------------------------------------------------------------------------------------------------------------------------
------------------------------------------------------------------------------------------------------------------------------------------------------
------------------------------SSSSSSSSSS------------------------------------------------------------SSSSSSSSSS--------------------SSSSSSSS------------
------------------------------SSSSSSSSSS--------------------------------------------------------------------------------------------------------------
------------------------------SSSSSSSSSS---------------------------------------------------------------------------k----------------------------------
--------------------S---------SSSSSSSSSS-----------------Q-Q------SSoo--------------y-------------------------S---SSSSSS------------------------------
---------------------------TT-----------------------------------------------------#SSS----------------------------------------------------------------
-----------------%%%-------TT----------------------------------------------------##-------------------------------------------------------------------
------------------||-------XX--------------------------------------------1------###1------------------------------------------------------------------
---------Q--------||---TT-----SSSSSSSSSS------tt---------Q-Q%%%%%%----T---------###--------------------------T-------------------------g##------------
-------------%%%%%||---TT-----SSSSSSSSSS------tt-------------||||-----T----TT---###--SSS---------------TT----T-------------------------###------------
--------------|||-||---TT-----SSSSSSSSSS------tt-------------||||-----T----TT---###--------------B-----TT----TTT---------------------g####---------F--
--------------|||-||k--TT-----SSSSSSSSSS-g----tt-------------||||-----T---kTT---###--------------b--g--TT----TTT---------k----ggg----#####---------#--
XXXXXXXXXXX---|||-||XXXXXXXXXXXXXXXXXXXXXXXXXXXXXXXXXXXXXXXX-||||-----XXXXXXXXXXXXXXXX---XXXXXXXXXXXXXXXXXXXXXXXXXXXXX--XXXXXXXXXXXXXXXXXX--XXXXXXXXXX
XXXXXXXXXXX---|||-||XXXXXXXXXXXXXXXXXXXXXXXXXXXXXXXXXXXXXXXX-||||-----XXXXXXXXXXXXXXXX---XXXXXXXXXXXXXXXXXXXXXXXXXXXXX--XXXXXXXXXXXXXXXXXX--XXXXXXXXXX
