------------------------------------------------------------------------------------------------------------------------------------------------------
------------------------------------------------------------------------------------------------------------------------------------------------------
------------------------------------------------------------------------------------------------------------------------------------------------------
----------------------------------------SSSSSSSSSS----------------------------------------------------------------------------------------------------
------------------------------------------------------------------------------------------------------------------------------------------------------
----------------------------------------------------------------------------------------oo--oo--------------------------------------------------------
-----------------------------------------oooo------------------------------1----oo-----------------------------------------------------------------SSS
-------------------------------------------------------------o---o---o--------------------------------------------------------------------------------
-----------------------------------------SSSS-U----------TT-%%%-%%%-%%-----------------------------%-------------------------SSS----------------------
------------Q--?------------------------oS--SoS----TT----TT--|---|---|-----ggg---SS-------------------------------------------------------------------
-------------------S--------------------SS--SSS----TT----XX--|---|---|#########----------SSS----------------------------r------------------#------#---
--------------------------------------tt-----------TT--------|---|---|--------#-----------------------------g--#--------%%%%%%------------##------#---
--------------------------------------tt-----------TT--------|---|---|--------#--------------%%%%-----------TT-#--------|||||------------###------#---
-M----------------K------ggg----------tt--kk-------TT--------|---|-r-|--------#---------------||------------TT-#----ggg-|||||--------y--####-ggg--#---
XXXXXXXXXXXXXXXXXXXXXXXXXXXXXXXXXXXXXXXXXXXXXXXXXXXXXXXXXXXX%%%%%%%%%%--------X---------------||------XXXXXXXX-XXXXXXXXX|||||-----XXXXXXXXXXXXXXXXXXXX
XXXXXXXXXXXXXXXXXXXXXXXXXXXXXXXXXXXXXXXXXXXXXXXXXXXXXXXXXXXX-|||||||||--------X---------------||------XXXXXXXX-XXXXXXXXX|||||-----XXXXXXXXXXXXXXXXXXXX
