------------------------------------------------------------------------------------------------------------------------------------------------------
------------------------------------------------------------------------------------------------------------------------------------------------------
------------------------------------------------------------------------------------------------------------------------------------------------------
S-----SSSS--------------------------------------------------------------------------------------------------------------------------------------U-----
S-----------------------------------------------------------------------------------------------------------------------------------------------------
S--------------------------------------------------------------------R----------------------oo--------------------------------------------------------
S-------------------USS--------------------------------------------------------------1----------------------------------------------------------------
S-------------------------------------------------------------------------------------------------------------------------------------------------SS--
S--------------------------------------------------------------------------------------------------%--------------------------SSS---------------------
S---------------------------------------------------------------------------------------------------------------------------------------------SS------
S----------------------------------------------------------------%%%---------------QQQQ---SS----------------------------%------------------#---------#
S--------------------B----------------K-------------K-------------|-----------------------------------------------------------------------##--------##
S--------------------b-------BTTTT--------------------------------|--------------------------%%%%---------*------------------------------###-------###
S--M------k---ggg----B-------bTTTT----------y-y------------g------|-----------------yy--------||----gg----*----k----kkk----------r---y--####------####
XXXXXXXXXXXXXXXXXXXXXXXXXXXXXXXXXXXXXXXXXXXXXXXXXXXXXXXXXXXX%%%%%-|---X----XXXXXXXXXXXXXXX----||----XXXXXXXXX-XXXXXXXXXX----XXXXXXXXXXXXXXXXXXXXX-XXXX
XXXXXXXXXXXXXXXXXXXXXXXXXXXXXXXXXXXXXXXXXXXXXXXXXXXXXXXXXXXX-|||--|---X----XXXXXXXXXXXXXXX----||----XXXXXXXXX-XXXXXXXXXX----XXXXXXXXXXXXXXXXXXXXX-XXXX
