------------------------------------------------------------------------------------------------------------------------------------------------------
------------------------------------------------------------------------------------------------------------------------------------------------------
------------------------------------------------------------------------------------------------------------------------------------------------------
S-----SSSS--------------------------------------------------------------------------------------------------------------SSS-----SS--------------------
S-----------------------------------------------------------------------------------------------------------------------------------------------------
S-------------------------------------------------------------g-------------------------oo--oo--------------------------------------------------k-----
S-------------------------------------------------------------SSSSS-------------oo----------------------------?SSS------US---------------------SQS--SQ
S-------------------------------o----ooo--------------------------------------------------------------------------------------------------------------
S--------------------------------------------------------------------------------------------------%------------------------SSS-----------------------
S--------------------------------------------------------------------------------SS-------------------------------------------------------------------
S------------------%------------------%%-------------------------------------------------SS-------------------SSSSS-----SSS----------------#---SQS--S?
S--------------------------------------|------------K-------------------------------------------------TT----------------------------------##----------
S--------------------------------------|----------------------TT-----t-----------------------%%%%-----TT----TT---------------------------###----------
S------------%%%%--------ggg---%%%%%%%-|-------------------g--TT-----tgg----------------------||------TT-k--TT--K--------------------y--####-k------gg
XXXXXXXXXXX---||----XXXXXXXXXX--|||||--|X-XX-XX-XXXXXXXXXXXXXXXXXXXXXXXXXXXXXXXX--------------||----XXXXXXXXXXXXXXXXXXXXXXX------XXXXXXXXXXXXXXXXXXXXX
XXXXXXXXXXX---||----XXXXXXXXXX--|||||--|X-XX-XX-XXXXXXXXXXXXXXXXXXXXXXXXXXXXXXXX--------------||----XXXXXXXXXXXXXXXXXXXXXXX------XXXXXXXXXXXXXXXXXXXXX
