------------------------------------------------------------------------------------------------------------------------------------------------------
------------------------------------------------------------------------------------------------------------------------------------------------------
------------------------------------------------------------------------------------------------------------------------------------------------------
----------SSSSSSSSSS--------------------------------------------------SSSSSSSSSS----------------------------------------------------------------------
------------------------------------------------------------------------------------------------------------------------------------------------------
---------------------------------------------------------------------R----------K-------------------oo------------------------------------------------
--------------------------------------------------------------------------------SS----1----SSS!-----%%%---------------------------SS------------------
------------------------------------------------------------------------------TT--------------------||--o----R----------------------------------------
------------------------------------------------------------------------------TT--------------------||-%%%--------------------------------------------
------------------------------------------------------------------------------TT--------------------||--|---------------SS-?Q-------------------------
--------------------SS-----------------T-TT---SU---------tt------%%%--------SCTTSS------------C-----||--|-------------------------SS------------------
---------------------K---TT------------T-TT--------------tt-------|-----TT----TT------TT------------||-o|-------------------------K---#----B----------
-------------------------TT------------T-TT--------------tt-------|-----TT----TT------TT------------||%%%%%--------B-----------y------#----b-------F--
-M-----------------------TT-----gg-----T-TT------k---g-g-tt-------|-----TT---kTT------TT-------g-g--||-|||---------b-------SSSSS------#----B-------#--
XXXXXXXXXXX--XX--X--XXXXXXXXXXXXXXXXXXXXXXXXXXXXXXXXXXXXXXXX%%%%%-|---XXXXXXXXXXXXXXXXXXXXXXXXXXXXXX||-|||----XXXXXXXXXX-------XX-XXXXXXXXXXXXXXXXXXXX
XXXXXXXXXXX--XX--X--XXXXXXXXXXXXXXXXXXXXXXXXXXXXXXXXXXXXXXXX-|||--|---XXXXXXXXXXXXXXXXXXXXXXXXXXXXXX||-|||----XXXXXXXXXX-------XX-XXXXXXXXXXXXXXXXXXXX
