------------------------------------------------------------------------------------------------------------------------------------------------------
------------------------------------------------------------------------------------------------------------------------------------------------------
------------------------------------------------------------------------------------------------------------------------------------------------------
----------SSSSSSSSSS--------------------SSSSSSSSSSSSSSSSS---------------------------------------------------------------SSS-----SS--------------------
----------------------------------------SSSSSSSS------------------------------------------------------------------------------------------------------
----------------------------------------SSSCSSSS--------------------------------K---------------------------------------------------------------------
----------------------!-----------------SSSSSSSS--QQ----------USSS--------SS----SS----1----------------------------oo---US----------------------------
----------------------------------------------------------------------------------------------------------------------------------oo------------------
-----------------------------------------------------------S----------------------------------------------------------------SSS-----------------------
-------------------------------------------ggg-------------------------------------------------oooo---------------------------------------------------
-----SSS--@QQQQ-----S@S!S---------------SSSSSSSS--QQ--QQQ----S-----TT-SS-----SS-SS-----------------------------%%%%--%%%SSS----------------Q----------
---------------------------------------TSSSSSSSS-------------------TT-----------------TT------------------------||----||---------------------------#--
-----------------g-#--------tt---------TSSSSSSSS-------------------TT-----------------TT------------------*-----||----||-----------------------K---#--
----------------g#-#-g------tt-------kkTSSSSSSSS-------------ggg---TT-----------------TT------------gg----*---o-||----||---------------------------#--
XXXXXXXXXXXXXXXXXXXXXXXXXXXXXXXXXXXXXXXXXXXXXXXXXXXXXXXXX---XXXXXXXXXX----------XXXXXXXXXX%%%%%%%-%%XXXXXXXXX-%-||----||XXX------XXXXXXXXXXXXXXXX--XXX
XXXXXXXXXXXXXXXXXXXXXXXXXXXXXXXXXXXXXXXXXXXXXXXXXXXXXXXXX---XXXXXXXXXX----------XXXXXXXXXX||||||---|XXXXXXXXX---||----||XXX------XXXXXXXXXXXXXXXX--XXX
