------------------------------------------------------------------------------------------------------------------------------------------------------
------------------------------------------------------------------------------------------------------------------------------------------------------
------------------------------------------------------------------------------------------------------------------------------------------------------
------------------------------------------------------------------------------------------------------------------------------------------------------
------------------------------------------------------------------------------------------------------------------------------------------------------
----------------------------------------------------------------------------------------oo------------------------------------------------------------
--------------------------------------------------------------USSS----------SSSSoo----------------------------------------SSC----------------QQQQ-----
--------------------------------------------------------------------------------------------------oo------TT------------------------------------------
---------------------------------------------------------TT-----------------------------------------------TT------------------------------------------
---------------------------------------------------TT----TT------------------K---SS-----------------------TT--------------SSS------------------y------
-------------------%--------TT--QQQQ---------------TT----XX--S-----TT------SSSSS---------S---------------SXXS-------------------------------Q?SSQQQ---
----------------------------TT-------K-B-----K---B-TT--------------TT-T-------------------------#--------------#---------------------TT---------------
----------------------------TT---------b---------b-TT--------------TT-T-------------------------#---TT---------#---------------------TT---------------
-M-----------%%%%-------ggg-TT---------b---------B-TT--------ggg---TT-T-------------------------#---TT---------#----ggg----------#---TT---------------
XXXXXXXXXXX---||----XXXXXXXXXXXXXXXXXXXXXXXXXXXXXXXXXXXXXXXXXXXXXXXXXXXXXXXXXXXX----------XXXXXXXXXXXXXXXXXXXX-XXXXXXXXXX----XXXXXXXXXXXXXXXXX--XXXXXX
XXXXXXXXXXX---||----XXXXXXXXXXXXXXXXXXXXXXXXXXXXXXXXXXXXXXXXXXXXXXXXXXXXXXXXXXXX----------XXXXXXXXXXXXXXXXXXXX-XXXXXXXXXX----XXXXXXXXXXXXXXXXX--XXXXXX
