------------------------------------------------------------------------------------------------------------------------------------------------------
------------------------------------------------------------------------------------------------------------------------------------------------------
------------------------------------------------------------------------------------------------------------------------------------------------------
S-----SSSS--------------------SSSSSSSSSS----------SSSSSSSSSS-------SSS--------------------SSSSSSSSSS--------------------------------------------------
S-----------------------------SSSSSSSSSS--------------SS--SS------------------------------------------------------------------------------------------
S---------------------ooor----SSSSSSSSSS--------------SS--SS--------------------K---------------------------------------------------------------------
S--------------------%%%%%----SSSSSSSSSS------------SS----------CSS-----SSSSS---SS----1----------------------------------SSS----S!-----------QQQQ-----
S---------------------|||---------------------------SS------------------------------------------------------------------------------------------------
S---------------------|||---------------------------SS------SS--2-------------------------------------------------------------------------------------
S---------------------|||---------------------------SS----oo---2-2-----------------------------------------------------------------------------y------
S---------Q---------%%%%%%%---SSSSSSSSSS------------SSSS--SS------2----------2--SS--------------------%%%%%%----------r----------S----------Q?SSQQQ---
S-------------------||||||----SSSSSSSSSS--------------SS-------------------TT---------TT---------------||||-------%%%%%%------------------------------
S-------------------||||||--o-SSSSSSSSSS--------------SS--------------t----TT--T------TT---------------||||--------|||||------------------------------
S--M---------------#||||||-%%%SSSSSSSSSS----y-y-----------------------t----TT--T------TT--------g-g----||||--------|||||----gg-g-gk-------------------
XXXXXXXXXXXXX--XXXXX||||||--|-XXXXXXXXXXXXXXXXXXXXXXXXXXXXXX---XXXXXXXXXXXXXXXXXXXXXXXXXXXXXXXXXXXXX%%-||||-%%-%%%-|||||XXXXXXXXXXXX---XXXXXXX--XXXXXX
XXXXXXXXXXXXX--XXXXX||||||--|-XXXXXXXXXXXXXXXXXXXXXXXXXXXXXX---XXXXXXXXXXXXXXXXXXXXXXXXXXXXXXXXXXXXX|--||||--|--|--|||||XXXXXXXXXXXX---XXXXXXX--XXXXXX
