------------------------------------------------------------------------------------------------------------------------------------------------------
------------------------------------------------------------------------------------------------------------------------------------------------------
------------------------------------------------------------------------------------------------------------------------------------------------------
------------------------------------------------------------------------------------------------------------------------------------------------U-----
--------------------------------------------?-----?---------------------------------------------------------------------------------------------------
-----------------------SSS----------------------------------------------------------------------------------------------------------------------------
------------------------------------------------------------------SSoo-------------USS----------------------------------------------------------------
---------------------g------------------------r---SS------------------------------------------------------TT----------------------oo--------------SS--
-----------------%%%%%%-------------------%%%%%%----------------------------------------------------------TT------------------------------------------
------------------||||----SSS--------------||||--------------------------1--------------------------------TT----------------------------------SS------
------------------||||----------QQQQ----%%-||||ooo----------%%%%%%----T-----------#----------------------SXXS---!-----S--------------------Q---------#
-------------%%%%%||||---------------K-B|--||||--r-----SSS---||||-----T----TT-----#-----------------------------------------------------------------##
--------------|||-||||-----------------b|%%%%%%%%%-----------||||-----T----TT-----##----------------TT---------------------------------------------###
-M------------|||-||||----oo-----------b|-||||||||-----------||||-----T---kTT-----##--gg-----------gTT--------------------kkk---------------------####
XXXXXXXXXXX---|||-||||---%%%--XXXXXXXXXX|-||||||||-----------||||-----XXXXXXXXXX--XXXXXXXX-XXXXXXXXXXXXXXXXXXXXXXXXXXXXXXXXXXXXXXXXXXXXXXXXXXXXXX-XXXX
XXXXXXXXXXX---|||-||||----|---XXXXXXXXXX|-||||||||-----------||||-----XXXXXXXXXX--XXXXXXXX-XXXXXXXXXXXXXXXXXXXXXXXXXXXXXXXXXXXXXXXXXXXXXXXXXXXXXX-XXXX
