------------------------------------------------------------------------------------------------------------------------------------------------------
------------------------------------------------------------------------------------------------------------------------------------------------------
------------------------------------------------------------------------------------------------------------------------------------------------------
----------------------------------------SSSSSSSSSS----------SSSSSSSSSS--------------------------------------------------------------------------------
----------------------------------------SSSSSSSS------------SSSS--SSSS--------------------------------------------------------------------------------
----------------------ooor--------------SSSCSSSS-------oooo-SSSS--SSSS------------g-------------------------------------------------------------------
---------------------%%%%%----S---------SSSSSSSS-------%%%%---SS---S-------g----SSSSSSSS----------------------------------oo---%%%SS------------------
----------------------|||-------------------------SSSS--||----SS---S---%%%%%%---------------------------------------------SS----||-------------y------
----------------------|||-------------------------------||----SS---S----||||----------------------------------------------------||-----------#SS--o---
----------------------|||------------------ggg----------||--ooSS---SoU--||||----------------------------------------------------||----------##--------
---------Q----------%%%%%%%---##--SSC---SSSSSSSS--------||--SSSS---SSS--||||--------------------TT----%%%%%%-----------------SS-||SS--------##--SC----
--------------------||||||--------------SSSSSSSS------U-||--------------||||--------------------TT-----||||---------------------||K---#----B##--------
--------------------||||||--o-----------SSSSSSSS--------||--------------||||--------------------TT-----||||--------B------------||----#----b##---SSS--
--------------k-ggg-||||||-%%%----------SSSSSSSS--------||--k--g-g------||||----------------k---TT-----||||--------b------------||----#----B##--------
XXXXXXXXXXXXXXXXXXXX||||||--|-XX--XXXXXXXXXXXXXXXX----%%%%%-XXXXXXXXXX--||||----XXXXXX---XXXXXXXXXXX%%-||||-%%XXXXXXXXXX%%-----%%%XXXXXXXXXXXX------XX
XXXXXXXXXXXXXXXXXXXX||||||--|-XX--XXXXXXXXXXXXXXXX-----|||--XXXXXXXXXX--||||----XXXXXX---XXXXXXXXXXX|--||||--|XXXXXXXXXX|-------||XXXXXXXXXXXX------XX
