------------------------------------------------------------------------------------------------------------------------------------------------------
------------------------------------------------------------------------------------------------------------------------------------------------------
------------------------------------------------------------------------------------------------------------------------------------------------------
----------SSSSSSSSSS------------oo------------------------------------------------------------------------------------------------SSSSSSSSSS----U-----
-------------------------------------g-g---------------------------------o----------------------------------------------------------------------------
-----------------------------------%%%%%--------------------------------%%%---------------------------------------------------------------------------
--------------------USS-------------||||---------------------------------|--o--------SUS----------------------?SSS------------------------------------
------------------------------------||||---------------------------------|--SSSS------------------oo----------------------------------------------SS--
------------------------------------||||-----------------------------o%--|----------------------------------------------------SSS---------------------
------------------------------%%%%%-||||-----------------o-------y-------|--------------------------------------------------------------------SS------
-------------------------------|||--||||------tt-----------------##------|----------#####-------------%%%%%%--SSSSS-----%----------------------------#
---------------------B---------|||--||||------tt----------------###------|----------#-----------#------||||-------------------------------TT--------##
---------------------b-------B-|||--||||------tt---------------####------|-----%---K#-----------#------||||------------------------tt-----TT-------###
---M-----------------B-------b-|||--||||-g----tt----k---------#####------|----------#-----------#------||||-----K----------------r-tt----kTT------####
XXXXXXXXXXX--XX--X--XXXXXXXXXX-|||--||||XXXXXXXXXX-XXXXXXXXXXXXXXXX---%%%%%%----XXXXXXX---XXXXXXXXXX%%-||||-%%XXXXXXXXXX----XXXXXXXXXXXXXXXXXXXXX-XXXX
XXXXXXXXXXX--XX--X--XXXXXXXXXX-|||--||||XXXXXXXXXX-XXXXXXXXXXXXXXXX---|||||-----XXXXXXX---XXXXXXXXXX|--||||--|XXXXXXXXXX----XXXXXXXXXXXXXXXXXXXXX-XXXX
