------------------------------------------------------------------------------------------------------------------------------------------------------
------------------------------------------------------------------------------------------------------------------------------------------------------
------------------------------------------------------------------------------------------------------------------------------------------------------
------------------------------------------------------------------------------------------------------------------------------------------------------
------------------------------------------------------------------------------------------------------------------------------------------------------
-----------------------SSS------------oo------------------------------------------------------------oo------------------------------------------------
-----------------------------------SSSS---------------------------SSoo-----1------------------------%%%-------?SSS-----------------------##-----------
---------------------g------------------------------------------------------------------------------||--o----R---------------------------##-----------
--------------------%%%-----------------------------------------------------------------------------||-%%%-------------------SSS-------####-----------
--------------------||----SSS----------------------------------------------ggg----o-----------------||--|------------------------------####-----------
----------Q---------||--------%-----------------------S-----%%%%%%----#########--------TT--------tt-||--|-----SSSSS-----r------------######-----------
--------------------||------------------T-----TT--TT---------||||-------------#--------TT-T------tt-||-o|---------------%%%%%%-------######-----------
--------------------||------------------T-----TT--TT---------||||-------------#--------TT-T------tt-||%%%%%-------------|||||--------######--------F--
-M-----------------#||----oo------------T-----TT--TT------k--||||-------------#--------TT-T------tt-||-|||------K-------|||||--------######--------#--
XXXXXXXXXXXXX--XXXXX||---%%%----%%%%--%%XXXX--XXXXXXXXXXXXXX-||||-------------X-XXXXXXXXXXXXXXXXXXXX||-|||----XXXXXXXXXX|||||-----XXXXXXXXXXXXXXXXXXXX
XXXXXXXXXXXXX--XXXXX||----|------||----|XXXX--XXXXXXXXXXXXXX-||||-------------X-XXXXXXXXXXXXXXXXXXXX||-|||----XXXXXXXXXX|||||-----XXXXXXXXXXXXXXXXXXXX
