------------------------------------------------------------------------------------------------------------------------------------------------------
------------------------------------------------------------------------------------------------------------------------------------------------------
------------------------------------------------------------------------------------------------------------------------------------------------------
------------------------------------------------------------------------------------------SSSSSSSSSSSSSSSSSSSS----------------------------------------
------------------------------------------------------------------------------------------------------------------------------------------------------
----------------------------------------%%-------------oooo---------------------K---------------------------------------------------------------------
----------------------------------------|--------------%%%%---------------SSCSS-SS----1--------------------------------------------------##-SS--------
----------------------------------------|----oo---SSSS--||---o---o---o------------------------------------------oooo---------------------##-----------
----------------------------------------|---------------||--%%%-%%%-%%-----------------------------------------------------------------####-----------
----------------------------------------|---------------||---|---|---|-----------------------------------------------------------------####-----------
----------------------------TT----------|---------------||---|---|---|--QQQQ--QQSS-------------------------TT-T----------------------######-SS--------
-----------------K----------TT--------K-|-------------U-||---|---|---|----------------TT--t-------------#--TT-T----------------------######-------#-TT
------------B---------------TTTTTT------|---------------||---|---|---|----------------TT--t------------##--TT-T----------------------######------##-TT
-M----------b-----------ggg-TTTTTT------|---------------||---|---|-r-|----------------TT--t---------kk-##--TT-T---y------k----ggg----######-----###-TT
XXXXXXXXXXXXXXXXXXXXXXXXXXXXXXXXXXXXXXXX|----%%%%-----%%%%%-%%%%%%%%%%XXXXXXXXXXXXXXXXXXXXXXXXXXXXXXXXXXX--XX-XXXXXXXXXXXXXXXXXXXXXXXXXXXXXXXXXXXXX-XX
XXXXXXXXXXXXXXXXXXXXXXXXXXXXXXXXXXXXXXXX|-----||-------|||---|||||||||XXXXXXXXXXXXXXXXXXXXXXXXXXXXXXXXXXX--XX-XXXXXXXXXXXXXXXXXXXXXXXXXXXXXXXXXXXXX-XX
