------------------------------------------------------------------------------------------------------------------------------------------------------
------------------------------------------------------------------------------------------------------------------------------------------------------
------------------------------------------------------------------------------------------------------------------------------------------------------
--------------------------------oo--------------------------SSSSSSSSSS------------------------------------------------------------SSSSSSSS------------
-------------------------------------g-g----?---------------SSSS--SSSS---o----------------------------------------------------------------------------
-----------------------SSS---------%%%%%---------------oooo-SSSS--SSSS--%%%-----------------oo--------------------------------------------------------
------------------------------------||||---------------%%%%---SS---S-----|--o------USS-----------------------R-----oo---SSS---------------------------
---------------------g--------------||||------r---SSSS--||----SS---S-----|--SSSS---------------------r------------------------------------------------
--------------------%%%-------------||||--%%%%%%--------||----SS---S--%--|-------------------------%%%%%%%%-------------------------------------------
--------------------||----SSS-%%%%%-||||---||||---------||--ooSS---SoU---|--------------------------||||||--------------------------------------------
-------------------%||---------|||--||||%%-||||ooo------||--SSSS---SSS---|--------#-------S---------||||||-----%%%%--%%%---------------g##----#LSS----
--------------------||---------|||--|||||--||||--r----U-||---------------|--------#-----------------||||||------||----||---------------###----#-------
--------------------||---------|||--|||||%%%%%%%%%------||---------------|-----%--##---------%%%%---||||||------||----||------TT-----g####----#-------
---M---------%%%%---||----oo---|||--|||||-||||||||------||--k--g-g-------|--------##--gg------||----||||||--ooo-||----||------TT-----#####--kk#-------
XXXXXXXXXXX---||----||---%%%---|||--|||||-||||||||----%%%%%-XXXXXXXXXX%%%%%%------XXXXXXXX----||----||||||--%%%-||----||----XXXXXXXXXXXXXX--XXXXXXX---
XXXXXXXXXXX---||----||----|----|||--|||||-||||||||-----|||--XXXXXXXXXX|||||-------XXXXXXXX----||----||||||---|--||----||----XXXXXXXXXXXXXX--XXXXXXX---
