------------------------------------------------------------------------------------------------------------------------------------------------------
------------------------------------------------------------------------------------------------------------------------------------------------------
------------------------------------------------------------------------------------------------------------------------------------------------------
--------------------------------------------------------------------------------SSSSSSSSSL------------------------------------------------------------
------------------------------------------------------------------------------------------------------------------------------------------------------
--------------------------------------------------------------------------------------------oo--------------------------------------------------------
------------------SC---------U--------------------------------USSS--------SSCSS-----oooooo-------------------@-----------SSS----S!-------##-----------
-----------------------------------------------------------------------------------------------------------------SSS---------------------##----y------
------------------------------------------------------------------------------------SSSSSS---------%-----------------------------------####--#SS--o---
------------------------------------------------------------------------------------SSSSSS---------------------------------------------####-##--------
--------------TT---2--------##-----------TT---SU------S------S-----TT---QQQQ--QQ----------SS--------SU----!--!-------------------S---######-##--SC----
--------------TT-------y-#####-----------TT-------TT---------------TT----------------------------------------------------------------######-##--------
--------------TT----y-######-------------TT-------TT---------------TT------------------------%%%%------------------------------------######-##---SSS--
-M------------TT----######--------k-k----TT------kTT------k--ggg---TT-------------------------||----------k-----------------gg-g-g---######-##--------
XXXXXXXXXXXXXXXXXXXXXXXX------XXXXXXXXX-XXXXXXXXXXXXXXXXXXXXXXXXXXXXXXXXXXXXXXXX---XXXXXXX----||----XXXXXXXXXX%%%%----%%XXXXXXXXXXXXXXXXXXXXXX------XX
XXXXXXXXXXXXXXXXXXXXXXXX------XXXXXXXXX-XXXXXXXXXXXXXXXXXXXXXXXXXXXXXXXXXXXXXXXX---XXXXXXX----||----XXXXXXXXXX|||------|XXXXXXXXXXXXXXXXXXXXXX------XX
