------------------------------------------------------------------------------------------------------------------------------------------------------
------------------------------------------------------------------------------------------------------------------------------------------------------
------------------------------------------------------------------------------------------------------------------------------------------------------
S-----SSSS------------------------------------------------------------SSSSSSSSSS----------SSSSSSSSSSSSSSSSSSSS----------------------------------U-----
S-------------------------------------------?---------------------------------------------------------------------------------------------------------
S-------------------------------------------------------------------------------K---------------------------------------------------------------------
S--------------------------------------------------------Q-Q--------------------SS----1-------------------------------------------SS------------------
S---------------------------------------------r-------------------------------TT------------------------------------------------------------------SS--
S-----------------------------------------%%%%%%------------------------------TT---------------------------------------y------------------------------
S------------------------------------------||||-------------------------------TT---------------------------------------X----------------------SS------
S---------------------------TT----------%%-||||ooo-------Q-Q----------------SCTTSS-------------------------TT---------XX----------SS-----------------#
S---------------------------TT----------|--||||--r----------------------TT----TT------TT--t-------------#--TT--------XXX----------K---#----B--------##
S---------------------------TT----------|%%%%%%%%%----------------------TT----TT------TT--t------------##--TT-------XXXX--------------#----b-------###
S---------k---ggg-------ggg-TT----k-k---|-||||||||-----------y----------TT---kTT------TT--t---------kk-##--TT------XXXXX-k----ggg-----#----B------####
XXXXXXXXXXXXXXXXXXXXXXXXXXXXXXXXXXXXXXX-|-||||||||XXXXXXXXXXXXXXXXXXXXXXXXXXXXXXXXXXXXXXXXXXXXXXXXXXXXXXX--XX-XXXXXXXXXXXXXXXXXXXXXXXXXXXXXXXXXXX-XXXX
XXXXXXXXXXXXXXXXXXXXXXXXXXXXXXXXXXXXXXX-|-||||||||XXXXXXXXXXXXXXXXXXXXXXXXXXXXXXXXXXXXXXXXXXXXXXXXXXXXXXX--XX-XXXXXXXXXXXXXXXXXXXXXXXXXXXXXXXXXXX-XXXX
