------------------------------------------------------------------------------------------------------------------------------------------------------
------------------------------------------------------------------------------------------------------------------------------------------------------
------------------------------------------------------------------------------------------------------------------------------------------------------
--------------------SSSSSSSSSS--oo----------------------------------------------------------------------------SS-------S------------------------------
--------------------SSSSSSSSSS-------g-g--------------------------------------------------------------------------------------------------------------
--------------------SSSSSSSSSS-----%%%%%----------------------g---------------------------------------------------------------------------------------
--------------------SSSSSSSSSS------||||----------------------SSSSS-----SSSSS------o--o-------------------2------------SSSS--------------##-----------
------------------------------------||||-------------------------------------------------------------------------------------------------##-----------
-----------------g------------------||||---------------------------------------------------------------------------SSS-----------------####-----------
-----------------#------------%%%%%-||||-------------------------------------------SSSS-------------o----------------------------------####-----------
---------QS-----##----SSSSSS?--|||--||||--------------S----------------------2----------------------------2------------S-------------######-----------
---------------###----SSSSS----|||--||||----------TT-----------------------TT----------------------------------##--------------------######-----------
--------------####----SSSSS----|||--||||----------TT----------TT-----tt----TT--T%%%--------------B-------------##-------------TT-----######--------F--
-M-----------#####---------ooo-|||--||||-------y--TT------k---TT-----tt----TT--T||---------------b------y--y---##-------------TT-----######--------#--
XXXXXXXXXXXXXXXXXXXX-XXXXXXXXX-|||--||||XXXXXXXXXXXXXXXXXXXXXXXXXXXXXXXXXXXXXXXX||--------XXXXXXXXXXXXXXXXXXXX-XX------X----XXXXXXXXXXXXXXXXXXXXXXXXXX
XXXXXXXXXXXXXXXXXXXX-XXXXXXXXX-|||--||||XXXXXXXXXXXXXXXXXXXXXXXXXXXXXXXXXXXXXXXX||--------XXXXXXXXXXXXXXXXXXXX-XX------X----XXXXXXXXXXXXXXXXXXXXXXXXXX
