------------------------------------------------------------------------------------------------------------------------------------------------------
------------------------------------------------------------------------------------------------------------------------------------------------------
------------------------------------------------------------------------------------------------------------------------------------------------------
--------------------------------------------------SSSSSSS-----------------------ooo-------------------------------------------------------------------
--------------------------------------------------------------------------------%%%-------------------------------------------------------------------
----------------------ooor------------oo-----------------------------------------|----------oo--------oo----------------------------------------------
---------------------%%%%%---------SSSS-----------QQ----------------------SS-----|----------------------------?SSS------SS--------SS------------------
----------------------|||--------------------------------------------------------|-------------------------------------------------------------y------
----------------------|||----------------------------------S---------------------|-----------------%-----------------------------------------#SS--o---
----------------------|||--------------------------------------------------------|---%%%%----------------------------------TT---------------##--------
---------Q------%%%%%%%%%%%---%----------TT---SU--QQ--QQQ-------------SS-----SS--|----||--S-------------------SSSSS--------TT-----SS--------##--SC----
-----------------||-||||||---------------TT--------------------------T----------%%%%%%||--------------------------------t--TT-----K---#----B##--------
-----------------||-||||||--o------------TT------------------B-------T-----------||||-||-----%%%%-----------tt----------t--TT---------#----b##---SSS--
-----------------||-||||||-%%%-----------TT------k-----------b-------T-----------||||-||------||------ggg---tt--K-------t--TT---------#----B##--------
XXXXXXXXXXX--%%%%||%||||||--|---%%%%--%%XXXXXXXXXXXXXXXXX---XXXXXX--XX-----------||||-||%%----||----XXXXXXXXXXXXXXXXXXXXXXXXXXXXXXXXXXXXXXXXXX------XX
XXXXXXXXXXX---||-||-||||||--|----||----|XXXXXXXXXXXXXXXXX---XXXXXX--XX-----------||||-||-|----||----XXXXXXXXXXXXXXXXXXXXXXXXXXXXXXXXXXXXXXXXXX------XX
