------------------------------------------------------------------------------------------------------------------------------------------------------
------------------------------------------------------------------------------------------------------------------------------------------------------
------------------------------------------------------------------------------------------------------------------------------------------------------
--------------------SSSSSSSSSS------------------------------------------------------------SSSSSSSSSS--------------------------------------------------
--------------------SSSSSSSSSS-----------------------------------------------------------------------------------------------------------------------o
--------------------SSSSSSSSSS------------------------------------------------------------------------------------------------------------------------
--------------------SSSSSSSSSS-------------------------------------------------------SUS------------------------------------------SS------------------
------------------------------------------------------------------------------------------------------------------------------------------------SSS---
---------------------------------------------------------B------------o------------------------------------------------------SSS------------oo--------
---------------------------------------------------------b------1-------------------------------------------------------------------------------------
----------------%%%%--SSSSSS?--------------------------SS#CS------------------------#####-----------------------!-----S-r---------SS--------SS--------
-----------------||---SSSSS---------------------------------------------------#-----#-----------------TT----------------%%%%%%----K---#----B----------
-----------------||---SSSSS--------------------------------K-----------------##----K#-----------------TT----TT----------|||||---------#----b----------
-M---------------||--------ooo----k-k-------y-y-------------------------------------#-----------g-g---TT-k--TT----------|||||---------#----B----------
XXXXXXXXXXX--%%%%||%-XXXXXXXXXXXXXXXXXX-XXXXXXXXXXXXXXXXXXXXXXXXXXXXX-XXXXXXXXXXXXXXXXX---XXXXXXXXXXXXXXXXXXXXXXXXXXXXXX|||||-----XXXXXXXXXX----------
XXXXXXXXXXX---||-||--XXXXXXXXXXXXXXXXXX-XXXXXXXXXXXXXXXXXXXXXXXXXXXXX-XXXXXXXXXXXXXXXXX---XXXXXXXXXXXXXXXXXXXXXXXXXXXXXX|||||-----XXXXXXXXXX----------
