------------------------------------------------------------------------------------------------------------------------------------------------------
------------------------------------------------------------------------------------------------------------------------------------------------------
------------------------------------------------------------------------------------------------------------------------------------------------------
----------------------------------------SSSSSSSSSS----------SSSSSSSSSS----------------------------------------SSSSSSSSSSSSS-----SS--------------------
----------------------------------------SSSSSSSS------------SSSS--SSSS--------------------------------------------------------------------------------
----------------------------------------SSSCSSSS------------SSSS--SSSS----------------------oo--------------------------------------------------------
----------------------!-----------------SSSSSSSS--------------SS---S------SSCSS------1--------------------2-------------US----------------------------
--------------------------------------------------------------SS---S----------------------------------------------------------------------------------
--------------------------------------------------------------SS---S-------------------------------%------------------------SSS-----------------------
-------------------------------------------ggg--------------ooSS---SoU------------------------------o-------------------------------------------------
---------Q----------S@S!S---------------SSSSSSSS-------ooo--SSSS---SSS--QQQQ--QQ---QQQQ---S---------------2---T---------SSS---------------------------
-----------------K--------------------K-SSSSSSSS--------------------------------------------------------------T------------------------------------#--
------------B---------------ttTTTT------SSSSSSSS---------------------------------------------%%%%-------------T----TT--------------------------K---#--
-M----------b--------g------ttTTTT------SSSSSSSS------------k--g-g------------------yy--------||--------y--y--T--g-TT------------------------------#--
XXXXXXXXXXXXXXXXXXXXXXXXXXXXXXXXXXXXXXXXXXXXXXXXXX--XXXXXXXXXXXXXXXXXXXXXXXXXXXXXXXXXXXXXX----||----XXXXXXXXXXXXXXXXXXXXXXX------XXXXXXXXXXXXXXXX--XXX
XXXXXXXXXXXXXXXXXXXXXXXXXXXXXXXXXXXXXXXXXXXXXXXXXX--XXXXXXXXXXXXXXXXXXXXXXXXXXXXXXXXXXXXXX----||----XXXXXXXXXXXXXXXXXXXXXXX------XXXXXXXXXXXXXXXX--XXX
