------------------------------------------------------------------------------------------------------------------------------------------------------
------------------------------------------------------------------------------------------------------------------------------------------------------
------------------------------------------------------------------------------------------------------------------------------------------------------
----------SSSSSSSSSS----------SSSSSSSSSS------------------------------SSSSSSSSSS----------------------------------------------------------------------
--------------------------------------------?---------------------------------------------------------------------------------------------------------
------------------------------------------------------------------------------------------------------------------------------------------------------
-----------------------------U-------------------------------------------------------SUS---------------------R-------------------------US-------------
----------------------------------------------r-------------------------------TT-------------------------r-------SSS----------------------------------
---------------------------------------S--%%%%%%---------TT----------o--------TT--------------------%%%%%%%-------------------------------------------
---------------------------------------S---||||----TT----TT------y------------TT----------------g---||||||---------------------------SS---------------
----------@QQQQ-------------##---------S%%-||||ooo-TT----XX------##---------SCTT----#####-------TT--||||||---------------------------------S#---------
-----------------------y-#####-#--------|--||||--r-TT-----------###-----TT----TT----#-----------TT--||||||----------------------------------##--------
-----------------g-#y-######---#-#------|%%%%%%%%%-TT----------####-----TT----TT---K#-----------TT--||||||------------------------TT--------###------#
-M--------------g#-#######-----#-#------|-||||||||-TT---------#####-----TT---kTT----#-----------TT--||||||--oo-----------k----ggg-TT--------####----##
XXXXXXXXXXXXXXXXXXXXXXXX------XXXXXXXXXX|-||||||||XXXXXXXXXXXXXXXXX---XXXXXXXXXXXXXXXXX---XXXXXXXXX-||||||--%%%%%%----%%XXXXXXXXXXXXXXXX-X-XXXXXXXXXXX
XXXXXXXXXXXXXXXXXXXXXXXX------XXXXXXXXXX|-||||||||XXXXXXXXXXXXXXXXX---XXXXXXXXXXXXXXXXX---XXXXXXXXX-||||||---||||------|XXXXXXXXXXXXXXXX-X-XXXXXXXXXXX
