------------------------------------------------------------------------------------------------------------------------------------------------------
------------------------------------------------------------------------------------------------------------------------------------------------------
------------------------------------------------------------------------------------------------------------------------------------------------------
--------------------------------------------------------------------------------SSSSSSSSSS------------------------------------------------------------
------------------------------------------------------------------------------------------------------------------------------------------------------
------------------------------------------------------------------------------------------------------------------------------------------------------
----------------------------------------------------------------------------------------------------------2--------oo--------------------##-----------
-----------------------------------------------------------------------------------------------------------------------------------------##-----------
---------------------------------------------------------TT----------------------------------------------------------------------------####-----------
-----------------------------------oo--------------TT----TT----------------------------S------------o-------------------SS-?Q----------####-----------
----------Q-----------------------o--o-------------TT----XX----------#----------SU--------------TT--------2----%%%%--%%%-------------######-----------
---------------------------------------------------TT---------------##--------------TT---t------TT--------------||----||-------------######-----------
---------------------------------------------------TT-------TT-----###--------------TT---t------TT--------------||----||-------y-----######--------F--
-M-----------------#---------------------------y---TT-------TT----####gg-----------kTT--kt--k---TT------y--y--o-||----||---SSSSS-----######--------#--
XXXXXXXXXXXXX--XXXXXXXXXX--XXXXXXXXXXXXXXXXXXXXXXXXXXXXXXXXXXXXXXXXXXXXXXXXXXXXXXXXXXXXXXXXXXXXXXXXXXXXXXXXXXX%-||----||-------XX-XXXXXXXXXXXXXXXXXXXX
XXXXXXXXXXXXX--XXXXXXXXXX--XXXXXXXXXXXXXXXXXXXXXXXXXXXXXXXXXXXXXXXXXXXXXXXXXXXXXXXXXXXXXXXXXXXXXXXXXXXXXXXXXXX--||----||-------XX-XXXXXXXXXXXXXXXXXXXX
