------------------------------------------------------------------------------------------------------------------------------------------------------
------------------------------------------------------------------------------------------------------------------------------------------------------
------------------------------------------------------------------------------------------------------------------------------------------------------
----------------------------------------SSSSSSSSSS------------------------------SSSSSSSSSL------------------------------SSS-----SS--------------------
----------------------------------------SSSSSSSS------------------------------------------------------------------------------------------------------
----------------------------------------SSSCSSSS-------oooo-------------------------------------------------------------------------------------------
------------------------------S---------SSSSSSSS-------%%%%----------------g--------oooooo-SSS!---------------?SSS------US-------------------------SSS
--------------------------------------------------SSSS--||-------------%%%%%%-----------------------------------------------------oo------------------
--------------------------------------------------------||--------------||||--------SSSSSS----------------------------------SSS-----------------------
-------------------------------------------ggg----------||--------------||||--------SSSSSS------------------------------------------------------------
---------Q------%%%%SS--------##--SSC---SSSSSSSS--------||--------------||||------------------C---------------SSSSS-----SSS----------------Q------#---
-----------------||--K---TT-------------SSSSSSSS------U-||--------------||||----------------------------------------------------------------------#---
-----------------||------TT-------------SSSSSSSS--------||--------------||||------------------------------*---------------------------------------#---
-----------------||------TT-------------SSSSSSSS--------||--gg-------g--||||-------------------g-g--gg----*-----K----------------------------ggg--#---
XXXXXXXXXXX--%%%%||%XXXXXXXXXXXX--XXXXXXXXXXXXXXXX----%%%%%-XXXXXXXXXX--||||-------XXXXXXXXXXXXXXXXXXXXXXXXXX-XXXXXXXXXXXXX------XXXXXXXXXXXXXXXXXXXXX
XXXXXXXXXXX---||-||-XXXXXXXXXXXX--XXXXXXXXXXXXXXXX-----|||--XXXXXXXXXX--||||-------XXXXXXXXXXXXXXXXXXXXXXXXXX-XXXXXXXXXXXXX------XXXXXXXXXXXXXXXXXXXXX
