------------------------------------------------------------------------------------------------------------------------------------------------------
------------------------------------------------------------------------------------------------------------------------------------------------------
------------------------------------------------------------------------------------------------------------------------------------------------------
-----------------------oo-----------------------------------------------------------------------------------------------------------------------------
------------------------------------------------------------------------------------------------------------------------------------------------------
--------------------------------------------------------------------------------K----------------------------------k----------------------------------
----------------------SSSS------------------------------------------------SS----SS----1---SSS------%----------S---SSSSSS-SSS----S!-----US-------------
-------------------------------------------------------------o---o---o--------------------------------------------------------------------------------
------------------------------------------------------------%%%-%%%-%%--------------------------------------------------------------------------------
-------------------------------------------------------------|---|---|---------------------------------------------------------------SS---------------
-----SSS------------------%%%%-TT---------------------S------|---|---|SS-----SS-SS----------%%%-------%%%%%%---------------------S---------S----------
---------------------------|||-TT-----------------TT---------|---|---|----------------TT-----|---------||||-------------------------------------------
---------------------------|||-TT-----------------TT---------|---|---|----------------TT-----|---------||||---TT------------------TT---------------F--
--------------k-ggg--------|||gTT--------------y--TT------k--|---|-r-|----------------TT-----|---------||||---TT------------gg-g-gTT---------------#--
XXXXXXXXXXXXXXXXXXXX%%%----|||XXXXXXXX--XXXXXXXXXXXXXXXXXXXX%%%%%%%%%%----------XXXXXXXXXX---|------%%-||||-%%XXXXXXXX--XXXXXXXXXXXXXXXX-X-XXXXXXXXXXX
XXXXXXXXXXXXXXXXXXXX||-----|||XXXXXXXX--XXXXXXXXXXXXXXXXXXXX-|||||||||----------XXXXXXXXXX---|------|--||||--|XXXXXXXX--XXXXXXXXXXXXXXXX-X-XXXXXXXXXXX
