------------------------------------------------------------------------------------------------------------------------------------------------------
------------------------------------------------------------------------------------------------------------------------------------------------------
------------------------------------------------------------------------------------------------------------------------------------------------------
------------------------------------------------------------------------------------------------------------------------------------------------------
-----------------------------------------------------------------------------------------------------------------------------------------------------o
------------------------------------------------------------------------------------------------------------------------------------------------------
----------------------!-------------------------------------------------SSSSS-------y-----------------------------------------------------------------
----------------------------------------------------------------------------------#SSS--------------------TT-----SSS------------oo--------------SSS---
---------------------------------------------------------------------------------##-----------------------TT-------------------------g#-----oo--------
--------------------------------------------------------------------------------###1----------------------TT------------------------g##---------------
----------Q---------S@S!S------TT---------------------S----------------------2--###--------------tt------SXXS----------------TT-----###-----SS--------
-------------------------------TT-----------------TT-----------------------TT---###--SSS--T------tt--------------------------TT----####---------------
----------------------------tt-TT-----------------TT------------------t----TT--T###-------T------tt-TT-----------------------TT---#####---------------
-------------------#-g------ttgTT-----------y-y---TT------k-gg-------gt----TT--T###-------T------tt-TT-------------------y---TT---#####---------------
XXXXXXXXXXXXX--XXXXXXXXXXXXXXXXXXXXXXX--XXXXXXXXXXXXXXXXXXXXXXXXXXXXXXXXXXXXXXXXXXXXXX---XXXXXXXXXXXXXXXXXXXXX%%%%----%%XXXXXXXXXXXXXXX--XXX----------
XXXXXXXXXXXXX--XXXXXXXXXXXXXXXXXXXXXXX--XXXXXXXXXXXXXXXXXXXXXXXXXXXXXXXXXXXXXXXXXXXXXX---XXXXXXXXXXXXXXXXXXXXX|||------|XXXXXXXXXXXXXXX--XXX----------
