------------------------------------------------------------------------------------------------------------------------------------------------------
------------------------------------------------------------------------------------------------------------------------------------------------------
------------------------------------------------------------------------------------------------------------------------------------------------------
----------------------------------------------------------------------------------------------------------------------------------SSSSSSSS------------
------------------------------------------------------------------------------------------------------------------------------------------------------
-------------------------------------------------------oooo-------------------------------------------------------------------------------------------
------------------Q--LSSS------------------------------%%%%---------------SS---------1-----------------------R-----------------SSS----------SS--------
--------------------------------o----ooo----------------||-------------------------------------------r------------------------------------------------
--------------------------------------------------------||-----------o------------------------------%%%%%%%-------------------------------------------
--------------------------------------------------SSS---||-------y----------------------------------||||||----------------------K---------------------
------------------?--2-----#----------%%----------------||-------##---SS-----SS----QQQQ---------TT--||||||------!-----S--------SSS-----g##--SS--------
--------------TT-----------#-----------|--------------U-||------###-----------------------------TT--||||||-----------------------------###--------#-TT
--------------TT-----------##----------|----------------||-----####-----------------------------TT--||||||---------------TT----------g####-------##-TT
--------------TT------kk---##--%%%%%%%-|-------y--------||----#####-----------------yy------k---TT--||||||--oo-----------TT----------#####------###-TT
XXXXXXXXXXXXXXXXXXXXXXXXXXXXXX--|||||--|XXXXXXXXXX----%%%%%-XXXXXXX-------------XXXXXXXXXXXXXXXXXXXX||||||--%%XXXXXXXXXXXXXXXXXXXXXXXXXXXX--XXXXXXX-XX
XXXXXXXXXXXXXXXXXXXXXXXXXXXXXX--|||||--|XXXXXXXXXX-----|||--XXXXXXX-------------XXXXXXXXXXXXXXXXXXXX||||||---|XXXXXXXXXXXXXXXXXXXXXXXXXXXX--XXXXXXX-XX
