------------------------------------------------------------------------------------------------------------------------------------------------------
------------------------------------------------------------------------------------------------------------------------------------------------------
------------------------------------------------------------------------------------------------------------------------------------------------------
S-----SSSS----------------------oo------------------------------------------------------------------SSSSSSSSSS----------------------------------------
S------------------------------------g-g----------?---------------------------------------------------------------------------------------------------
S---------------------ooor---------%%%%%ooooo---------------------------------------------------------------------------------------------------------
S--------------------%%%%%----------||||------------------------------------SSSS-----SSSS---------------------------------oo---%%%-----------------SSS
S---------------------|||-----------||||--------SSSS-------------------------------------------------------------SSS------SS----||--------------------
S---------------------|||-----------||||-SSSS-----------------------------------------------------------------------------------||--------------------
S---------------------|||-----%%%%%-||||-------------------------------------K--------------------------------------------------||--------------------
S-------------------%%%%%%%----|||--||||-----------------------------------SSSSSQ--------------------------TT----------------SS-||----------------#---
S-------------------||||||-----|||--||||---------------SSS-----------TT---------------------------------#--TT-------------------||----------------#---
S-------------------||||||--o--|||--||||----%%%%%------------B-------TT--------------------------B-----##--TT-------------------||----------------#---
S---------k---ggg---||||||-%%%-|||--||||-----|||-------------b-------TT----------ggg-------------b--kk-##--TT-------------------||k----------ggg--#---
XXXXXXXXXXXXXXXXXXXX||||||--|--|||--||||%%---|||------------XXXXXX--XXXXXXXXXXXXXXXXX----XXXXXXXXXXXXXXXX--XX-%%%%----%%%%-----%%%XX---XXXXXXXXXXXXXXX
XXXXXXXXXXXXXXXXXXXX||||||--|--|||--|||||----|||------------XXXXXX--XXXXXXXXXXXXXXXXX----XXXXXXXXXXXXXXXX--XX-|||------||-------||XX---XXXXXXXXXXXXXXX
