------------------------------------------------------------------------------------------------------------------------------------------------------
------------------------------------------------------------------------------------------------------------------------------------------------------
------------------------------------------------------------------------------------------------------------------------------------------------------
S-----SSSS------------------------------------------------------------SSSSSSSSSS----------------------------------------------------------------------
S----------------------------------------g--------?---------------------------------------------------------------------------------------------------
S---------------------ooor--------------%%------------------------------------------------------------------------------------------------------------
S--------------------%%%%%--------------|-------------------------SSoo-------------o--o----SSS!-----------------------US-----------SSSS---------------
S---------------------|||---------------|----oo---SS--------------------------TT----------------------------------------------------------------------
S---------------------|||---------------|-------------------------------------TT----------------------------------------------------------------------
S---------------------|||---------------|-------------------------------------TT---SSSS-----------------------------E----------SSS-----SSSS-----------
S-------------------%%%%%%%------------T|-------------------%%%%%%----------SCTT--------------C--------------------TT---%-------------------#---------
S-------------------||||||-------------T|--------------SSS---||||-------TT----TT----------------------TT-----------TT--t--------------------##--------
S-------------------||||||--o----------T|--------------------||||-------TT----TT%%%-------------------TT----TT-----TT--t--------------------###------#
S--M------k---ggg---||||||-%%%--gg-----T|--------------------||||-------TT---kTT||-------------g-g----TT-k--TT--g--TT--t---------r----------####----##
XXXXXXXXXXXXXXXXXXXX||||||--|-XXXXXXXXXX|----%%%%------------||||-----XXXXXXXXXX||--------XXXXXXXXXXXXXXXXXXXXXXXXXXXXXX----XXXXXX---------XXXXXXXXXXX
XXXXXXXXXXXXXXXXXXXX||||||--|-XXXXXXXXXX|-----||-------------||||-----XXXXXXXXXX||--------XXXXXXXXXXXXXXXXXXXXXXXXXXXXXX----XXXXXX---------XXXXXXXXXXX
