------------------------------------------------------------------------------------------------------------------------------------------------------
------------------------------------------------------------------------------------------------------------------------------------------------------
------------------------------------------------------------------------------------------------------------------------------------------------------
S-----SSSS----------------------oo-----------------oo-------------------------------------------------------------------------------------------------
S------------------------------------g-g----------%%%%------------------------------------------------------------------------------------------------
S----------------------------------%%%%%-----------||---------g-----------------K---------------------------------------------------------------------
S-----------------------------------||||-----------||---------SSSSS--------g----SS----1----------------------R?SSS--------SSC-------------------------
S-----------------------------------||||-----------||--SSS-------------%%%%%%----------------------------r------------------------oo------------------
S-----------------------------------||||-----------||-------------------||||------------------------%%%%%%%-------------------------------------------
S-----------------------------%%%%%-||||-----------||-------------------||||--------------------g---||||||----------------SSS-------------------------
S------------------------------|||--||||-----------||-------------------||||----SS--------------TT--||||||----SSSSS------------------------Q----------
S----------------K-------------|||--||||-----------||-------------------||||----------TT--------TT--||||||--------------------------------------------
S-----------B------------------|||--||||----------%||---------TT-----t--||||----------TT--------TT--||||||-----------------------------------------F--
S--M--------b------------ggg---|||--||||-----------||---------TT-----t--||||----------TT--------TT--||||||--oo--K----------------#-----------------#--
XXXXXXXXXXXXXXXXXXXXXXXXXXXXXX-|||--||||X-XX-XX-XX-||-------XXXXXXXXXX--||||----XXXXXXXXXXXXXXXXXXX-||||||--%%XXXXXXXXXXX----XXXXXXXXXXXXXXXXXXXXXXXXX
XXXXXXXXXXXXXXXXXXXXXXXXXXXXXX-|||--||||X-XX-XX-XX-||-------XXXXXXXXXX--||||----XXXXXXXXXXXXXXXXXXX-||||||---|XXXXXXXXXXX----XXXXXXXXXXXXXXXXXXXXXXXXX
