------------------------------------------------------------------------------------------------------------------------------------------------------
------------------------------------------------------------------------------------------------------------------------------------------------------
------------------------------------------------------------------------------------------------------------------------------------------------------
----------------------------------------SSSSSSSSSS----------------------------------------------------------------------SSSSSSSSSS--------------U-----
----------------------------------------SSSSSSSS------------------------------------------------------------------------------------------------------
----------------------------------------SSSCSSSS--------------------------------------------oo--------------------------------------------------------
-----------------------------U----------SSSSSSSS------------------SSoo-----g-------o--o--------------------------------------------------##-----------
-----------------------------------------------------------------------%%%%%%------------------------------------------------------------##-------SS--
------------------------------------------------------------------------||||-----------------------%-----------------------------------####-----------
-------------------------------------------ggg--------------------------||||-------SSSS------------------------------------------------####---SS------
----------------!-----------##---------TSSSSSSSS------------%%%%%%------||||--------------SS--------------------------r--------------######----------#
-----------------------y-#####---------TSSSSSSSS----K--------||||-------||||--------------------------TT----------%%%%%%--SS---------######---------##
--------------------y-######-----------TSSSSSSSS-------------||||-------||||----%%%----------%%%%-----TT----TT-----|||||--SS---------######--------###
-M------------------######------gg-----TSSSSSSSS-----------g-||||-------||||----||------------||------TT-k--TT-----|||||--SS---------######-------####
XXXXXXXXXXXXXXXXXXXXXXXX------XXXXXXXXXXXXXXXXXXXXXXXXXXXXXX-||||-------||||----||------------||----XXXXXXXXXX-%%%-|||||--XX--XXXXXXXXXXXXXXXXXXX-XXXX
XXXXXXXXXXXXXXXXXXXXXXXX------XXXXXXXXXXXXXXXXXXXXXXXXXXXXXX-||||-------||||----||------------||----XXXXXXXXXX--|--|||||--XX--XXXXXXXXXXXXXXXXXXX-XXXX
