------------------------------------------------------------------------------------------------------------------------------------------------------
------------------------------------------------------------------------------------------------------------------------------------------------------
------------------------------------------------------------------------------------------------------------------------------------------------------
----------------------------------------SSSSSSSSSSSSSSSSS---------------------------------------------------------------SSS-----SS--------------------
----------------------------------------SSSSSSSS------------------------------------------------------------------------------------------------------
----------------------------------------SSSCSSSS------------------------------------------------------------------------------------------------------
----------------------------------------SSSSSSSS--QQ---------------------------------1-----SSS!-------------------------US-------------US---SSS-------
----------------------------------------------------------------------------------------------------------TT------------------------------------------
-----------------------------------------------------------S----------------------------------------------TT----------------SSS-----------------------
-------------------------------------------ggg------------------------------------------------------------TT-------------------------SS----------SSSSS
----------------------------------------SSSSSSSS--QQ--QQQ------------T-------------QQQQ-------C----------SXXS-----------SSS----------------S----------
-----------------K----------------------SSSSSSSS---------------------T--------------------------------------------------------------------------------
------------B---------------------------SSSSSSSS---------------------T------------------------------TT-------------B--------------TT--------SSS-------
------------b------------ggg------k-k---SSSSSSSS--------------ggg----T--------------yy---------g-g--TT-------------b--------------TT---------------r--
XXXXXXXXXXXXXXXXXXXXXXXXXXXXXXXXXXXXXXX-XXXXXXXXXXXXXXXXX---XXXXXXXXXXX----XXXXXXXXXXXXXXXXXXXXXXXXXXXXXXXXXXXXXXXXXXXXXXXX------XXXXXXX-X-X-----XXXXX
XXXXXXXXXXXXXXXXXXXXXXXXXXXXXXXXXXXXXXX-XXXXXXXXXXXXXXXXX---XXXXXXXXXXX----XXXXXXXXXXXXXXXXXXXXXXXXXXXXXXXXXXXXXXXXXXXXXXXX------XXXXXXX-X-X-----XXXXX
