------------------------------------------------------------------------------------------------------------------------------------------------------
------------------------------------------------------------------------------------------------------------------------------------------------------
------------------------------------------------------------------------------------------------------------------------------------------------------
S-----SSSS----------SSSSSSSSSS--------------------------------------------------ooo---------------------------SS-------S------------------------------
S-------------------SSSSSSSSSS--------------------------------------------------%%%-------------------------------------------------------------------
S-------------------SSSSSSSSSS---------------------------------------------------|----------oo--------------------------------------------------------
S-------------------SSSSSSSSSS---------------------------------------------------|----------------------SSQSSS---------S-----------SSSS---------------
S------------------------------------------------------------o---o---o-----------|--------------------------------------------------------------------
S-----------------------------------------------------------%%%-%%%-%%---------g-|-----------------%---------------SSS--------------------------------
S--------------------------------------------------------o---|---|---|-----------|---%%%%-----------------K-------------SS-?Q----------SSSS-----------
S---------------------SSSSSS?--TT----------------------------|---|---|-------S@S-|----||--SS------------SSSSSS---------S------------------------------
S---------------------SSSSS----TT----------------------------|---|---|----------%%%%%%||-----------------------##----------------------------------#--
S---------------------SSSSS----TT----------------------------|---|---|-----------||||-||-----%%%%--------------##--------------y---------------K---#--
S-------------k-ggg--------ooogTT-------------------k--------|---|-r-|-----------||||-||------||---------------##----------SSSSS-------------------#--
XXXXXXXXXXXXXXXXXXXX-XXXXXXXXXXXXXXXXX--X-XX-XX-XX-XXXXXXXXX%%%%%%%%%%-XXXXXXXXX-||||-||%%----||----XXXXXXXXXX-XX------X-------XX----------XXXXXX--XXX
XXXXXXXXXXXXXXXXXXXX-XXXXXXXXXXXXXXXXX--X-XX-XX-XX-XXXXXXXXX-|||||||||-XXXXXXXXX-||||-||-|----||----XXXXXXXXXX-XX------X-------XX----------XXXXXX--XXX
