------------------------------------------------------------------------------------------------------------------------------------------------------
------------------------------------------------------------------------------------------------------------------------------------------------------
------------------------------------------------------------------------------------------------------------------------------------------------------
----------------------------------------SSSSSSSSSS------------------------------SSSSSSSSSS--------------------SSSSSSSSSS------------------------------
----------------------------------------SSSSSSSS------------------------------------------------------------------------------------------------------
----------------------ooor------------ooSSSCSSSS------------------------------------------------------------------------------------------------------
------------------SC-%%%%%---------SSSS-SSSSSSSS---------------------------g------------------------------2---------------SSC------------##-SS--------
----------------------|||----------------------------------------------%%%%%%------------------------------------------------------------##-----------
----------------------|||--------------------------------------------o--||||-----------------------------------------------------------####-----------
----------------------|||------------------ggg-------------------y------||||-----------S------------o---------------------SSS----------####-----------
--------------TT---2%%%%%%%---%---------SSSSSSSS-----------------##-----||||----SU------------------------2---T----------------------######-SS--------
--------------TT----||||||--------------SSSSSSSS----K-----------###-----||||--------TT---t--------------------T----------------------######-------#-TT
--------------TT----||||||--o-----------SSSSSSSS---------------####-----||||--------TT---t-------B------------T----TT----------------######------##-TT
-M------------TT----||||||-%%%----------SSSSSSSS-----------g--#####-----||||-------kTT--kt-------b------y--y--T--g-TT------------#---######-----###-TT
XXXXXXXXXXXXXXXXXXXX||||||--|---%%%%--%%XXXXXXXXXXXXXXXXXXXXXXXXXXX-----||||----XXXXXXXXXXXXXXXXXXXXXXXXXXXXXXXXXXXXXXXXX----XXXXXXXXXXXXXXXXXXXXXX-XX
XXXXXXXXXXXXXXXXXXXX||||||--|----||----|XXXXXXXXXXXXXXXXXXXXXXXXXXX-----||||----XXXXXXXXXXXXXXXXXXXXXXXXXXXXXXXXXXXXXXXXX----XXXXXXXXXXXXXXXXXXXXXX-XX
