------------------------------------------------------------------------------------------------------------------------------------------------------
------------------------------------------------------------------------------------------------------------------------------------------------------
------------------------------------------------------------------------------------------------------------------------------------------------------
------------------------------SSSSSSSSSS--------------------------------------------------------------------------------------------------------------
------------------------------SSSSSSSSSS--------------------------------------------------------------------------------------------------------------
------------------------------SSSSSSSSSS----------------------g---------------------------------------------------------------------------------k-----
--------------------S---------SSSSSSSSSS----------------------SSSSS--------g--------y---------------------2--------------------SSSSS-----------SQS--SQ
---------------------------TT------------------------------------------%%%%%%-----#SSS----------------------------------------------------------------
---------------------------TT----------------------------TT-------------||||-----##-------------------------------------------------------------------
---------------------------XX----------------------TT----TT-------------||||----###1-----------oooo-o---------------------------K---------------------
----------------!------TT-----SSSSSSSSSS-----------TT----XX-------------||||----###-----------------------2--------------------SSSSS-----------SQS--S?
-----------------------TT-----SSSSSSSSSS-----------TT-------------------||||----###--SSS------------------------------------------K---#----B----------
-----------------------TT-----SSSSSSSSSS-----------TT---------TT-----t--||||----###--------------------------------B-----TT-----------#----b----------
-M------------------k--TT-----SSSSSSSSSS----y-y----TT---------TT-----t--||||----###---------------------y--y-------b-----TT-----------#----B-k------gg
XXXXXXXXXXXXXXXXXXXXXXXXXXXXXXXXXXXXXXXXXXXXXXXXXXXXXXXXXXXXXXXXXXXXXX--||||----XXXXXX---X%%%%%%%-%%XXXXXXXXXXXXXXXXXXXXXXXXXXXXXXXXXXXXXXXXXXXXXXXXXX
XXXXXXXXXXXXXXXXXXXXXXXXXXXXXXXXXXXXXXXXXXXXXXXXXXXXXXXXXXXXXXXXXXXXXX--||||----XXXXXX---X||||||---|XXXXXXXXXXXXXXXXXXXXXXXXXXXXXXXXXXXXXXXXXXXXXXXXXX
