------------------------------------------------------------------------------------------------------------------------------------------------------
------------------------------------------------------------------------------------------------------------------------------------------------------
------------------------------------------------------------------------------------------------------------------------------------------------------
--------------------SSSSSSSSSS--oo--------------------------------------------------------------------------------------------------------------U-----
-------------------------------------g-g--------------------------------------------------------------------------------------------------------------
-----------------------------------%%%%%--------------------------------------------------------------------------------------------------------------
------------------------------------||||------QQQQ-------------------------1------------------------------2-------------------------------------------
------------------------------------||||----------------------------------------------------------------------------------------------------------SS--
------------------------------------||||-----------------TT------------------------------------------------------------------SSS----------------------
-----------------------------C%%%%%-||||--------k--TT----TT----------------ggg----o-----------------o-----------------------------------------SS------
-----------------------#-#-----|||--||||T-----?QQQ-TT----XX-----------#########--------TT-------TT--------2-------------r----------------------------#
-----------------K---#-#-#-#---|||--||||T----------TT----------------T--------#--------TT-------TT----------------------%%%%%%-------TT-------------##
------------B--------#-#-#-#---|||--||||T----------TT--------B-------T--------#--------TT-------TT-----------------B----|||||--------TT------------###
------------b--------#-#-#-#-E-|||--||||T----------TT--------b-------T--------#--------TT---k---TT------y--y-------b----|||||--------TT-----------####
XXXXXXXXXXXXXXXXXXXXXXXXXXXXXX-|||--||||XXXXXXXXXXXXXXXXXXXXXXXXXX--XX--------X-XXXXXXXXXXXXXXXXXXXXXXXXXXXXXXXXXXXXXXXX|||||-----XXXXXXXXXXXXXXX-XXXX
XXXXXXXXXXXXXXXXXXXXXXXXXXXXXX-|||--||||XXXXXXXXXXXXXXXXXXXXXXXXXX--XX--------X-XXXXXXXXXXXXXXXXXXXXXXXXXXXXXXXXXXXXXXXX|||||-----XXXXXXXXXXXXXXX-XXXX
