------------------------------------------------------------------------------------------------------------------------------------------------------
------------------------------------------------------------------------------------------------------------------------------------------------------
------------------------------------------------------------------------------------------------------------------------------------------------------
--------------------------------------------------------------------------------SSSSSSSSSS------------------------------------------------------------
--------------------------------------------?---------------------------------------------------------------------------------------------------------
-----------------------SSS-----------------------------oooo---------------------------------oo--------------------------------------------------------
-------------------------------------------------------%%%%---------------SS----------------------------SSQSSS--------------------%-------------------
---------------------g------------------------r---SSSS--||--------------------------------------------------------------------------------------------
--------------------%%%-------------------%%%%%%--------||-----------------------------------------%-------------------y----------------SSS-----------
--------------------||----SSS--------------||||---------||-----------------------------S------------------K------------XSS-?Q-------------------------
----------------%%%%||------------------%%-||||ooo------||-----------#SS-----SS-SU--------SS------------SSSSSS--------XX----------%%%%%---------------
-----------------||-||------------------|--||||--r----U-||----------##--------------TT---t---------------------------XXX-----------|||----------------
-----------------||-||------------------|%%%%%%%%%------||--TT-----###--------------TT---t---%%%%-------------------XXXX-------y---|||-------------F--
-M---------------||-||----oo------k-k---|-||||||||------||--TT----####-------------kTT--kt----||-------------------XXXXX---SSSSS---|||-------------#--
XXXXXXXXXXX--%%%%||%||---%%%--XXXXXXXXX-|-||||||||----%%%%%-XXXXXXXXXX----------XXXXXXXXXX----||----XXXXXXXXXXXXXXXXXXXX-------XX-%|||------XXXXXXXXXX
XXXXXXXXXXX---||-||-||----|---XXXXXXXXX-|-||||||||-----|||--XXXXXXXXXX----------XXXXXXXXXX----||----XXXXXXXXXXXXXXXXXXXX-------XX--|||------XXXXXXXXXX
