------------------------------------------------------------------------------------------------------------------------------------------------------
------------------------------------------------------------------------------------------------------------------------------------------------------
------------------------------------------------------------------------------------------------------------------------------------------------------
----------------------------------------SSSSSSSSSS----------SSSSSSSSSS------------------------------SSSSSSSSSS----------------------------------------
----------------------------------------SSSSSSSS------------SSSS--SSSS--------------------------------------------------------------------------------
----------------------------------------SSSCSSSS------------SSSS--SSSS------------------oo------------------------------------------------------------
--------------------S-------------------SSSSSSSS--------------SS---S------------oo---------SSS!------------------------------------------##-SS--------
---------------------------TT---------------------------------SS---S------------------------------------------------------------oo-------##-----------
---------------------------TT---------------------------------SS---S-----------g-------------------------------------------------------####-----------
---------------------------XX--------------ggg-----------o--ooSS---SoU-----------SSS---------------------------------------------------####-----------
-------------------%---TT---------------SSSSSSSS------------SSSS---SSS-------S@S---------S----C------------TT---------r------TT------######-SS--------
-----------------------TT---------------SSSSSSSS--------------------------------------------------------#--TT-----%%%%%%-----TT------######-------#-TT
-----------------------TT---------------SSSSSSSS-------------------------------------------------------##--TT------|||||-----TT------######------##-TT
-M-----------%%%%---k--TT---------k-k---SSSSSSSS----k-------k--g-g-----------------------------g-g--kk-##--TT------|||||-y---TT------######-----###-TT
XXXXXXXXXXX---||----XXXXXXXXXXXXXXXXXXX-XXXXXXXXXX-XXXXXXXXXXXXXXXXXXX-XXXXXXXXX----------XXXXXXXXXXXXXXX--XX--%%%-|||||XXXXXXXXXXXXXXXXXXXXXXXXXXX-XX
XXXXXXXXXXX---||----XXXXXXXXXXXXXXXXXXX-XXXXXXXXXX-XXXXXXXXXXXXXXXXXXX-XXXXXXXXX----------XXXXXXXXXXXXXXX--XX---|--|||||XXXXXXXXXXXXXXXXXXXXXXXXXXX-XX
