------------------------------------------------------------------------------------------------------------------------------------------------------
------------------------------------------------------------------------------------------------------------------------------------------------------
------------------------------------------------------------------------------------------------------------------------------------------------------
------------------------------------------------------------------------------------------------------------------------------------------------------
------------------------------------------------------------------------------------------------------------------------------------------------------
--------------------------------------------------------------------------------------------oo--------------------------------------------------------
------------------Q-USS----------------------------------------------------1--------y------------------------@---------------------SSSS---------------
----------------------------------------------------------------------------------#SSS----------------------------------------------------------------
---------------------------------------------------------------------------------##----------------%-------------------------SSS----------------------
---------------------------------------------------------------------------ggg--###1---------------------------------------------------SSSS-----------
-----SSS----------?-------------QQQQ----------------------------------#########-###-------SS--------SU----!--!--!-----S-r-----------------------------
--------------TT-----B---------------K-B------------K----------------T--------#-###--SSS--------------------------------%%%%%%------------------------
--------------TT-----b-------B---------b---------------------B-------T--------#-###----------%%%%-----------------------|||||----------------------F--
--------------TT-----B-------b---------b-------y-----------g-b-------T--------#-###-----------||----------k-------------|||||----------------------#--
XXXXXXXXXXXXXXXXXXXXXXXXXXXXXXXXXXXXXXXXXXXXXXXXXXXXXXXXXXXXXXXXXX--XX--------X-XXXXXX---X----||----XXXXXXXXXXXXXXXXXXXX|||||--------------XXXXXXXXXXX
XXXXXXXXXXXXXXXXXXXXXXXXXXXXXXXXXXXXXXXXXXXXXXXXXXXXXXXXXXXXXXXXXX--XX--------X-XXXXXX---X----||----XXXXXXXXXXXXXXXXXXXX|||||--------------XXXXXXXXXXX
