------------------------------------------------------------------------------------------------------------------------------------------------------
------------------------------------------------------------------------------------------------------------------------------------------------------
------------------------------------------------------------------------------------------------------------------------------------------------------
----------SSSSSSSSSS----------------------------------------------------------------------------------------------------------------------------------
------------------------------------------------------------------------------------------------------------------------------------------------------
------------------------------------------------------------------------------------------------------------------------------------------------k-----
------------------------------S-------------------Q---------------------SSSSS------USS---------------------------------------------------------SQS--SQ
----------------------------------------------------------------------------------------------------------------------------------oo------------------
------------------------------------------------------------------------------------------------------------------------------------------------------
--------------------------------------------------------------------------------------------------oo--------------------SS-?Q-------------------------
---------Q------------------TT##--SSC-------------Q--------------------------2----#-----------------------------!-----S--------------------Q---SQS--S?
----------------------------TT---------------------------------------------TT-----#------------TT-----------g-----------------------------------------
----------------------------TT----------------------------------------t----TT--T--##-----------TT-----------TT-----------------y----------------------
-M----------------------ggg-TT--------------y-y------gg----kgg-------gt----TT--T--##--gg----y--TT-----------TT-------------SSSSS-------------k------gg
XXXXXXXXXXX--XX--X--XXXXXXXXXXXX--XXXXXXXXXXXXXXXXXXXXXXXXXXXXXXXXXXXXXXXXXXXXXX--XXXXXXXXXXXXXXXXXX--XXXXXXXXXXXXXXXXXX-------XX-XXXXXXXXXXXXXXXXXXXX
XXXXXXXXXXX--XX--X--XXXXXXXXXXXX--XXXXXXXXXXXXXXXXXXXXXXXXXXXXXXXXXXXXXXXXXXXXXX--XXXXXXXXXXXXXXXXXX--XXXXXXXXXXXXXXXXXX-------XX-XXXXXXXXXXXXXXXXXXXX
