------------------------------------------------------------------------------------------------------------------------------------------------------
------------------------------------------------------------------------------------------------------------------------------------------------------
------------------------------------------------------------------------------------------------------------------------------------------------------
----------------------------------------SSSSSSSSSS--------------------SSSSSSSSSS----------SSSSSSSSSS----------SS-------SSSS-----SSSSSSSSSS------------
----------------------------------------SSSSSSSS----------------------------SSSS----------------------------------------------------------------------
----------------------------------------SSSCSSSS-------------------------g--SSSS----------------------------------------------------------------------
-----------------------------U----------SSSSSSSS------------------------SS-----------SUS---------------------R---------SUS-------------------------SSS
------------------------------------------------------------------------SS---------------------------r------------------------------------------------
------------------------------------------------------------------------SS--------------------------%%%%%%%--------SSS------SSS-----------------------
-----------------------------------oo------ggg--------------------------SC--g-g---------------------||||||--------------------------------------------
---------Q---------%--------##----o--o--SSSSSSSS------------------------SS--SSSS----#####-----------||||||-------------SSSS------------g##--------#---
-----------------------y-#####----------SSSSSSSS----K-------------------------------#-----t---------||||||-----##----------------------###--------#---
--------------------y-######------------SSSSSSSS-----------------------------------K#-----t---------||||||-----##--------------------g####--------#---
-------------%%%%---######--------------SSSSSSSS-----------ggg-------g--------------#-----t---------||||||--oo-##--------------------#####---ggg--#---
XXXXXXXXXXX---||----XXXX------XXXXXXXXXXXXXXXXXXXXXXXXXXXXXXXXXXXXXXXXXXXXXXXXXXXXXXXXX---XXXXXXXXXX||||||--%%-XX------XXXX------XXXXXXXXX--XXXXXXXXXX
XXXXXXXXXXX---||----XXXX------XXXXXXXXXXXXXXXXXXXXXXXXXXXXXXXXXXXXXXXXXXXXXXXXXXXXXXXXX---XXXXXXXXXX||||||---|-XX------XXXX------XXXXXXXXX--XXXXXXXXXX
