------------------------------------------------------------------------------------------------------------------------------------------------------
------------------------------------------------------------------------------------------------------------------------------------------------------
------------------------------------------------------------------------------------------------------------------------------------------------------
----------------------------------------SSSSSSSSSS------------------------------SSSSSSSSSS--------------------------------------------------SSSSSSSSSS
--------------------------------------------------?---------------------------------------------------------------------------------------------------
----------------------ooor------------------------------------------------------------------oo---------------------k----------------------------------
---------------------%%%%%---------------oooo------------------------------g---------------------------------RS---SSSSSS---------------US-------------
----------------------|||-------------------------SS-------------------%%%%%%------------------------r------------------------------------------------
----------------------|||----------------SSSS-U-------------------------||||-----------------------%%%%%%%%-------------------------------------------
----------------------|||----------oo---oS--SoS-----------------1-------||||-----------S------------||||||--------------SS-?Q--------SS---------------
---------Q----------%%%%%%%-------o--o--SS--SSS-------------------------||||----SU--------SS--------||||||---------------------------------S--TT------
--------------------||||||-----------------------------SSS--------------||||--------TT---t----------||||||------------------------------------TT------
--------------------||||||--o-------------------------------------------||||--------TT---t---%%%%---||||||----TT---------------y--TT----------TT------
-M------------k-ggg-||||||-%%%------------kk----------------------------||||-------kTT--kt----||----||||||--ooTT-----------SSSSS--TT----------TT------
XXXXXXXXXXXXXXXXXXXX||||||--|-XXXXXXXXXXXXXXXXXXXX----------XXXXXXXXX---||||----XXXXXXXXXX----||----||||||--%%XXXXXXXX---------XX-XXXXXX-X-XXXXX--XXXX
XXXXXXXXXXXXXXXXXXXX||||||--|-XXXXXXXXXXXXXXXXXXXX----------XXXXXXXXX---||||----XXXXXXXXXX----||----||||||---|XXXXXXXX---------XX-XXXXXX-X-XXXXX--XXXX
