------------------------------------------------------------------------------------------------------------------------------------------------------
------------------------------------------------------------------------------------------------------------------------------------------------------
------------------------------------------------------------------------------------------------------------------------------------------------------
--------------------SSSSSSSSSS--------------------------------------------------------------------------------SS-------S------------------------------
--------------------------------------------?----------------------------o----------------------------------------------------------------------------
------------------------------------------------------------------------%%%-----------------oo--------------------------------------------------k-----
-------------------------------------------------------------------------|--o--------------------------------@---------S--oo---%%%-------##----SQS--SQ
----------------------------------------------r--------------------------|--SSSS------------------------------------------SS----||-------##-----------
------------------------------------------%%%%%%----------------------%--|-------------------------%---------------SSS----------||-----####-----------
-----------------------------C-------------||||--------------------------|--------o---------------------------------------------||-----####-----------
---------Q-------------#-#-----TT-------%%-||||ooo-----ooo---------------|-------------TT-SS--------SU----!--!---------S-----SS-||---######----SQS--S?
-----------------K---#-#-#-#---TT-------|--||||--r-------------------T---|-------------TT----------------------##---------------||---######-----------
------------B--------#-#-#-#---TT-------|%%%%%%%%%-----------B-------T---|-----%-------TT----%%%%--------------##---------------||---######-----------
------------b--------#-#-#-#-EgTT-------|-||||||||-----------b-------T---|-------------TT-----||----------k----##---------------||---######--k------gg
XXXXXXXXXXXXXXXXXXXXXXXXXXXXXXXXXXXXXX--|-||||||||--XXXXXXXXXXXXXX--XX%%%%%%----XXXXXXXXXX----||----XXXXXXXXXX-XX------X%%-----%%%XXXXXXXXXXXXXXXXXXXX
XXXXXXXXXXXXXXXXXXXXXXXXXXXXXXXXXXXXXX--|-||||||||--XXXXXXXXXXXXXX--XX|||||-----XXXXXXXXXX----||----XXXXXXXXXX-XX------X|-------||XXXXXXXXXXXXXXXXXXXX
