------------------------------------------------------------------------------------------------------------------------------------------------------
------------------------------------------------------------------------------------------------------------------------------------------------------
------------------------------------------------------------------------------------------------------------------------------------------------------
----------------------------------------------------------------------SSSSSSSSSS--------------------------------------------------SSSSSSSS------------
-----------------------------------------g------------------------------------------------------------------------------------------------------------
----------------------ooor------------oo%%------------------------------------------------------------------------------------------------------------
---------------------%%%%%---------SSSS-|--------------------------------------------1----SSS------%----SSQSSS-----oo----SSS----S!--------------------
----------------------|||---------------|----oo-------------------------------TT---------------------------------------------------------------y------
----------------------|||---------------|----------------TT-------------------TT-------------------------------------------------------------#SS--o---
----------------------|||---------------|----------TT----TT-------------------TT--------------------------K---------------------------------##--------
--------SU---------%%%%%%%%---%---------|----------TT----XX-----------------SCTT---QQQQ-----%%%---------SSSSSS-%%%%--%%%---------S-----g##--##--SC----
--------------------||||||--------------|----------TT-------------------TT----TT-------------|------------------||----||---------------###--##--------
--------------------||||||--o-----------|----------TT-------------------TT----TT-------------|------------------||----||-------------g####--##---SSS--
--M----------%%%%---||||||-%%%----------|----------TT--------y----------TT---kTT----yy-------|----------------o-||----||----gg-g-g---#####--##--------
XXXXXXXXXXX---||----||||||--|---%%%%--%%|----%%%%-XXXXXXXXXXXXXXXXXXXXXXXXXXXXXXXXXXXXXXXX---|------XXXXXXXXXX%-||----||XXXXXXXXXXXXXXXXXX--XX------XX
XXXXXXXXXXX---||----||||||--|----||----||-----||--XXXXXXXXXXXXXXXXXXXXXXXXXXXXXXXXXXXXXXXX---|------XXXXXXXXXX--||----||XXXXXXXXXXXXXXXXXX--XX------XX
