------------------------------------------------------------------------------------------------------------------------------------------------------
------------------------------------------------------------------------------------------------------------------------------------------------------
------------------------------------------------------------------------------------------------------------------------------------------------------
--------------------------------------------------------------------------------------------------------------SSSSSSSSSS------------------------U-----
------------------------------------------------------------------------------------------------------------------------------------------------------
---------------------------------------------------------------------R------------------oo------------------------------------------------------------
---------------------LSSS--------------------------------Q-Q--------------------oo--------------------------------------------------------------------
----------------------------------------------------------------------------------------------------------------------------------oo--------------SS--
-----------------------------------------------------------------------------------------------------------------------------SSS----------------------
-------------------------------------------------------------------------1-------SS-------------g---------------------------------------------SS------
----------------%%%%-2-----#-----------T-TT---SU---------Q-Q-----%%%--T------------------S------TT------------T---------r------------------Q---------#
-----------------||--------#-----------T-TT-----------------------|---T----TT-------------------TT------------T---------%%%%%%----------------------##
-----------------||--------##----------T-TT-----------------------|---T----TT-------------------TT--------*---T----TT---|||||----------------------###
---M-------------||---kk---##---gg-----T-TT------k----------------|---T---kTT-------------------TT--gg----*---T--g-TT---|||||---------------------####
XXXXXXXXXXX--%%%%||%XXXXXXXXXXXXXXXXXXXXXXXXXXXXXXXXXXXXXXXX%%%%%-|---XXXXXXXXXX----------XXXXXXXXX-XXXXXXXXX-XXXXXXXXXX|||||-----XXXXXXXXXXXXXXX-XXXX
XXXXXXXXXXX---||-||-XXXXXXXXXXXXXXXXXXXXXXXXXXXXXXXXXXXXXXXX-|||--|---XXXXXXXXXX----------XXXXXXXXX-XXXXXXXXX-XXXXXXXXXX|||||-----XXXXXXXXXXXXXXX-XXXX
