------------------------------------------------------------------------------------------------------------------------------------------------------
------------------------------------------------------------------------------------------------------------------------------------------------------
------------------------------------------------------------------------------------------------------------------------------------------------------
--------------------------------------------------------------------------------SSSSSSSSSL----------------------------------------SSSSSSSS------------
--------------------------------------------------?---------------------------------------------------------------------------------------------------
----------------------------------------ooooo---------------------------------------------------------oo----------------------------------------------
------------------------------------------------------------------------------------oooooo--------------------------------------------------SSS-------
------------------------------------------------SSSS---------o---o---o--------------------------------------------------------------------------------
-----------------%%%---------------------SSSS---------------%%%-%%%-%%--------------SSSSSS-----------------------------------SSS----------------------
------------------||---------------oo------------------------|---|---|--------------SSSSSS-------------------------------------------------------SSSSS
--------SU--------||SS------------o--o-----------------------|---|---|------------------------------------------------r-r--------------g##------------
-------------%%%%%||-K---TT----------------------------SSS---|---|---|--------------------------------------------%%%%%%%%%%%%---------###------------
--------------|||-||-----TT-----------------%%%%%------------|---|---|--------------------------------------tt-----||||||||||--------g####--SSS-------
--M-----------|||-||-----TT------------------|||-------------|---|-r-|gg---------------------------g--ggg---tt-----||||||||||--------#####---------r--
XXXXXXXXXXX---|||-||XXXXXXXXXXXXXXXXXXXX%%---|||------------%%%%%%%%%%XXXXXXXXXX---XXXXXXX-XXXXXXXXXXXXXXXXXXX-%%%-||||||||||-----XXXXXXXX-------XXXXX
XXXXXXXXXXX---|||-||XXXXXXXXXXXXXXXXXXXX|----|||-------------|||||||||XXXXXXXXXX---XXXXXXX-XXXXXXXXXXXXXXXXXXX--|--||||||||||-----XXXXXXXX-------XXXXX
