------------------------------------------------------------------------------------------------------------------------------------------------------
------------------------------------------------------------------------------------------------------------------------------------------------------
------------------------------------------------------------------------------------------------------------------------------------------------------
--------------------------------oo----------------------------------------------------------------------------------------------------------SSSSSSSSSS
-------------------------------------g-g--------------------------------------------------------------------------------------------------------------
-----------------------------------%%%%%---------------oooo-------------------------------------------------------------------------------------------
-----------------------------U------||||---------------%%%%--------------------------1-----------------------R?SSS-----------------SSSS---------------
------------------------------------||||----------------||-----------------------------------------------r--------------------------------------------
-----------------%%%----------------||||----------------||-----------o---------g--------------------%%%%%%%-------------------------------------------
------------------||----------%%%%%-||||----------SSS---||-------y------------------------------g---||||||-----------------------------SSSS-----------
------------------||--------##-|||--||||------tt--------||-------##----------S@S---QQQQ---------TT--||||||----SSSSS---------------------------TT------
-------------%%%%%||---y-#####-|||--||||------tt------U-||------###-----------------------------TT--||||||------------------------------------TT------
--------------|||-||y-######---|||--||||------tt--------||-----####-----------------------------TT--||||||------------------------------------TT------
---M----------|||-||######-----|||--||||-g----tt--------||----#####-----------------yy----------TT--||||||--oo--K--------k----ggg-------------TT------
XXXXXXXXXXX---|||-||XXXX-------|||--||||XXXXXXXXXX----%%%%%-XXXXXXX----XXXXXXXXXXXXXXXXXXXXXXXXXXXX-||||||--%%XXXXXXXXXXXXXXXXXXXX---------XXXXX--XXXX
XXXXXXXXXXX---|||-||XXXX-------|||--||||XXXXXXXXXX-----|||--XXXXXXX----XXXXXXXXXXXXXXXXXXXXXXXXXXXX-||||||---|XXXXXXXXXXXXXXXXXXXX---------XXXXX--XXXX
