------------------------------------------------------------------------------------------------------------------------------------------------------
------------------------------------------------------------------------------------------------------------------------------------------------------
------------------------------------------------------------------------------------------------------------------------------------------------------
------------------------------SSSSSSSSSS---------------------------SSS----------SSSSSSSSSSSSSSSSSSSS--------------------------------------------------
------------------------------SSSSSSSSSS----?---------------------------------------------------------------------------------------------------------
------------------------------SSSSSSSSSS---------------oooo-------------------------------------------------------------------------------------------
------------------------------SSSSSSSSSS---------------%%%%-----CSS--------g------------------------------------------------------%----------QQQQ-----
----------------------------------------------r---SSSS--||-------------%%%%%%------------------------------------SSS------------oo--------------------
-----------------g------------------------%%%%%%--------||--SS--2-------||||------------------------------------------------------------SSS-----------
-----------------#-------------------------||||---------||-----2-2------||||-----------S-------------------------------------------------------y------
----------S-----##----------TTSSSSSSSSSS%%-||||ooo------||--------2-----||||----SU-------------------------------------------TT---%%%%%-----Q?SSQQQ---
---------------###----------TTSSSSSSSSSS|--||||--r----U-||--------------||||--------TT---t------------TT---------------------TT----|||----------------
--------------####----------TTSSSSSSSSSS|%%%%%%%%%------||--------------||||--------TT---t------------TT----TT---------------TT----|||----------------
-M-----------#####------ggg-TTSSSSSSSSSS|-||||||||------||--------------||||-------kTT--kt------g-g---TT-k--TT-----------y---TT----|||----------------
XXXXXXXXXXXXXXXXXXXXXXXXXXXXXXXXXXXXXXXX|-||||||||----%%%%%----XXXXXXX--||||----XXXXXXXXXXXXXXXXXXXXXXXXXXXXXX%%%%----%%XXXXXXXXXX%|||------XX--XXXXXX
XXXXXXXXXXXXXXXXXXXXXXXXXXXXXXXXXXXXXXXX|-||||||||-----|||-----XXXXXXX--||||----XXXXXXXXXXXXXXXXXXXXXXXXXXXXXX|||------|XXXXXXXXXX-|||------XX--XXXXXX
