------------------------------------------------------------------------------------------------------------------------------------------------------
------------------------------------------------------------------------------------------------------------------------------------------------------
------------------------------------------------------------------------------------------------------------------------------------------------------
S-----SSSS---------------------------------------------------------SSS--------------------------------------------------------------------------------
S----------------------------------------g------------------------------------------------------------------------------------------------------------
S----------------------SSS--------------%%-------------oooo-----------------------------oo----------oo------------------------------------------------
S---------------------------------------|--------------%%%%-----CSS--------1----oo------------------%%%---------------------------%----------QQQQ-----
S--------------------g------------------|----oo---SSSS--||------------------------------------------||--o----R----------------------------------------
S-------------------%%%-----------------|---------------||--SS--2-----------------------------------||-%%%-------------y----------------SSS-----------
S-----------Q--?----||----SSS-----------|---------------||-----2-2---------ggg---SS-----------------||--|--------------X-------SSS-------------y------
S------------------S||------------------|---------------||--------2---#########----------S------TT--||--|-------------XX%---------%%%%%-----Q?SSQQQ---
S-------------------||----------------tt|-------------U-||--------------------#-----------------TT--||-o|------------XXX-----------|||----------------
S-------------------||----------------tt|---------------||--------------------#-----------------TT--||%%%%%---------XXXX-----------|||----------------
S--M--------------K-||----oo----------tt|---------------||--------------------#-------------k---TT--||-|||---------XXXXX---------r-|||----------------
XXXXXXXXXXXXXXXXXXXX||---%%%--XXXXXXXXXX|----%%%%-----%%%%%----XXXXXXX--------X-----------XXXXXXXXXX||-|||----XXXXXXXXXX----XXXXXX%|||------XX--XXXXXX
XXXXXXXXXXXXXXXXXXXX||----|---XXXXXXXXXX|-----||-------|||-----XXXXXXX--------X-----------XXXXXXXXXX||-|||----XXXXXXXXXX----XXXXXX-|||------XX--XXXXXX
