------------------------------------------------------------------------------------------------------------------------------------------------------
------------------------------------------------------------------------------------------------------------------------------------------------------
------------------------------------------------------------------------------------------------------------------------------------------------------
--------------------SSSSSSSSSS------------------------------------------------------------------------------------------SSSSSSSSSS--------------------
------------------------------------------------------------------------------------------------------------------------------------------------------
----------------------------------------------------------------------------------------oo------------------------------------------------------------
---------------------------------------------------------------------------g----oo---------------------------------oo---------------------------------
-----------------------------------------------------------------------%%%%%%-------------------------------------------------------------------------
------------------------------------------------------------------------||||---------------------------------------------------------g#---------------
-----------------------------C------------------------------------------||||-----SSS--------------oo--------------------------------g##---------------
-----------------------#-#------QQQQ------------------S--------------#--||||-------------S---------------------%%%%--%%%------------###-----#---------
-----------------K---#-#-#-#---------K-B----------TT----------------##--||||-------------------TT-----TT--------||----||--SS-------####-----##--------
------------B--------#-#-#-#-----------b----------TT--------TT-----###--||||-------------------TT-----TT----TT--||----||--SS------#####-----###------#
-M----------b--------#-#-#-#-E---------b----y-y---TT------k-TT----####--||||----------------y--TT-----TT-k--TTo-||----||--SS------#####-----####----##
XXXXXXXXXXXXXXXXXXXXXXXXXXXXXXXXXXXXXXXXXXXXXXXXXXXXXXXXXXXXXXXXXXXXXX--||||--------------XXXXXXXXXXXXXXXXXXXX%-||----||--XX--XXXXXXXXX--XXXXXXXXXXXXX
XXXXXXXXXXXXXXXXXXXXXXXXXXXXXXXXXXXXXXXXXXXXXXXXXXXXXXXXXXXXXXXXXXXXXX--||||--------------XXXXXXXXXXXXXXXXXXXX--||----||--XX--XXXXXXXXX--XXXXXXXXXXXXX
