------------------------------------------------------------------------------------------------------------------------------------------------------
------------------------------------------------------------------------------------------------------------------------------------------------------
------------------------------------------------------------------------------------------------------------------------------------------------------
--------------------------------------------------------------------------------SSSSSSSSSS----------------------------------------SSSSSSSS------------
------------------------------------------------------------------------------------------------------------------------------------------------------
------------------------------------------------------------------------------------------------------------------------------------------------------
--------------------S---------------------------------------------SSoo-----g---------------------------------R------------------------------SS--------
---------------------------TT------------------------------------------%%%%%%----------------------------r--------------------------------------------
---------------------------TT-------------------------------------------||||------------------------%%%%%%%-------------------------------------------
---------------------------XX-------------------------------------------||||-----------S-------oooo-||||||--------------SS-?Q-------------------------
-----------------------TT-----------------------------S-----%%%%%%------||||----SU------------------||||||-----------------------------g##--SS--------
-----------------------TT-------------------------TT---------||||-------||||--------TT---t----------||||||-----------------------------###--------#-TT
-----------------------TT-------------------------TT---------||||-------||||--------TT---t----------||||||---------B-----------y-----g####-------##-TT
---M------k---ggg---k--TT---------k-k-------------TT------k--||||-------||||-------kTT--kt----------||||||--oo-----b-------SSSSS-----#####------###-TT
XXXXXXXXXXXXXXXXXXXXXXXXXXXXXXXXXXXXXXX-X-XX-XX-XXXXXXXXXXXX-||||-------||||----XXXXXXXXXX%%%%%%%-%%||||||--%%XXXXXXXXXX-------XX-XXXXXXXX--XXXXXXX-XX
XXXXXXXXXXXXXXXXXXXXXXXXXXXXXXXXXXXXXXX-X-XX-XX-XXXXXXXXXXXX-||||-------||||----XXXXXXXXXX||||||---|||||||---|XXXXXXXXXX-------XX-XXXXXXXX--XXXXXXX-XX
