------------------------------------------------------------------------------------------------------------------------------------------------------
------------------------------------------------------------------------------------------------------------------------------------------------------
------------------------------------------------------------------------------------------------------------------------------------------------------
------------------------------------------------------------SSSSSSSSSS------------------------------SSSSSSSSSSSSSSSSSSSS------------------------------
------------------------------------------------------------SSSS--SSSS--------------------------------------------------------------------------------
--------------------------------------oo--------------------SSSS--SSSS------------------oo------------------------------------------------------------
-----------------------------------SSSS-----------------------SS---S------SS----oo--------------------------------------------------------------------
--------------------------------------------------------------SS---S--------------------------------------------------------------oo------------------
---------------------------------------------------------TT---SS---S----------------------------------------------------------------------------------
---------------------------------------------------TT----TT-ooSS---SoU-----------SSS--------------oo---------------------------SSS--------------------
------------------------------%--------------------TT----XX-SSSS---SSSSS-----SS----------S-------------------TT---------%------------------Q#---------
---------------------------------------------------TT------------------------------------------TT------TT----TT-----------------------------##--------
---------------------------------------------------TT------------------------------------------TT------TT----TT----TT-----------------------###------#
-M------------k-ggg------ggg----------------y-y----TT-------k--g-g--------------------------y--TT---g--TT----TT--g-TT------------r----------####----##
XXXXXXXXXXXXXXXXXXXXXXXXXXXXXX--%%%%--%%XXXXXXXXXXXXXXXXXXXXXXXXXXXXXX--------------------XXXXXXXXXXXXXXXXXXXXXXXXXXXXXX----XXXXXXXXXXXXXXXXXXXXXXXXXX
XXXXXXXXXXXXXXXXXXXXXXXXXXXXXX---||----|XXXXXXXXXXXXXXXXXXXXXXXXXXXXXX--------------------XXXXXXXXXXXXXXXXXXXXXXXXXXXXXX----XXXXXXXXXXXXXXXXXXXXXXXXXX
