------------------------------------------------------------------------------------------------------------------------------------------------------
------------------------------------------------------------------------------------------------------------------------------------------------------
------------------------------------------------------------------------------------------------------------------------------------------------------
--------------------------------------------------------------------------------SSSSSSSSSS----------SSSSSSSSSSSSSSSSSSSS------------------------------
------------------------------------------------------------------------------------------------------------------------------------------------------
----------------------------------------%%-------------oooo----------R--------------------------------------------------------------------------------
----------------------------------------|--------------%%%%---------------SSCSS------------------------------------------SSS----S!-------##-----------
----------------------------------------|----oo---------||-------------------------------------------------------------------------------##-----------
----------------------------------------|---------------||-----------------------------------------------------------------------------####-----------
----------------------------------------|---------SSS---||-----------------------------S--------g--------------------------------------####-----------
----------------!-----------TT--QQQQ----|---------------||-------%%%----QQQQ--QQSU--------------TT---------TT-T------------------S---######-----------
----------------------------TT-------K-B|-------------U-||--------|-----------------TT---t------TT------#--TT-T----------------------######--------#--
----------------------------TT---------b|---------------||--------|-----------------TT---t------TT-----##--TT-T----TT----------------######----K---#--
-M----------------------ggg-TT---------b|---------------||--------|----------------kTT--kt------TT--kk-##--TT-T--g-TT-------gg-g-g---######--------#--
XXXXXXXXXXXXXXXXXXXXXXXXXXXXXXXXXXXXXXXX|----%%%%-----%%%%%-%%%%%-|---XXXXXXXXXXXXXXXXXXXXXXXXXXXXX-XXXXX--XX-XXXXXXXXXXXXXXXXXXXXXXXXXXXXXXXXXXX--XXX
XXXXXXXXXXXXXXXXXXXXXXXXXXXXXXXXXXXXXXXX|-----||-------|||---|||--|---XXXXXXXXXXXXXXXXXXXXXXXXXXXXX-XXXXX--XX-XXXXXXXXXXXXXXXXXXXXXXXXXXXXXXXXXXX--XXX
