------------------------------------------------------------------------------------------------------------------------------------------------------
------------------------------------------------------------------------------------------------------------------------------------------------------
------------------------------------------------------------------------------------------------------------------------------------------------------
----------SSSSSSSSSS------------------------------SSSSSSS---SSSSSSSSSS--------------------------------------------------------------------------------
------------------------------------------------------------SSSS--SSSS--------------------------------------------------------------------------------
------------------------------------------------------------SSSS--SSSS------------------oo-------------------------k----------------------------k-----
------------------------------S-------------------QQ----------SS---S------------oo----------------------------S---SSSSSS-----------------##----SQS--SQ
--------------------------------------------------------------SS---S---------------------------------------------------------------------##-----------
-----------------------------------------------------------S--SS---S-------------------------------------------------------------------####-----------
------------------------------------------------------------ooSS---SoU---1-------SS------------oooo------------------------------------####-----------
----------@QQQQ---------------##--SSC-------------QQ--QQQ---SSSS---SSST------------------S------------%%%%%%-------------------------######----SQS--S?
----------------------------------------------------------------------T----TT--------------------------||||--------------------------######-----------
-----------------g-#--------------------------------------------------T----TT--------------------------||||---TT---------------------######-----------
-M--------------g#-#----------------------------------------k--g-g----T---kTT--------------------------||||---TT---------k----ggg----######--k------gg
XXXXXXXXXXXXXXXXXXXXXXXXX--XXXXX--XXXXXXX-XX-XX-XXXXXXXXX---XXXXXXXXXXXXXXXXXXXX----------%%%%%%%-%%%%-||||-%%XXXXXXXX--XXXXXXXXXXXXXXXXXXXXXXXXXXXXXX
XXXXXXXXXXXXXXXXXXXXXXXXX--XXXXX--XXXXXXX-XX-XX-XXXXXXXXX---XXXXXXXXXXXXXXXXXXXX----------||||||---||--||||--|XXXXXXXX--XXXXXXXXXXXXXXXXXXXXXXXXXXXXXX
