------------------------------------------------------------------------------------------------------------------------------------------------------
------------------------------------------------------------------------------------------------------------------------------------------------------
------------------------------------------------------------------------------------------------------------------------------------------------------
-------------------------------------------------------------------SSS--------------------------------------------------------------------------U-----
--------------------------------------------------?---------------------------------------------------------------------------------------------------
----------------------------------------------------------------------------------------oo------------------------------------------------------------
----------------------------------------------QQQQ--------------CSS--------g----oo------------------------2-------------SSS--------SSSS---------------
--------------------------------------------------SS-------------------%%%%%%-----------------------------------oooo------------------------------SS--
-----------------%%%----------------------------------------SS--2-------||||--------------------------------------------------------------------------
------------------||----------------------------k--------------2-2------||||-----SS-----------------o----------------------------------SSSS---SS------
---------Q--------||------------QQQQ----T-----?QQQ----------------2-----||||-------------S----------------2---T--------------------------------------#
-------------%%%%%||-----------------K-BT--------------SSS--------------||||----------------------------------T-------------------------------------##
--------------|||-||-------------------bT-------------------------------||||---------------------B------------T---------------TT-------------------###
--------------|||-||-----ggg-----------bT-------------------------------||||---------------------b------y--y--T---y-----------TT------------------####
XXXXXXXXXXX---|||-||XXXXXXXXXXXXXXXXXXXXXXXXXXXXXX-------------XXXXXXX--||||--------------XXXXXXXXXXXXXXXXXXXXXXXXXXXXXX----XXXXXX---------XXXXXX-XXXX
XXXXXXXXXXX---|||-||XXXXXXXXXXXXXXXXXXXXXXXXXXXXXX-------------XXXXXXX--||||--------------XXXXXXXXXXXXXXXXXXXXXXXXXXXXXX----XXXXXX---------XXXXXX-XXXX
