------------------------------------------------------------------------------------------------------------------------------------------------------
------------------------------------------------------------------------------------------------------------------------------------------------------
------------------------------------------------------------------------------------------------------------------------------------------------------
--------------------------------------------------------------------------------SSSSSSSSSS------------------------------------------------------------
------------------------------------------------------------------------------------------------------------------------------------------------------
--------------------------------------------------------------------------------------------oo--------------------------------------------------------
----------------------!-------S------------------------------------------------------------------------------@-----oo---------------------------------
------------------------------------------------------------------------------------------------------------------------------------------------------
-----------------%%%-------------------------------------------------------------------------------%--------------------------------------------------
------------------||-----------------------------------------------------1-------------S--------------------------------SS-?Q-------------------------
------------------||S@S!S-----##--SSC---------------------------------T---------SU--------SS--------SU----!--!-%%%%--%%%--------------------#---------
-------------%%%%%||--------------------------------K-----------------T----TT-------TT---t----------------------||----||--------------------##--------
--------------|||-||--------tt----------------------------------------T----TT-------TT---t---%%%%---------------||----||-------y------------###------#
-M------------|||-||-g------tt-----------------ggg---------g-y--------T---kTT------kTT--kt----||----------k---o-||----||---SSSSS------------####----##
XXXXXXXXXXX---|||-||XXXXXXXXXXXX--XXXXXX-XXXXXXXXXXXXXXXXXXXXXXXXXXXXXXXXXXXXXXXXXXXXXXXXX----||----XXXXXXXXXX%-||----||-------XX-XXXXXXXXXXXXXXXXXXXX
XXXXXXXXXXX---|||-||XXXXXXXXXXXX--XXXXXX-XXXXXXXXXXXXXXXXXXXXXXXXXXXXXXXXXXXXXXXXXXXXXXXXX----||----XXXXXXXXXX--||----||-------XX-XXXXXXXXXXXXXXXXXXXX
