------------------------------------------------------------------------------------------------------------------------------------------------------
------------------------------------------------------------------------------------------------------------------------------------------------------
------------------------------------------------------------------------------------------------------------------------------------------------------
----------SSSSSSSSSS----------SSSSSSSSSS------------------------------SSSSSSSSSS--------------------SSSSSSSSSS----------------------------------------
------------------------------------------------------------------------------------------------------------------------------------------------------
------------------------------------------------------------------------------------------------------------------------------------------------k-----
--------------------S---------------------------------------------SSoo--------------------------------------------------SSS--------SSSS--------SQS--SQ
---------------------------TT-------------------------------------------------TT----------------------------------------------------------------------
---------------------------TT----------S--------------------------------------TT----------------------------------------------------------------------
---------------------------XX----------S--------------------------------------TT--o------------oooo------------------------------------SSSS-----------
---------Q@QQQQ--------TT--------------S--------------------%%%%%%----------SCTT-------TT--------------------T---------------------------------SQS--S?
-----------------------TT------#--------------------K--------||||-------TT----TT-------TT--------------TT----T----------------------------------------
-----------------g-#---TT------#-#---------------------------||||-------TT----TT-------TT--------------TT----T----------------TT----------------------
----------------g#-#k--TT------#-#-------------y-----------g-||||-------TT---kTT-------TT-----------g--TT----T-k----kkk-------TT-------------k------gg
XXXXXXXXXXXXXXXXXXXXXXXXXXXXXXXXXXXXXXXXXXXXXXXXXXXXXXXXXXXX-||||-----XXXXXXXXXXXXXXXXXXXX%%%%%%%-%%XXXXXXXXXXXXXXXXXXXX----XXXXXX---------XXXXXXXXXXX
XXXXXXXXXXXXXXXXXXXXXXXXXXXXXXXXXXXXXXXXXXXXXXXXXXXXXXXXXXXX-||||-----XXXXXXXXXXXXXXXXXXXX||||||---|XXXXXXXXXXXXXXXXXXXX----XXXXXX---------XXXXXXXXXXX
