------------------------------------------------------------------------------------------------------------------------------------------------------
------------------------------------------------------------------------------------------------------------------------------------------------------
------------------------------------------------------------------------------------------------------------------------------------------------------
S-----SSSS------------------------------------------------------------SSSSSSSSSSooo-------------------------------------------------------------------
S---------------------------------------------------------------------------SSSS%%%-------------------------------------------------------------------
S---------------------------------------%%-------------------------------g--SSSS-|--------------------------------------------------------------------
S-----------------SCS-------------------|-------------------------------SS-------|--------SSS------%---------------oo---------------------------------
S--------------------------TT-----------|----oo-------------------------SS-------|--------------------------------------------------------------------
S--------------------------TT-----------|----------------------------o--SS-------|--------------------------------------------------------------------
S--------------------------XX-----------|------------------------y------SC--g-g--|---%%%%-------------------------------------------------------------
S-------------TT---2---TT------TT-------|----------------tt------##-----SS--SSSS-|----||----%%%----------------%%%%--%%%-------------------#----------
S-------------TT-------TT------TT-------|----------------tt-----###-------------%%%%%%||-----|--------------g---||----||------------------##----------
S-------------TT-------TT------TT-------|----------------tt----####--------------||||-||-----|--------------TT--||----||-----------------###-------F--
S--M----------TT----k--TT-----gTT-------|------------g-g-tt---#####--------------||||-||-----|--------------TTo-||----||--kkk--------y--####-------#--
XXXXXXXXXXXXXXXXXXXXXXXXXXXXXXXXXXXXXX--|----%%%%-XXXXXXXXXXXXXXXXX---XXXXXXXXXX-||||-||%%---|--------XXXXXXXX%-||----||XXXXXXXXXXXXXXXXXXXXXXXXXXXXXX
XXXXXXXXXXXXXXXXXXXXXXXXXXXXXXXXXXXXXX--|-----||--XXXXXXXXXXXXXXXXX---XXXXXXXXXX-||||-||-|---|--------XXXXXXXX--||----||XXXXXXXXXXXXXXXXXXXXXXXXXXXXXX
