------------------------------------------------------------------------------------------------------------------------------------------------------
------------------------------------------------------------------------------------------------------------------------------------------------------
------------------------------------------------------------------------------------------------------------------------------------------------------
--------------------------------------------------------------------------------------------------------------SS-------S------------------------------
------------------------------------------------------------------------------------------------------------------------------------------------------
------------------------------------------------------------------------------------------------------------------------------------------------------
------------------SC--!--------------------------------------------------------------1-----------------------@---------S-----------------##-----------
--------------------------------------------------------------------------------------------------oo----------------------------oo-------##-----------
----------------------------------------------------------------------o--------------------------------------------SSS-----------------####-----------
-----------------------------------oo--------------------------------------------------------------------------------------------------####-----------
--------------TT---2S@S!S---------o--o----------------S----------------------------QQQQ-------------SU----!--!---------S-----TT------######-----------
--------------TT-----------------------------K---BTT--------------------------#-----------------#--------------##------------TT------######-----------
--------------TT------------tt-------------------bTT-------------------------##-----------------#--------------##------------TT------######--------F--
-M------------TT-----g------tt-------------------BTT------k--y----------------------yy----------#---------k----##--------y---TT------######--------#--
XXXXXXXXXXXXXXXXXXXXXXXXXXXXXXXXXXXXXXXXXXXXXXXXXXXXXXXXXXXXXXXXXXXXXXXXXXXXXXXXXXXXXXXXXXXXXXXXXXXXXXXXXXXXXX-XX------XXXXXXXXXXXXXXXXXXXXXXXXXXXXXXX
XXXXXXXXXXXXXXXXXXXXXXXXXXXXXXXXXXXXXXXXXXXXXXXXXXXXXXXXXXXXXXXXXXXXXXXXXXXXXXXXXXXXXXXXXXXXXXXXXXXXXXXXXXXXXX-XX------XXXXXXXXXXXXXXXXXXXXXXXXXXXXXXX
