------------------------------------------------------------------------------------------------------------------------------------------------------
------------------------------------------------------------------------------------------------------------------------------------------------------
------------------------------------------------------------------------------------------------------------------------------------------------------
------------------------------------------------------------------------------------------------------------------------------------------------U-----
-----------------------------------------g------------------------------------------------------------------------------------------------------------
----------------------------------------%%-------------oooo---------------------K---------------------oo----------------------------------------------
------------------------------S---------|--------------%%%%---------------------SS----1-----------------------?SSS------SSS---------------------------
----------------------------------------|----oo---------||----------------------------------------------------------------------------------------SS--
----------------------------------------|---------------||-----------o--------------------------------------------------------------------------------
----------------------------------------|---------SSS---||-------y--------------------------------oo------------------------------------------SS------
------------------------------##--SSC---|---------------||-------##-------------SS----------------------------SSSSS------------------------#---------#
----------------------------------------|-------------U-||------###-------------------TT-------TT-----------------------------------------##--------##
----------------------------------------|---------------||-----####-------------------TT-------TT-----------tt----------------TT---------###-------###
-M------------k-ggg---------------------|---------------||----#####---gg--------------TT----y--TT-----ggg---tt--K-------------TT-----y--####------####
XXXXXXXXXXXXXXXXXXXXXXXXX--XXXXX--XXXXXX|----%%%%-----%%%%%-XXXXXXX---XXXXXXXXXXXXXXXXXXXXXXXXXXXXXXXXXXXXXXXXXXXXXXXXXX----XXXXXXXXXXXXXXXXXXXXX-XXXX
XXXXXXXXXXXXXXXXXXXXXXXXX--XXXXX--XXXXXX|-----||-------|||--XXXXXXX---XXXXXXXXXXXXXXXXXXXXXXXXXXXXXXXXXXXXXXXXXXXXXXXXXX----XXXXXXXXXXXXXXXXXXXXX-XXXX
