------------------------------------------------------------------------------------------------------------------------------------------------------
------------------------------------------------------------------------------------------------------------------------------------------------------
------------------------------------------------------------------------------------------------------------------------------------------------------
--------------------------------oo------SSSSSSSSSS-----------------SSS--------------------------------------------------------------------------------
---------------------------------------gSSSSSSSS--?---------------------------------------------------------------------------------------------------
-----------------------------------%%%%%SSSCSSSS----------------------------------g-------------------------------------------------------------------
------------------------------------||||SSSSSSSS----------------CSS-------------SSSSSSSS---------------------R---------------------------##-----------
------------------------------------||||----------SS-------------------------------------------------r--------------------------oo-------##-----------
------------------------------------||||--------------------SS--2-----------------------------------%%%%%%%----------------------------####-----------
------------------------------%%%%%-||||---ggg-----------------2-2-------------------------o--------||||||-----------------------------####-----------
----------Q-----------------TT-|||--||||SSSSSSSS------------------2------------------------------TT-||||||-------------------TT------######-#---------
----------------------------TT-|||--||||SSSSSSSS-------SSS---------------------------------------TT-||||||-----#-------------TT------######-##--------
----------------------------TT-|||--||||SSSSSSSS-------------------------------------------------TT-||||||-----#-------------TT------######-###------#
-------------------#----ggg-TT-|||--||||SSSSSSSS-------------------------------------------------TT-||||||--oo-#----ggg--y---TT------######-####----##
XXXXXXXXXXXXX--XXXXXXXXXXXXXXX-|||--||||XXXXXXXXXX-------------XXXXXXXX----XXXXXXXXXXX---XXXXXXXXXXX||||||--%%-XXXXXXXXXXXXXXXXXXXXXXXXXXXXXXXXXXXXXXX
XXXXXXXXXXXXX--XXXXXXXXXXXXXXX-|||--||||XXXXXXXXXX-------------XXXXXXXX----XXXXXXXXXXX---XXXXXXXXXXX||||||---|-XXXXXXXXXXXXXXXXXXXXXXXXXXXXXXXXXXXXXXX
