------------------------------------------------------------------------------------------------------------------------------------------------------
------------------------------------------------------------------------------------------------------------------------------------------------------
------------------------------------------------------------------------------------------------------------------------------------------------------
--------------------SSSSSSSSSS--------------------------------------------------ooo-------------------------------------------------------------------
--------------------------------------------------------------------------------%%%-------------------------------------------------------------------
---------------------------------------------------------------------------------|--------------------------------------------------------------------
------------------------------S-----------------------------------SSoo-----------|----------------------------?SSS--------oo---%%%-------##-----------
---------------------------------------------------------------------------------|----------------------------------------SS----||-------##----y------
---------------------------------------------------------TT----------------------|----------------------------------------------||-----####--#SS--o---
-----------------------------C---------------------TT----TT----------------------|---%%%%---------------------------------------||-----####-##--------
----------------!------#-#----##--SSC---------tt---TT----XX-%%%%%%---------------|----||--------------%%%%%%--SSSSS----------SS-||---######-##--SC----
---------------------#-#-#-#------------------tt---TT--------||||---------------%%%%%%||---------------||||---------------------||---######-##--------
---------------------#-#-#-#------------------tt---TT--------||||----------------||||-||---------B-----||||---------------------||---######-##---SSS--
---------------------#-#-#-#-E-----------g----tt---TT--------||||-----gg---------||||-||---------b-----||||-----K---------------||---######-##--------
XXXXXXXXXXXXXXXXXXXXXXXXXXXXXXXX--XXXXXXXXXXXXXXXXXXXXXXXXXX-||||-----XXXXXXXXXX-||||-||%%XXXXXXXXXX%%-||||-%%XXXXXXXXXX%%-----%%%XXXXXXXXXXXX------XX
XXXXXXXXXXXXXXXXXXXXXXXXXXXXXXXX--XXXXXXXXXXXXXXXXXXXXXXXXXX-||||-----XXXXXXXXXX-||||-||-|XXXXXXXXXX|--||||--|XXXXXXXXXX|-------||XXXXXXXXXXXX------XX
