------------------------------------------------------------------------------------------------------------------------------------------------------
------------------------------------------------------------------------------------------------------------------------------------------------------
------------------------------------------------------------------------------------------------------------------------------------------------------
S-----SSSS----------------------oo--------------------------------------------------------------------------------------------------------------------
S------------------------------------g-g--------------------------------------------------------------------------------------------------------------
S---------------------ooor---------%%%%%--------------------------------------------------------------------------------------------------------------
S--------------------%%%%%----------||||----------------------------------SSCSS-----y--------------------------------------------------US-------------
S---------------------|||-----------||||------------------------------------------#SSS------------oo------------oooo----------------------------------
S---------------------|||-----------||||-----------------------------------------##-------------------------------------------------------------------
S---------------------|||-----%%%%%-||||----------------------------------------###1-------------------------------------------------SS---------------
S-------------------%%%%%%%----|||--||||------tt---------tt-------------QQQQ--QQ###---------------------------T----------------------------S----------
S-------------------||||||-----|||--||||------tt---------tt---------------------###--SSS--------#-------------T---------------------------------------
S-------------------||||||--o--|||--||||------tt---------tt---------------------###-------------#---------*---T-------------------TT---------------F--
S--M------k---ggg---||||||-%%%-|||--||||-g----tt-----g-g-tt-gg-------g----------###-------------#---gg----*---T---y------k----ggg-TT---------------#--
XXXXXXXXXXXXXXXXXXXX||||||--|--|||--||||XXXXXXXXXXXXXXXXXXXXXXXXXXXXXXXXXXXXXXXXXXXXXX---XXXXXXXXXXXXXXXXXXXX-XXXXXXXXXXXXXXXXXXXXXXXXXX-X-XXXXXXXXXXX
XXXXXXXXXXXXXXXXXXXX||||||--|--|||--||||XXXXXXXXXXXXXXXXXXXXXXXXXXXXXXXXXXXXXXXXXXXXXX---XXXXXXXXXXXXXXXXXXXX-XXXXXXXXXXXXXXXXXXXXXXXXXX-X-XXXXXXXXXXX
