------------------------------------------------------------------------------------------------------------------------------------------------------
------------------------------------------------------------------------------------------------------------------------------------------------------
------------------------------------------------------------------------------------------------------------------------------------------------------
------------------------------SSSSSSSSSS------------------------------------------------------------SSSSSSSSSS----------------------------------------
------------------------------------------------------------------------------------------------------------------------------------------------------
-----------------------SSS--------------ooooo---------------------------------------------------------------------------------------------------------
----------------------------------------------------------------------------SSSS----------SSS------%---------------------------SSS%----------QQQQ-----
---------------------g--------------------------SS-----------o---o---o--------------------------------------------------------------------------------
--------------------%%%----------------S-SSSS------------TT-%%%-%%%-%%------------TT----------------------------------------------------SSS-----------
--------------------||----SSS----------S-----------TT----TT--|---|---|-------K----TT--------------------------------------------K--------------y------
---------Q---------%||-----------------S-----------TT----XX--|---|---|-----SSSSS--TT--------%%%------------TT------------------SSS%%%%%-----Q?SSQQQ---
--------------------||---------#-------------------TT--------|---|---|T-----------TT-----T---|----------#--TT--#-------------------|||----------------
--------------------||---------#-#----------%%%%%--TT--------|---|---|T---------T-TT-----T---|---------##--TT--#---------TT--------|||----------------
-M-----------%%%%---||----oo---#-#-----------|||---TT--------|---|-r-|T---------T-TT---k-T---|------kk-##--TT--#----ggg--TT--------|||----------------
XXXXXXXXXXX---||----||---%%%--XXXXXXXXXX%%---|||--XXXXXXXXXX%%%%%%%%%%XXXXXXXXXXXXXXXXXXXX---|------XXXXX--XX--XXXXXXXXXXXXXXXXXXX%|||------XX--XXXXXX
XXXXXXXXXXX---||----||----|---XXXXXXXXXX|----|||--XXXXXXXXXX-|||||||||XXXXXXXXXXXXXXXXXXXX---|------XXXXX--XX--XXXXXXXXXXXXXXXXXXX-|||------XX--XXXXXX
