------------------------------------------------------------------------------------------------------------------------------------------------------
------------------------------------------------------------------------------------------------------------------------------------------------------
------------------------------------------------------------------------------------------------------------------------------------------------------
----------SSSSSSSSSSSSSSSSSSSS---------------------oo-------------------------------------SSSSSSSSSS--------------------------------------------------
--------------------SSSSSSSSSS--------------------%%%%------------------------------------------------------------------------------------------------
--------------------SSSSSSSSSS---------------------||-------------------------------------------------------------------------------------------------
--------------------SSSSSSSSSS---------------------||--------------------------------------------------------R----------------------------------------
---------------------------------------------------||--SSS-----------------------------------------------r--------------------------------------------
---------------------------------------------------||-----------------------------TT----------------%%%%%%%-------------------------------------------
---------------------------------------------------||-----------1-----------------TT----------------||||||---------------------SSS--------------------
----------------------SSSSSS?----------------------||-----------------------------TT----------------||||||--------------%-----------------------------
----------------------SSSSS------------T-----------||-----------------------------TT-----Tt---------||||||---------------------------TT---------------
----------------------SSSSS------------T----------%||---------------------------T-TT-----Tt---------||||||---------B-----------------TT------------F--
-M-------------------------ooo-------kkT-------ggg-||-----------------gg--------T-TT---k-Tt---------||||||--oo-----b-------------r---TT------------#--
XXXXXXXXXXX--XX--X---XXXXXXXXXXXXXXXXXXX-XXXXXXXXX-||-------XXXXXXXXX-XXXXXXXXXXXXXXXXXXXXXXXXXXXXXX||||||--%%XXXXXXXXXX----XXXXXXXXXXXXXXXXXXXXXXXXXX
XXXXXXXXXXX--XX--X---XXXXXXXXXXXXXXXXXXX-XXXXXXXXX-||-------XXXXXXXXX-XXXXXXXXXXXXXXXXXXXXXXXXXXXXXX||||||---|XXXXXXXXXX----XXXXXXXXXXXXXXXXXXXXXXXXXX
