------------------------------------------------------------------------------------------------------------------------------------------------------
------------------------------------------------------------------------------------------------------------------------------------------------------
------------------------------------------------------------------------------------------------------------------------------------------------------
------------------------------------------------------------SSSSSSSSSS--------------------SSSSSSSSSS--------------------SSS-----SS--------------------
------------------------------------------------------------SSSS--SSSS-------------------------------------------------------------------------------o
------------------------------------------------------------SSSS--SSSS------------------oo------------------------------------------------------------
------------------SC---------US---------------QQQQ------------SS---S-------1----oo------------------------2-------------US---------SSSS---------------
--------------------------------------------------------------SS---S----------------------------------------------------------------------------SSS---
--------------------------------------------------------------SS---S---------------------------------------------------y----SSS-------------oo--------
------------------------------------------------k-----------ooSS---SoU-----ggg---SSS----------------o------------------X---------------SSSS-----------
-----SSS------TT---2--------####--SSC---T-----?QQQ-------tt-SSSS---SSS#########----------S----------------2-----------XXSSS-----------------SS--------
--------------TT-------y-#####----------T----------------tt-------------------#--------------------------------------XXX------------------------------
--------------TT----y-######------------T----------------tt-------------------#-------------------------------------XXXX------------------------------
--------------TT----######--------------T------------g-g-tt-k--g-g------------#-----------------g-g-----y--y-------XXXXX------------------------------
XXXXXXXXXXXXXXXXXXXXXXXX------XX--XXXXXXXXXXXXXXXXXXXXXXXXXXXXXXXXXXXX--------X-----------XXXXXXXXXXXXXXXXXXXXXXXXXXXXXXXXX------X---------X----------
XXXXXXXXXXXXXXXXXXXXXXXX------XX--XXXXXXXXXXXXXXXXXXXXXXXXXXXXXXXXXXXX--------X-----------XXXXXXXXXXXXXXXXXXXXXXXXXXXXXXXXX------X---------X----------
