------------------------------------------------------------------------------------------------------------------------------------------------------
------------------------------------------------------------------------------------------------------------------------------------------------------
------------------------------------------------------------------------------------------------------------------------------------------------------
----------------------------------------------------------------------SSSSSSSSSS----------------------------------------------------------------------
-----------------------------------------------------------------------------------------------------------------------------------------------------o
--------------------------------------------------------------------------------------------oo--------------------------------------------------------
----------------------!-------------------------------------------SSoo------------------------------------2----------------------------US-------------
------------------------------------------------------------------------------TT----------------------------------------------------------------SSS---
------------------------------------------------------------------------------TT--TT---------------%-------------------y--------------------oo--------
---------------------------------------------------------o--------------------TT--TT----------------o------------------X-------------SS---------------
--------SU------!---S@S!S-------QQQQ------------------------%%%%%%----------SCTT--TT------S---------------2-----------XX-------------------SSS--------
-------------------------------------K-B---------------------||||-------TT----TT--TT-----T---------------------------XXX------------------------------
----------------------------tt---------b---------------------||||-------TT----TTT-TT-----T---%%%%-------------------XXXX----------TT------------------
--M------------------g------tt---------b----y-y-----k--------||||-------TT---kTTT-TT---k-T----||--------y--y-------XXXXX-k----ggg-TT------------------
XXXXXXXXXXXXXXXXXXXXXXXXXXXXXXXXXXXXXXXXXXXXXXXXXX-XXXXXXXXX-||||-----XXXXXXXXXXXXXXXXXXXX----||----XXXXXXXXXXXXXXXXXXXXXXXXXXXXXXXXXXXX-X-X----------
XXXXXXXXXXXXXXXXXXXXXXXXXXXXXXXXXXXXXXXXXXXXXXXXXX-XXXXXXXXX-||||-----XXXXXXXXXXXXXXXXXXXX----||----XXXXXXXXXXXXXXXXXXXXXXXXXXXXXXXXXXXX-X-X----------
