------------------------------------------------------------------------------------------------------------------------------------------------------
------------------------------------------------------------------------------------------------------------------------------------------------------
------------------------------------------------------------------------------------------------------------------------------------------------------
--------------------SSSSSSSSSS------------------------------------------------------------------------------------------------------------------------
--------------------SSSSSSSSSS------------------------------------------------------------------------------------------------------------------------
--------------------SSSSSSSSSS---------------------------------------R------------------oo------------------------------------------------------------
--------------------SSSSSSSSSS--------------------------------------------------oo----------------------SSQSSS----------SS----------------------------
------------------------------------------------------------------------------------------------------------------------------------------------------
---------------------------------------------------------TT-------------------------------------------------------------------------------------------
---------------------------------------------------TT----TT----------------------SS-----------------------K----------------TT-------------------------
--------SU------------SSSSSS?-----------------tt---TT----XX------%%%---------------------S-------tt-----SSSSSS--!-----S----TT-------------------------
----------------------SSSSS-------------------tt---TT-------------|-----------------------T------tt---------------------t--TT-------------------------
----------------------SSSSS-------------------tt---TT-------------|-----------------------T------tt---------------------t--TT----------------------F--
--M-------k---ggg----------ooo----k-k----g----tt---TT-------------|-----------------------T------tt---------------------t--TT-----k----------------#--
XXXXXXXXXXXXXXXXXXXX-XXXXXXXXXXXXXXXXXX-XXXXXXXXXXXXXXXXXXXX%%%%%-|---X----XXXXX----------XXXXXXXXXXXXXXXXXXXXXXXXXXXXXXXXXXXXXXXXXX---XXXXXXXXXXXXXXX
XXXXXXXXXXXXXXXXXXXX-XXXXXXXXXXXXXXXXXX-XXXXXXXXXXXXXXXXXXXX-|||--|---X----XXXXX----------XXXXXXXXXXXXXXXXXXXXXXXXXXXXXXXXXXXXXXXXXX---XXXXXXXXXXXXXXX
