------------------------------------------------------------------------------------------------------------------------------------------------------
------------------------------------------------------------------------------------------------------------------------------------------------------
------------------------------------------------------------------------------------------------------------------------------------------------------
--------------------------------oo----------------SSSSSSSSSS----------SSSSSSSSSSSSSSSSSSSL------------------------------------------------------------
---------------------------------------g--------------SS--SS------------------------------------------------------------------------------------------
-----------------------------------%%%%%--------------SS--SS--------------------------------oo--------------------------------------------------------
------------------------------------||||------------SS------------------------------oooooo--------------SSQSSS-----------SSS----S!%-------------------
------------------------------------||||------------SS------------------------TT----------------------------------------------------------------------
-----------------g------------------||||------------SS------------------------TT----SSSSSS---------%-------------------y----------------SSS-----------
-----------------#------------%%%%%-||||------------SS----oo------------------TT----SSSSSS----------------K------------X------------------------------
----------S-----##----------TT-|||--||||------------SSSS--SS----------------SCTT----------S-------------SSSSSS--------XX---------S%%%%%-------#LSS----
---------------###----------TT-|||--||||--------------SS-------------T--TT----TT-------------------------------------XXX-----------|||--------#-------
--------------####----------TT-|||--||||--------------SS-----B-------T--TT----TT-------------%%%%-------------------XXXX-----------|||--------#-------
---M---------#####------ggg-TT-|||--||||---------------------b-------T--TT---kTT--------------||-------------------XXXXX----gg-g-g-|||------kk#-------
XXXXXXXXXXXXXXXXXXXXXXXXXXXXXX-|||--||||X-XX-XX-XXXXXXXXXXXXXXXXXX--XXXXXXXXXXXX---XXXXXXX----||----XXXXXXXXXXXXXXXXXXXXXXXXXXXXXX%|||------XXXXXXX---
XXXXXXXXXXXXXXXXXXXXXXXXXXXXXX-|||--||||X-XX-XX-XXXXXXXXXXXXXXXXXX--XXXXXXXXXXXX---XXXXXXX----||----XXXXXXXXXXXXXXXXXXXXXXXXXXXXXX-|||------XXXXXXX---
