------------------------------------------------------------------------------------------------------------------------------------------------------
------------------------------------------------------------------------------------------------------------------------------------------------------
------------------------------------------------------------------------------------------------------------------------------------------------------
----------------------------------------SSSSSSSSSS----------------------------------------------------------------------SSS-----SS--------------------
------------------------------------------------------------------------------------------------------------------------------------------------------
------------------------------------------------------------------------------------------------------------------------------------------------------
-----------------------------------------oooo------------------------------1---------SSSS-------------------------------US---------------##-SSS-------
----------------------------------------------------------------------------------------------------oo-----------------------------------##-----------
-----------------g-----------------------SSSS-U----------------------o-------------------------------------------------y----SSS--------####-----------
-----------------#-----------------oo---oS--SoS------------------y---------ggg-----------------------------------------X---------------####------SSSSS
----------S-----##----------------o--o--SS--SSS----------tt------##---#########-Q----------------------------T--------XXSSS----------######-----------
---------------###---------------------------------------tt-----###-----------#------------------------------T-------XXX-------------######-----------
--------------####---------------------------------------tt----####-----------#------------------B-----------T------XXXX-------------######-SSS-------
-M-----------#####------------------------kk---------g-g-tt---#####-----------#--ggg-------------b--------y--T-----XXXXX-------------######--------r--
XXXXXXXXXXXXXXXXXXXXXXXXX--XXXXXXXXXXXXXXXXXXXXXXXXXXXXXXXXXXXXXXXX-----------X-XXXXX----XXXXXXXXXXXXXXXXXXXXXXXXXXXXXXXXXX------XXXXXXXXXXX-----XXXXX
XXXXXXXXXXXXXXXXXXXXXXXXX--XXXXXXXXXXXXXXXXXXXXXXXXXXXXXXXXXXXXXXXX-----------X-XXXXX----XXXXXXXXXXXXXXXXXXXXXXXXXXXXXXXXXX------XXXXXXXXXXX-----XXXXX
