------------------------------------------------------------------------------------------------------------------------------------------------------
------------------------------------------------------------------------------------------------------------------------------------------------------
------------------------------------------------------------------------------------------------------------------------------------------------------
----------------------------------------SSSSSSSSSS------------------------------------------------------------------------------------------SSSSSSSSSS
------------------------------------------------------------------------------------------------------------------------------------------------------
------------------------------------------------------------------------------------------------------------------------------------------------------
---------------------LSSS----------------oooo---------------------------------------------------------------------------SS-------------US-------------
--------------------------------o----ooo----------------------------------------------------------oo--------------------------------------------------
-----------------g-----------------------SSSS-U-------------------------------------------------------------------------------------------------------
-----------------#----------------------oS--SoS-----------------1--------1--------o----------------------------------------TT--------SS---------------
----------S-----##---2-----#----------%%SS--SSS-------S---------------T----------------TT----------------------------------TT--------------S--TT------
---------------###---------#-----------|----------TT------------------T----TT----------TT-------#-----TT----------------t--TT-----------------TT------
--------------####---------##----------|----------TT------------------T----TT----------TT-------#-----TT----TT-----B----t--TT-----TT----------TT------
-M-----------#####----kk---##--%%%%%%%-|--kk------TT------k-----------T---kTT----------TT-------#-----TT-k--TT-----b----t--TT-----TT----------TT------
XXXXXXXXXXXXXXXXXXXXXXXXXXXXXX--|||||--|XXXXXXXXXXXXXXXXXXXXXXXXXXXXX-XXXXXXXXXXXXXXXXXXXXXXXXXXXXXXXXXXXXXXXXXXXXXXXXXXXXXXXXXXXXXXXXXX-X-XXXXX--XXXX
XXXXXXXXXXXXXXXXXXXXXXXXXXXXXX--|||||--|XXXXXXXXXXXXXXXXXXXXXXXXXXXXX-XXXXXXXXXXXXXXXXXXXXXXXXXXXXXXXXXXXXXXXXXXXXXXXXXXXXXXXXXXXXXXXXXX-X-XXXXX--XXXX
