------------------------------------------------------------------------------------------------------------------------------------------------------
------------------------------------------------------------------------------------------------------------------------------------------------------
------------------------------------------------------------------------------------------------------------------------------------------------------
----------------------------------------SSSSSSSSSS----------------------------------------------------------------------------------------------------
----------------------------------------SSSSSSSS-------------------------o----------------------------------------------------------------------------
----------------------------------------SSSCSSSS-------oooo-------------%%%-----K---------------------------------------------------------------------
----------------------------------------SSSSSSSS-------%%%%--------------|--o---SS----1---------------------------------------------------------------
--------------------------------------------------------||---------------|--SSSS--------------------------TT----------------------oo------------------
--------------------------------------------------------||------------%--|--------------------------------TT------------------SSS---------------------
-------------------------------------------ggg----SSS---||---------------|--------------------------------TT------------------------------------------
--------------------SS------------------SSSSSSSS--------||---------------|------SS---------------tt------SXXS-----------%------------------Q----------
---------------------K---TT-----------ttSSSSSSSS------U-||---------------|------------TT--T------tt------------#--------------------------------------
-------------------------TT-----------ttSSSSSSSS--------||---------------|-----%------TT--T------tt-TT---------#-----------------------------------F--
-M--------k---ggg--------TT-----------ttSSSSSSSS--------||---y-----------|------------TT--T------tt-TT---------#----ggg----------r-----------------#--
XXXXXXXXXXXXXXXXXXXXXXXXXXXXXXXXXXXXXXXXXXXXXXXXXX----%%%%%-XXXXXXXXXX%%%%%%----XXXXXXXXXXXXXXXXXXXXXXXXXXXXXX-XXXXXXXXX----XXXXXXXXXXXXXXXXXXXXXXXXXX
XXXXXXXXXXXXXXXXXXXXXXXXXXXXXXXXXXXXXXXXXXXXXXXXXX-----|||--XXXXXXXXXX|||||-----XXXXXXXXXXXXXXXXXXXXXXXXXXXXXX-XXXXXXXXX----XXXXXXXXXXXXXXXXXXXXXXXXXX
