------------------------------------------------------------------------------------------------------------------------------------------------------
------------------------------------------------------------------------------------------------------------------------------------------------------
------------------------------------------------------------------------------------------------------------------------------------------------------
----------------------------------------------------------------------------------------------------------------------------------SSSSSSSS------------
------------------------------------------------------------------------------------------------------------------------------------------------------
------------------------------------------------------------------------------------------------------------------------------------------------------
--------------------------------------------------------------USSS-------------------SSSS-----------------------------US------------------------------
--------------------------------o----ooo------------------------------------------------------------oo------------------------------------------------
-------------------------------------------------------------------------------g----------------------------------------------------------------------
------------Q--?----------------------------------------------------------------------------------------------------E----------SSS--------------------
---------Q---------S------------------%%---------------ooo---S-----TT--------S@SQ----------------------------T-----TT---%--------------g##------------
---------------------------------------|T-----TT-------------------TT----------------------------------------T-----TT--t---------------###------------
---------------------------------------|T-----TT-------------------TT----------------------------------------T-----TT--t-------------g####---------F--
------------------K------ggg---%%%%%%%-|T-----TT-------------ggg---TT------------ggg---------------g------y--T--g--TT--t---------r---#####---------#--
XXXXXXXXXXXXXXXXXXXXXXXXXXXXXX--|||||--|XXXX--XXXX--XXXXXXXXXXXXXXXXXX-XXXXXXXXXXXXXX----X-XXXXXXXXXXXXXXXXXXXXXXXXXXXXX----XXXXXXXXXXXXXX--XXXXXXXXXX
XXXXXXXXXXXXXXXXXXXXXXXXXXXXXX--|||||--|XXXX--XXXX--XXXXXXXXXXXXXXXXXX-XXXXXXXXXXXXXX----X-XXXXXXXXXXXXXXXXXXXXXXXXXXXXX----XXXXXXXXXXXXXX--XXXXXXXXXX
