------------------------------------------------------------------------------------------------------------------------------------------------------
------------------------------------------------------------------------------------------------------------------------------------------------------
------------------------------------------------------------------------------------------------------------------------------------------------------
------------------------------------------------------------------------------------------------------------------------------------------------------
------------------------------------------------------------------------------------------------------------------------------------------------------
----------------------ooor----------------------------------------------------------------------------------------------------------------------------
------------------Q--%%%%%--------------------------------------------------------------------------------------------------------%-------------------
----------------------|||------------------------------------o---o---o--------------------------------------------------------------------------------
----------------------|||-----------------------------------%%%-%%%-%%---------g--------------------------------------------------------SSS-----------
----------------------|||--------------------------------o---|---|---|------------o--------o----------------------------------------------------------
--------SU--------?-%%%%%%%-----QQQQ-------------------------|---|---|-------S@S-------TT--------TT-------------!-----S-----------%%%%%-----#---------
--------------TT----||||||-----------K-B---------------------|---|---|-----------------TT--------TT---------g----------------------|||------##--------
--------------TT----||||||--o----------b---------------------|---|---|-----------------TT--------TT---------TT---------------------|||------###------#
--M-----------TT----||||||-%%%---------b----y-y-----k--------|---|-r-|-----------------TT--------TT---------TT-----------k----ggg--|||------####----##
XXXXXXXXXXXXXXXXXXXX||||||--|-XXXXXXXXXXXXXXXXXXXX-XXXXXXXXX%%%%%%%%%%-XXXXXXXXXXXXXXXXXXXXXXXXXXXXX--XXXXXXXXXXXXXXXXXXXXXXXXXXXX%|||------XXXXXXXXXX
XXXXXXXXXXXXXXXXXXXX||||||--|-XXXXXXXXXXXXXXXXXXXX-XXXXXXXXX-|||||||||-XXXXXXXXXXXXXXXXXXXXXXXXXXXXX--XXXXXXXXXXXXXXXXXXXXXXXXXXXX-|||------XXXXXXXXXX
