------------------------------------------------------------------------------------------------------------------------------------------------------
------------------------------------------------------------------------------------------------------------------------------------------------------
------------------------------------------------------------------------------------------------------------------------------------------------------
----------SSSSSSSSSS--------------------------------------------------SSSSSSSSSS----------------------------------------SSS-----SS--------------------
--------------------------------------------------?---------------------------------------------------------------------------------------------------
--------------------------------------------------------------------------------K---------------------------------------------------------------k-----
--------------------USS---------------------------------------------------------SS----1---------------------------------US---------------------SQS--SQ
--------------------------------o----ooo----------SS--------------------------TT------------------oo--------------------------------------------------
------------------------------------------------------------------------------TT--------------------------------------------SSS-----------------------
------------------------------------------------------------------------------TT----------------------------------------------------------------------
----------@QQQQ-----------------------%%------------------------------------SCTTSS------------------------------!-----S-SSS--------------------SQS--S?
---------------------B-----------------|-----K---B-----SSS--------------TT----TT------TT--------#-----------g-----------------------------------------
-----------------g-#-b-------B---------|---------b----------------------TT----TT------TT--------#-----------TT----------------------------------------
-M--------------g#-#-B-------b-%%%%%%%-|---------B-----------y----------TT---kTT------TT--------#-----------TT-------------------------------k------gg
XXXXXXXXXXXXXXXXXXXXXXXXXXXXXX--|||||--|XXXXXXXXXX----------XXXXXXXXXXXXXXXXXXXXXXXXXXXXXXXXXXXXXXXX--XXXXXXXXXXXXXXXXXXXXX------XXXXXXXXXXXXXXXXXXXXX
XXXXXXXXXXXXXXXXXXXXXXXXXXXXXX--|||||--|XXXXXXXXXX----------XXXXXXXXXXXXXXXXXXXXXXXXXXXXXXXXXXXXXXXX--XXXXXXXXXXXXXXXXXXXXX------XXXXXXXXXXXXXXXXXXXXX
