------------------------------------------------------------------------------------------------------------------------------------------------------
------------------------------------------------------------------------------------------------------------------------------------------------------
------------------------------------------------------------------------------------------------------------------------------------------------------
-----------------------oo-------oo----------------------------------------------------------------------------SS-------S------------------------------
---------------------------------------g--------------------------------------------------------------------------------------------------------------
-----------------------------------%%%%%ooooo---------------------------------------------------------------------------------------------------------
----------------------SSSS----------||||------------------------------------------------------------------2------------SSSS---------------------------
------------------------------------||||--------SS----------------------------------------------------------------------------------------------------
------------------------------------||||-SSSS-------------------------------------TT-------------------------------SSS--------------------------------
------------Q--?--------------%%%%%-||||---------------------------------1--------TT----------------o-------------------------------------------------
-----SSS-----------S------%%%%-|||--||||-----------------tt-----------T-----------TT----------------------2------------S------------------------------
---------------------------|||-|||--||||-----------------tt-----------T----TT-----TT-----T---------------------##----------------------------------#--
---------------------------|||-|||--||||----%%%%%--------tt-----------T----TT---T-TT-----T-------B-------------##-------------TT---------------K---#--
------------------K--------|||-|||--||||-----|||-----g-g-tt--y--------T---kTT---T-TT---k-T-------b------y--y---##-------------TT-------------------#--
XXXXXXXXXXXXXXXXXXXX%%%----|||-|||--||||%%---|||--XXXXXXXXXXXXXXXXXXXXXXXXXXXXXXXXXXXXXXXXXXXXXXXXXXXXXXXXXXXX-XX------X----XXXXXXXXXXXXXXXXXXXXX--XXX
XXXXXXXXXXXXXXXXXXXX||-----|||-|||--|||||----|||--XXXXXXXXXXXXXXXXXXXXXXXXXXXXXXXXXXXXXXXXXXXXXXXXXXXXXXXXXXXX-XX------X----XXXXXXXXXXXXXXXXXXXXX--XXX
