------------------------------------------------------------------------------------------------------------------------------------------------------
------------------------------------------------------------------------------------------------------------------------------------------------------
------------------------------------------------------------------------------------------------------------------------------------------------------
----------------------------------------SSSSSSSSSS----------------------------------------------------------------------SSS-----SS----------SSSSSSSSSS
----------------------------------------SSSSSSSS------------------------------------------------------------------------------------------------------
----------------------ooor--------------SSSCSSSS------------------------------------------------------------------------------------------------------
---------------------%%%%%--------------SSSSSSSS--Q----------------------------------1-----------------------R----------US----------------------------
----------------------|||----------------------------------------------------------------------------r------------------------------------------------
----------------------|||---------------------------------------------------------------------------%%%%%%%-----------------SSS-----------------------
----------------------|||------------------ggg------------------------------------------------------||||||--------------------------------------------
--------------------%%%%%%%-------------SSSSSSSS--Q--------------------------------QQQQ-------------||||||------!-----S-SSS-------------------TT------
--------------------||||||-------------TSSSSSSSS----------------------------------------------------||||||------------------------------------TT------
--------------------||||||--o----------TSSSSSSSS-------------------------------------------------B--||||||------------------------------------TT------
-M------------k-ggg-||||||-%%%-------kkTSSSSSSSS-----gg----kgg-------ggg------------yy-----------b--||||||--oo--------------------k-----------TT------
XXXXXXXXXXXXXXXXXXXX||||||--|-XXXXXXXXXXXXXXXXXXXXXXXXXXXXXXXXXXXXXXXXXXXXXXXXXXXXXXXXXXXXXXXXXXXXXX||||||--%%XXXXXXXXXXXXX------XXX---XXXXXXXXX--XXXX
XXXXXXXXXXXXXXXXXXXX||||||--|-XXXXXXXXXXXXXXXXXXXXXXXXXXXXXXXXXXXXXXXXXXXXXXXXXXXXXXXXXXXXXXXXXXXXXX||||||---|XXXXXXXXXXXXX------XXX---XXXXXXXXX--XXXX
