------------------------------------------------------------------------------------------------------------------------------------------------------
------------------------------------------------------------------------------------------------------------------------------------------------------
------------------------------------------------------------------------------------------------------------------------------------------------------
S-----SSSSSSSSSSSSSS--------------------------------------------------------------------------------------------------------------SSSSSSSS------------
S----------------------------------------g-----------------------------------------------------------------------------------------------------------o
S---------------------------------------%%----------------------------------------------oo------------------------------------------------------------
S---------------------------------------|---------------------------------SSCSS-oo----------------------------------------SSC-------------------------
S---------------------------------------|----oo-----------------------------------------------------------------oooo----------------------------SSS---
S---------------------------------------|---------------------------------------------------------------------------------------------------oo--------
S---------------------------------------|----------------------------------------SSS--------------------------------------SSS-------------------------
S-------------------SS------------------|----------------tt-------------QQQQ--QQ---------S-------tt-----------T------------------------g##--SS--------
S--------------------K---TT-----------K-|----------------tt-------------------------------T------tt---------g-T------------------------###------------
S------------------------TT---TTTT------|----------------tt-------------------------------T------tt---------TTT----------------------g####------------
S--M---------------------TT---TTTT------|------------g-g-tt--y----------------------------T------tt---------TTT---y--------------#---#####------------
XXXXXXXXXXX--XX--X--XXXXXXXXXXXXXXXXXXXX|----%%%%-XXXXXXXXXXXXXXXXXXXXXXXXXXXXXX----------XXXXXXXXXX--XXXXXXXXXXXXXXXXXXX----XXXXXXXXXXXXX------------
XXXXXXXXXXX--XX--X--XXXXXXXXXXXXXXXXXXXX|-----||--XXXXXXXXXXXXXXXXXXXXXXXXXXXXXX----------XXXXXXXXXX--XXXXXXXXXXXXXXXXXXX----XXXXXXXXXXXXX------------
