------------------------------------------------------------------------------------------------------------------------------------------------------
------------------------------------------------------------------------------------------------------------------------------------------------------
------------------------------------------------------------------------------------------------------------------------------------------------------
------------------------------SSSSSSSSSS------------------------------------------------------------SSSSSSSSSS----------------------------------------
------------------------------------------------------------------------------------------------------------------------------------------------------
----------------------ooor-----------------------------oooo-------------------------------------------------------------------------------------------
---------------------%%%%%-----------------------------%%%%-------SSoo----SS--------------------------------------------SS---------SSSS---------------
----------------------|||-------------------------SSSS--||--------------------------------------------------------------------------------------------
----------------------|||--------------S----------------||-------------------------------------------------------------y------------------------------
----------------------|||--------------S----------------||------------------------o-------------g----------------------X---TT----------SSSS-----------
----------Q---------%%%%%%%------------S----------------||--%%%%%%----SS-----SS--------TT-------TT-----------T--------XX---TT-------------------------
--------------------||||||-----#----------------------U-||---||||----------------------TT-------TT-----TT----T-------XXXt--TT----------------------#--
--------------------||||||--o--#-#----------------------||---||||----------------------TT-------TT-----TT----T------XXXXt--TT------------------K---#--
-M-----------------#||||||-%%%-#-#-------------ggg------||---||||----------------------TT-------TT--g--TT----T-----XXXXXt--TT----------------------#--
XXXXXXXXXXXXX--XXXXX||||||--|-XXXXXXXXXX-XXXXXXXXX----%%%%%--||||---------------XXXXXXXXXXXXXXXXXXX-XXXXXXXXXXXXXXXXXXXXXXXXXXXXXX---------XXXXXX--XXX
XXXXXXXXXXXXX--XXXXX||||||--|-XXXXXXXXXX-XXXXXXXXX-----|||---||||---------------XXXXXXXXXXXXXXXXXXX-XXXXXXXXXXXXXXXXXXXXXXXXXXXXXX---------XXXXXX--XXX
