------------------------------------------------------------------------------------------------------------------------------------------------------
------------------------------------------------------------------------------------------------------------------------------------------------------
------------------------------------------------------------------------------------------------------------------------------------------------------
----------------------------------------------------------------------SSSSSSSSSS--------------------SSSSSSSSSS----------------------------------------
--------------------------------------------?-------------------------------SSSS----------------------------------------------------------------------
-------------------------------------------------------oooo--------------g--SSSS--------oo------------------------------------------------------------
--------------------S----------------------------------%%%%-------------SS------oo---------SSS!--------------------------------SSS--------------------
---------------------------TT-----------------r---SSSS--||---o---o---o--SS---------------------------------------SSS--------------oo------------------
---------------------------TT-------------%%%%%%--------||--%%%-%%%-%%--SS----------------------------------------------------------------------------
---------------------------XX--------------||||---------||---|---|---|--SC--g-g--SS---------------------------------------------K---------------------
-------------------%---TT---------------%%-||||ooo------||---|---|---|--SS--SSSS---------S----C--------------T-----------------SSS---------Q----------
-----------------------TT-------------K-|--||||--r----U-||---|---|---|---------------------------------TT----T-------------------------------------#--
-----------------------TT-----TTTT------|%%%%%%%%%------||---|---|---|---------------------------------TT----T-----------TT--------------------K---#--
-M-----------%%%%---k--TT-----TTTT------|-||||||||------||---|---|-r-|-------------------------g-g--g--TT----T-----------TT------------------------#--
XXXXXXXXXXX---||----XXXXXXXXXXXXXXXXXXXX|-||||||||----%%%%%-%%%%%%%%%%XXXXXXXXXX----------XXXXXXXXXXXXXXXXXXXX%%%%----%%XXXXXXXXXXXXXXXXXXXXXXXXX--XXX
XXXXXXXXXXX---||----XXXXXXXXXXXXXXXXXXXX|-||||||||-----|||---|||||||||XXXXXXXXXX----------XXXXXXXXXXXXXXXXXXXX|||------|XXXXXXXXXXXXXXXXXXXXXXXXX--XXX
