------------------------------------------------------------------------------------------------------------------------------------------------------
------------------------------------------------------------------------------------------------------------------------------------------------------
------------------------------------------------------------------------------------------------------------------------------------------------------
--------------------------------------------------------------------------------------------------------------SS-------SSSSSSSSSSS--------------------
------------------------------------------------------------------------------------------------------------------------------------------------------
---------------------------------------------------------------------R--------------------------------oo----------------------------------------k-----
---------------------LSSS---------------------QQQQ-------Q-Q---------------1-------------------------------------------S-----------------------SQS--SQ
------------------------------------------------------------------------------------------------------------------------------------------------------
----------------------------------------------------------------------------------TT-------------------------------SSS--------------------------------
------------------------------------------------k--------------------------ggg----TT------------------------------------------------------------------
---------------------2-----#------------T-----?QQQ-------Q-Q-----%%%--#########---TT-----------------------------------S-----------------------SQS--S?
---------------------------#-----------TT-------------------------|-----------#---TT-----T---------------------##---------SS---------TT---------------
---------------------------##----------TT-------------------------|-----------#-T-TT-----T-------B----------tt-##---------SS---------TT---------------
-M------------k-ggg---kk---##--------kkTT-------------------------|-----------#-T-TT---k-T-------b----ggg---tt-##---------SS---------TT------k------gg
XXXXXXXXXXXXXXXXXXXXXXXXXXXXXXXXXXXXXXXXXXXXXXXXXXXXXXXXXXXX%%%%%-|-----------X-XXXXXXXXXXXXXXXXXXXXXXXXXXXXXX-XX------X--XX--XXXXXXXXXXXXXXXXXXXXXXXX
XXXXXXXXXXXXXXXXXXXXXXXXXXXXXXXXXXXXXXXXXXXXXXXXXXXXXXXXXXXX-|||--|-----------X-XXXXXXXXXXXXXXXXXXXXXXXXXXXXXX-XX------X--XX--XXXXXXXXXXXXXXXXXXXXXXXX
