------------------------------------------------------------------------------------------------------------------------------------------------------
------------------------------------------------------------------------------------------------------------------------------------------------------
------------------------------------------------------------------------------------------------------------------------------------------------------
--------------------------------------------------------------------------------SSSSSSSSSS------------------------------------------------------------
-------------------------------------------------------------------------o----------------------------------------------------------------------------
------------------------------------------------------------------------%%%---------------------------oo----------------------------------------------
-----------------------------U----------------QQQQ-----------------------|--o--------------------------------------------SSS----S!--------------------
-------------------------------------------------------------------------|--SSSS---------------------------------------------------------------y------
---------------------------------------------------------TT-----------%--|-----------------------------------------------------------g#------#SS--o---
------------------------------------------------k--TT----TT--------------|-------------S--------------------------------------------g##-----##--------
----------------------------##-TT-------T-----?QQQ-TT----XX--------------|------SU---------------tt------------------------------S--###-----##--SC----
-----------------------y-#####-TT-------T----------TT--------------------|----------TT---tT------tt--------------------------------####-----##--------
--------------------y-######---TT-------T----------TT--------------------|-----%----TT---tT------tt---------tt-----B--------------#####-----##---SSS--
-M------------k-ggg-######----gTT-------T----------TT--------y-----------|---------kTT--ktT------tt---ggg---tt-----b--------gg-g-g#####-----##--------
XXXXXXXXXXXXXXXXXXXXXXXX------XXXXXXXX--XXXXXXXXXXXXXXXXXXXXXXXXXXXXXX%%%%%%----XXXXXXXXXXXXXXXXXXXXXXXXXXXXXXXXXXXXXXXXXXXXXXXXXXXXXXX--XXXXX------XX
XXXXXXXXXXXXXXXXXXXXXXXX------XXXXXXXX--XXXXXXXXXXXXXXXXXXXXXXXXXXXXXX|||||-----XXXXXXXXXXXXXXXXXXXXXXXXXXXXXXXXXXXXXXXXXXXXXXXXXXXXXXX--XXXXX------XX
