------------------------------------------------------------------------------------------------------------------------------------------------------
------------------------------------------------------------------------------------------------------------------------------------------------------
------------------------------------------------------------------------------------------------------------------------------------------------------
S-----SSSSSSSSSSSSSS--------------------------------------------------SSSSSSSSSS----------------------------------------------------------------------
S---------------------------------------------------------------------------SSSS----------------------------------------------------------------------
S------------------------------------------------------------------------g--SSSS----------------------oo----------------------------------------------
S-----------------------------S---------------QQQQ----------------SSoo--SS---------USS----------------------------------SS------------------SS--------
S-----------------------------------------------------------------------SS----------------------------------------------------------------------------
S--------------------------------------------------------B--------------SS----------------------------------------------------------------------------
S-----------------------------------------------k--------b--------------SC--g-g----------------oooo------------------------TT-------------------------
S-----------------------------##--SSC---T-----?QQQ-----SS#CS%%%%%%------SS--SSSS--#----------------------------------------TT---------------SS--------
S---------------------------------------T--------------------||||-----------------#----------------------------#--------t--TT--------TT-----------#-TT
S---------------------------------------T------------------K-||||-----------------##------------------------tt-#--------t--TT--------TT----------##-TT
S------------------------ggg------------T--------------------||||-----------------##--gg--------------ggg---tt-#----ggg-t--TT--------TT---------###-TT
XXXXXXXXXXX--XX--X--XXXXXXXXXXXX--XXXXXXXXXXXXXXXXXXXXXXXXXX-||||-----XXXXXXXXXX--XXXXXXXX%%%%%%%-%%XXXXXXXXXX-XXXXXXXXXXXXXXXXXXXXXXXXXXXXXXXXXXXX-XX
XXXXXXXXXXX--XX--X--XXXXXXXXXXXX--XXXXXXXXXXXXXXXXXXXXXXXXXX-||||-----XXXXXXXXXX--XXXXXXXX||||||---|XXXXXXXXXX-XXXXXXXXXXXXXXXXXXXXXXXXXXXXXXXXXXXX-XX
