------------------------------------------------------------------------------------------------------------------------------------------------------
------------------------------------------------------------------------------------------------------------------------------------------------------
------------------------------------------------------------------------------------------------------------------------------------------------------
--------------------SSSSSSSSSS--------------------SSSSSSS-------------------------------------------SSSSSSSSSSSSSSSSSSSS------------------------------
--------------------SSSSSSSSSS------------------------------------------------------------------------------------------------------------------------
--------------------SSSSSSSSSS------------------------------------------------------------------------------------------------------------------------
------------------SCSSSSSSSSSS--------------------QQ-----------------------g--------------------------------------------SS---------SSSS------------SSS
-----------------------------------------------------------------------%%%%%%-------------------------------------------------------------------------
-----------------------------------------------------------S------------||||--------------------------------------------------------------------------
------------------------------------------------------------------------||||------o----------------------------------------TT----------SSSS-----------
--------------TT---2--SSSSSS?---QQQQ--------------QQ--QQQ---------------||||-----------TT-------TT---------TT-T------------TT---------------------#---
--------------TT------SSSSS----------K-B--------------------------------||||-----------TT-------TT------#--TT-T---------t--TT---------------------#---
--------------TT------SSSSS------------b--------------------------------||||-----------TT-------TT-----##--TT-T----TT---t--TT---------------------#---
-M------------TT-----------ooo---------b----y-y--------------y----------||||-----------TT---k---TT--kk-##--TT-T--g-TT---t--TT----------------ggg--#---
XXXXXXXXXXXXXXXXXXXX-XXXXXXXXXXXXXXXXXXXXXXXXXXXXXXXXXXXX---XXXXXXXXXX--||||----XXXXXXXXXXXXXXXXXXXXXXXXX--XX-XXXXXXXXXXXXXXXXXXXX---------XXXXXXXXXXX
XXXXXXXXXXXXXXXXXXXX-XXXXXXXXXXXXXXXXXXXXXXXXXXXXXXXXXXXX---XXXXXXXXXX--||||----XXXXXXXXXXXXXXXXXXXXXXXXX--XX-XXXXXXXXXXXXXXXXXXXX---------XXXXXXXXXXX
