------------------------------------------------------------------------------------------------------------------------------------------------------
------------------------------------------------------------------------------------------------------------------------------------------------------
------------------------------------------------------------------------------------------------------------------------------------------------------
--------------------------------------------------SSSSSSS---------------------------------SSSSSSSSSSSSSSSSSSSS----------------------------------------
------------------------------------------------------------------------------------------------------------------------------------------------------
------------------------------------------------------------------------------------------------------------------------------------------------------
--------------------S-----------------------------QQ--------------SSoo---------------1-----------------------------------SSS----S!-------##--QQQQ-----
---------------------------TT------------------------------------------------------------------------------------------------------------##-----------
---------------------------TT------------------------------S-------------------g-------------------------------------------------------####-----------
---------------------------XX----------------------------------------------------------------------------------------------------------####----y------
----------Q------------TT-------------------------QQ--QQQ---%%%%%%-----------S@S---QQQQ----------------------T--------r----------S---######-Q?SSQQQ---
-----------------------TT--------------TT-----TT-------------||||--------------------------------------TT----T----%%%%%%-------------######-----------
-----------------------TT--------------TT-----TT-------------||||--------------------------------------TT----T-----|||||-------------######-----------
-M-----------------#k--TT------------kkTT-----TT-------------||||-------------------yy----------g-g-g--TT----T-----|||||----gg-g-g---######-----------
XXXXXXXXXXXXX--XXXXXXXXXXXXXXXXXXXXXXXXXXXXX--XXXXXXXXXXX----||||------XXXXXXXXXXXXXXXXXXXXXXXXXXXXXXXXXXXXXXX-%%%-|||||XXXXXXXXXXXXXXXXXXXXXX--XXXXXX
XXXXXXXXXXXXX--XXXXXXXXXXXXXXXXXXXXXXXXXXXXX--XXXXXXXXXXX----||||------XXXXXXXXXXXXXXXXXXXXXXXXXXXXXXXXXXXXXXX--|--|||||XXXXXXXXXXXXXXXXXXXXXX--XXXXXX
