------------------------------------------------------------------------------------------------------------------------------------------------------
------------------------------------------------------------------------------------------------------------------------------------------------------
------------------------------------------------------------------------------------------------------------------------------------------------------
--------------------------------------------------SSSSSSS-------------SSSSSSSSSS----------------------------------------------------------------------
----------------------------------------------------------------------------SSSS---------------------------------------------------------------------o
-------------------------------------------------------------------------g--SSSS--------oo------------------------------------------------------------
--------------------------------------------------QQ--------------SSoo--SS------oo--------------------------------------------------------------------
------------------------------------------------------------------------SS------------------------oo------------oooo--------------oo------------SSS---
-----------------------------------------------------------S------------SS------------------------------------------------------------------oo--------
------------------------------------------------------------------------SC--g-g--SS-------------------------------------------------------------------
----------------%%%%------------------------------QQ--QQQ---%%%%%%------SS--SSSS---------S--------------------T----------------------------QSS--------
-----------------||--------------------T---------------------||||-------------------------------#-----------g-T---------------------------------------
-----------------||--------------------T---------------------||||-------------------------------#-----------TTT---------------------------------------
-M---------------||------------------kkT-------ggg-----------||||-------------------------------#-----------TTT---y------k----ggg---------------------
XXXXXXXXXXX--%%%%||%XXXXX--XXXXXXXXXXXXX-XXXXXXXXXXXXXXXX----||||-----XXXXXXXXXX----------XXXXXXXXXX--XXXXXXXXXXXXXXXXXXXXXXXXXXXXXXXXXXXXXX----------
XXXXXXXXXXX---||-||-XXXXX--XXXXXXXXXXXXX-XXXXXXXXXXXXXXXX----||||-----XXXXXXXXXX----------XXXXXXXXXX--XXXXXXXXXXXXXXXXXXXXXXXXXXXXXXXXXXXXXX----------
