------------------------------------------------------------------------------------------------------------------------------------------------------
------------------------------------------------------------------------------------------------------------------------------------------------------
------------------------------------------------------------------------------------------------------------------------------------------------------
----------------------------------------------------------------------SSSSSSSSSS--------------------SSSSSSSSSS--------------------SSSSSSSSSS----------
--------------------------------------------------?-------------------------SSSS----------------------------------------------------------------------
-------------------------------------------------------------------------g--SSSS----------------------------------------------------------------k-----
------------------SC--!-------------------------------------------------SS--------------------------------------------US-----------------------SQS--SQ
--------------------------------------------------SS--------------------SS----------------------------------------------------------------------------
------------------------------------------------------------------------SS--------TT------------------------------------------------------------------
------------------------------------------------------------------------SC--g-g---TT-----------oooo-----------------E---------------------------------
-----SSS------TT---2S@S!S-----------------------------------------------SS--SSSS--TT-------------------------T-----TT--------------------------SQS--S?
--------------TT----------------------tt-----K---B-----SSS------------------------TT-----T-------------TT----T-----TT--t------------------TT----------
--------------TT------------tt--------tt---------b------------------------------T-TT-----T-------------TT----T-----TT--t-----------tt-----TT----------
--------------TT-----g------tt--------tt---------B-----------y------------------T-TT---k-T----------g--TT----T--g--TT--t--kkk------tt----kTT-k------gg
XXXXXXXXXXXXXXXXXXXXXXXXXXXXXXXXXXXXXXXXXXXXXXXXXX----------XXXXXXXXXXXXXXXXXXXXXXXXXXXXXX%%%%%%%-%%XXXXXXXXXXXXXXXXXXXXXXXXXXXXXXXXXXXXXXXXXXXXXXXXXX
XXXXXXXXXXXXXXXXXXXXXXXXXXXXXXXXXXXXXXXXXXXXXXXXXX----------XXXXXXXXXXXXXXXXXXXXXXXXXXXXXX||||||---|XXXXXXXXXXXXXXXXXXXXXXXXXXXXXXXXXXXXXXXXXXXXXXXXXX
