------------------------------------------------------------------------------------------------------------------------------------------------------
------------------------------------------------------------------------------------------------------------------------------------------------------
------------------------------------------------------------------------------------------------------------------------------------------------------
----------SSSSSSSSSS----------SSSSSSSSSS----------------------------------------------------------------------SS-------S----------SSSSSSSS------------
------------------------------------------------------------------------------------------------------------------------------------------------------
------------------------------------------------------------------------------------------------------------------------------------------------------
--------------------USS----------------------------------Q-Q------SSoo-------------o--o----------------------R---------S------------------------------
---------------------------------------------------------------------------------------------------------r--------------------------------------------
---------------------------------------S------------------------------------------------------------%%%%%%%--------SSS--------------------------------
---------------------------------------S-------------------------------------------SSSS-----------oo||||||--------------------------------------------
----------@QQQQ------------------------S-----------------Q-Q%%%%%%----------------------------------||||||-------------S---------------g##------------
---------------------B---------#-----------------------------||||------------------------------TT---||||||-----##----------------------###---------#--
-----------------g-#-b-------B-#-#---------------------------||||---------------%%%------------TT---||||||-----##--------------------g####-----K---#--
-M--------------g#-#-B-------b-#-#-------------y-------------||||---------------||----------y--TT---||||||--oo-##--------k----ggg----#####---------#--
XXXXXXXXXXXXXXXXXXXXXXXXXXXXXXXXXXXXXXXXXXXXXXXXXXXXXXXXXXXX-||||-----X----XXXXX||--------XXXXXXXXXX||||||--%%-XX------XXXXXXXXXXXXXXXXXXX--XXXXX--XXX
XXXXXXXXXXXXXXXXXXXXXXXXXXXXXXXXXXXXXXXXXXXXXXXXXXXXXXXXXXXX-||||-----X----XXXXX||--------XXXXXXXXXX||||||---|-XX------XXXXXXXXXXXXXXXXXXX--XXXXX--XXX
