------------------------------------------------------------------------------------------------------------------------------------------------------
------------------------------------------------------------------------------------------------------------------------------------------------------
------------------------------------------------------------------------------------------------------------------------------------------------------
----------SSSSSSSSSS--------------------------------------------------SSSSSSSSSS------------------------------SSSSSSSSSSSSSSSSSSSS--------------------
----------------------------------------------------------------------------SSSS---------------------------------------------------------------------o
-------------------------------------------------------oooo----------R---g--SSSS----------------------------------------------------------------------
-------------------------------------------------------%%%%-------------SS----------y-----SSS------%------------------------------%-------------------
--------------------------------------------------------||--------------SS--------#SSS--------------------TT------------------------------------SSS---
--------------------------------------------------------||--------------SS-------##-----------------------TT----------------------------SSS-oo--------
--------------------------------------------------SSS---||--------------SC--g-g-###1----------------------TT------------------------------------------
----------@QQQQ-----------------------------------------||-------%%%----SS--SSSS###---------%%%----------SXXS-T-------------------%%%%%-----SS--------
---------------------------------------T--------------U-||--------|-------------###--SSS-----|----------------T-----------SS-------|||----------------
-----------------g-#-------------------T----------------||--------|-------------###----------|------TT--------T----TT-----SS-------|||----------------
----------------g#-#-----------------kkT-------ggg------||--------|-------------###----------|------TT--------T--g-TT-----SS-------|||----------------
XXXXXXXXXXXXXXXXXXXXXXXXX--XXXXXXXXXXXXX-XXXXXXXXX----%%%%%-%%%%%-|---XXXXXXXXXXXXXXXX---X---|------XXXXXXXXXXXXXXXXXXXX--XX--XXXX%|||----------------
XXXXXXXXXXXXXXXXXXXXXXXXX--XXXXXXXXXXXXX-XXXXXXXXX-----|||---|||--|---XXXXXXXXXXXXXXXX---X---|------XXXXXXXXXXXXXXXXXXXX--XX--XXXX-|||----------------
