------------------------------------------------------------------------------------------------------------------------------------------------------
------------------------------------------------------------------------------------------------------------------------------------------------------
------------------------------------------------------------------------------------------------------------------------------------------------------
----------------------------------------SSSSSSSSSS----------SSSSSSSSSS--------------------SSSSSSSSSS--------------------------------------------------
----------------------------------------SSSSSSSS------------SSSS--SSSS-------------------------------------------------------------------------------o
----------------------ooor--------------SSSCSSSS------------SSSS--SSSS--------------------------------------------------------------------------------
---------------------%%%%%--------------SSSSSSSS--------------SS---S-------g-------USS------------------SSQSSS----------SS----------------------------
----------------------|||-------------------------------------SS---S---%%%%%%-------------------------------------------------------------------SSS---
----------------------|||-------------------------------------SS---S----||||----------------------------------------------------------------oo--------
----------------------|||------------------ggg--------------ooSS---SoU--||||------------------------------K----------------TT-------------------------
-------------------%%%%%%%%-----QQQQ----SSSSSSSS------------SSSS---SSS--||||------#---------------------SSSSSS-------------TT---------------SS--------
--------------------||||||-----------K-BSSSSSSSS----K-------------------||||------#-------------------------------------t--TT--------TT---------------
--------------------||||||--o----------bSSSSSSSS------------------------||||------##------------------------------------t--TT--------TT---------------
-M-----------%%%%---||||||-%%%---------bSSSSSSSS-----------gk--g-g------||||------##--gg--------g-g------------k----kkk-t--TT--------TT---------------
XXXXXXXXXXX---||----||||||--|-XXXXXXXXXXXXXXXXXXXXXXXXXXXXXXXXXXXXXXXX--||||------XXXXXXXXXXXXXXXXXXXXXXXXXXXXXXXXXXXXXXXXXXXXXXXXXXXXXXXXXX----------
XXXXXXXXXXX---||----||||||--|-XXXXXXXXXXXXXXXXXXXXXXXXXXXXXXXXXXXXXXXX--||||------XXXXXXXXXXXXXXXXXXXXXXXXXXXXXXXXXXXXXXXXXXXXXXXXXXXXXXXXXX----------
