------------------------------------------------------------------------------------------------------------------------------------------------------
------------------------------------------------------------------------------------------------------------------------------------------------------
------------------------------------------------------------------------------------------------------------------------------------------------------
S-----SSSS-------------oo---------------------------------------------------------------------------SSSSSSSSSS----------------------------------------
S-----------------------------------------------------------------------------------------------------------------------------------------------------
S-------------------------------------oo---------------oooo-----------------------------oo------------------------------------------------------------
S---------------------SSSS---------SSSS-------QQQQ-----%%%%---------------SS----oo--------------------------------------SS---------------##-----------
S-------------------------------------------------------||-------------------------------------------------------------------------------##-----------
S----------------%%%------------------------------------||-----------------------------------------------------------------------------####-----------
S-----------------||----------------------------k-SSS---||-----------------------SSS------------g--------------------------TT----------####-----------
S-----------------||------%%%%%---------T-----?QQQ------||------------SS-----SS----------S------TT-----------T-------------TT--------######-----------
S------------%%%%%||-------|||----------T-------------U-||--------------------------------------TT-----TT----T----------t--TT--------######-----------
S-------------|||-||-------|||----------T---------------||--------------------------------------TT-----TT----T-----B----t--TT--------######--------F--
S--M----------|||-||-------|||----------T---------------||--gg-------g--------------------------TT--g--TT----T-----b----t--TT--------######--------#--
XXXXXXXXXXX---|||-||%%%----|||--%%%%--%%XXXXXXXXXX----%%%%%-XXXXXXXXXX--------------------XXXXXXXXX-XXXXXXXXXXXXXXXXXXXXXXXXXXXXXXXXXXXXXXXXXXXXXXXXXX
XXXXXXXXXXX---|||-||||-----|||---||----|XXXXXXXXXX-----|||--XXXXXXXXXX--------------------XXXXXXXXX-XXXXXXXXXXXXXXXXXXXXXXXXXXXXXXXXXXXXXXXXXXXXXXXXXX
