------------------------------------------------------------------------------------------------------------------------------------------------------
------------------------------------------------------------------------------------------------------------------------------------------------------
------------------------------------------------------------------------------------------------------------------------------------------------------
S-----SSSS------------------------------------------------------------------------------------------SSSSSSSSSS----------SSSSSSSSSS--------------------
S-----------------------------------------------------------------------------------------------------------------------------------------------------
S-------------------------------------------------------------------------------K---------------------------------------------------------------------
S--------------------LSSS--------------------------------Q-Q--USSS------SSSSS---SS----1--------------------------------------------SSSS---------------
S-------------------------------o----ooo--------------------------------------------------------------------------------------------------------------
S-----------------------------------------------------------------------------------------------------------------------------------------------------
S-----------Q--?-----------------------------------------------------------------------------------------------------------------------SSSS-----------
S------------------S-2-----#----------%%-----------------Q-Q-S-----TT--------2--SS--------------TT---------TT-----------------------------------------
S--------------------------#-----------|---------------------------TT------TT---------TT--------TT------#--TT-------------SS--------------------------
S--------------------------##----------|---------------------------TT-t----TT--T------TT--------TT-----##--TT-------------SS-----------------------F--
S-----------------K---kk---##--%%%%%%%-|---------------------ggg---TT-t----TT--T------TT----k---TT--kk-##--TT--k----kkk---SS-----------------------#--
XXXXXXXXXXXXXXXXXXXXXXXXXXXXXX--|||||--|X-XX-XX-XXXXXXXXXXXXXXXXXXXXXXXXXXXXXXXXXXXXXXXXXXXXXXXXXXXXXXXXX--XX-XXXXXXXXXX--XX--XXXX---------XXXXXXXXXXX
XXXXXXXXXXXXXXXXXXXXXXXXXXXXXX--|||||--|X-XX-XX-XXXXXXXXXXXXXXXXXXXXXXXXXXXXXXXXXXXXXXXXXXXXXXXXXXXXXXXXX--XX-XXXXXXXXXX--XX--XXXX---------XXXXXXXXXXX
