------------------------------------------------------------------------------------------------------------------------------------------------------
------------------------------------------------------------------------------------------------------------------------------------------------------
------------------------------------------------------------------------------------------------------------------------------------------------------
------------------------------SSSSSSSSSS------------------------------SSSSSSSSSS----------SSSSSSSSSSSSSSSSSSSS----------------------------------------
------------------------------SSSSSSSSSS------------------------------------SSSS----------------------------------------------------------------------
------------------------------SSSSSSSSSS---------------oooo----------R---g--SSSS----------------------------------------------------------------------
------------------------------SSSSSSSSSS------QQQQ-----%%%%-------------SS-----------SUS------------------------------------------%-------------------
--------------------------------------------------------||--------------SS--------------------------------------oooo----------------------------------
--------------------------------------------------------||--------------SS----------------------------------------------------SSS-------SSS-----------
------------------------------------------------k-SSS---||--------------SC--g-g-----------------------------------------------------------------------
---------Q------!---SS--------SSSSSSSSSST-----?QQQ------||-------%%%----SS--SSSS----#####--------------------TT---------%---------%%%%%---------------
---------------------K---TT---SSSSSSSSSST-------------U-||--------|-----------------#------------------TT----TT--------------------|||----------------
-------------------------TT---SSSSSSSSSST---------------||--------|----------------K#------------------TT----TT--------------------|||-------------F--
-------------------------TT---SSSSSSSSSST---------------||--------|-----------------#-----------g-g-g--TT----TT---y--------------r-|||-------------#--
XXXXXXXXXXXXXXXXXXXXXXXXXXXXXXXXXXXXXXXXXXXXXXXXXX----%%%%%-%%%%%-|---XXXXXXXXXXXXXXXXX---XXXXXXXXXXXXXXXXXXXXXXXXXXXXXX----XXXXXX%|||------XXXXXXXXXX
XXXXXXXXXXXXXXXXXXXXXXXXXXXXXXXXXXXXXXXXXXXXXXXXXX-----|||---|||--|---XXXXXXXXXXXXXXXXX---XXXXXXXXXXXXXXXXXXXXXXXXXXXXXX----XXXXXX-|||------XXXXXXXXXX
