------------------------------------------------------------------------------------------------------------------------------------------------------
------------------------------------------------------------------------------------------------------------------------------------------------------
------------------------------------------------------------------------------------------------------------------------------------------------------
-----------------------oo-----SSSSSSSSSS--------------------SSSSSSSSSS--------------------------------------------------------------------------------
------------------------------------------------------------SSSS--SSSS--------------------------------------------------------------------------------
------------------------------------------------------------SSSS--SSSS------------g-------------------------------------------------------------------
----------------------SSSS------------------------------------SS---S------------SSSSSSSS---------------------R----------------------------------------
--------------------------------------------------------------SS---S------------------------------oo-----r--------------------------------------------
-----------------g---------------------S----------------------SS---S--------------------------------%%%%%%%-------------------------------------------
-----------------#---------------------S--------------------ooSS---SoU---1--------------------------||||||---------------------SSS--------------------
----------S-----##--------%%%%---------S--------------------SSSS---SSST-----------------------------||||||--------------%-----------------------------
---------------###---------|||-#--------------------K-----------------T----TT-------------------#---||||||---------------------------TT---------------
--------------####---------|||-#-#------------------------------------T----TT-------------------#---||||||---------B-----------------TT------------F--
-M-----------#####---------|||-#-#-------------ggg---------gk--g-g----T---kTT-------------------#---||||||--oo-----b-------------r---TT------------#--
XXXXXXXXXXXXXXXXXXXX%%%----|||XXXXXXXXXX-XXXXXXXXXXXXXXXXXXXXXXXXXXXXXXXXXXXXXXXXXXXXX---XXXXXXXXXXX||||||--%%XXXXXXXXXX----XXXXXXXXXXXXXXXXXXXXXXXXXX
XXXXXXXXXXXXXXXXXXXX||-----|||XXXXXXXXXX-XXXXXXXXXXXXXXXXXXXXXXXXXXXXXXXXXXXXXXXXXXXXX---XXXXXXXXXXX||||||---|XXXXXXXXXX----XXXXXXXXXXXXXXXXXXXXXXXXXX
