------------------------------------------------------------------------------------------------------------------------------------------------------
------------------------------------------------------------------------------------------------------------------------------------------------------
------------------------------------------------------------------------------------------------------------------------------------------------------
-----------------------oo-----------------------------------------------------------------------------------------------------------------------------
------------------------------------------------------------------------------------------------------------------------------------------------------
--------------------------------------------------------------------------------K----------------------------------k----------------------------------
----------------------SSSS--------------------QQQQ-------------------------1----SS----1-----------------SSQSSSS---SSSSSS--oo---%%%-----------QQQQ-----
--------------------------------------------------------------------------------------------------------------------------SS----||--------------------
-----------------g--------------------------------------------------------------------------------------------------------------||---g#---------------
-----------------#------------------------------k--------o-----------------ggg------------------g---------K---------------------||--g##--------y------
----------S-----##--------%%%%-TT-------T-----?QQQ--------------------#########-SS--------------TT------SSSSSS---------------SS-||--###-----Q?SSQQQ---
---------------###---------|||-TT-------T-------------------------------------#-------TT--------TT------------------------------||-####---------------
--------------####---------|||-TT-------T-------------------------------------#-------TT--------TT------------TT----------------||#####---------------
-M-----------#####---------|||gTT-------T-----------k--------y----------------#-------TT--------TT------------TT----------------||#####---------------
XXXXXXXXXXXXXXXXXXXX%%%----|||XXXXXXXX--XXXXXXXXXX-XXXXXXXXXXXXXXXXXXX--------X-XXXXXXXXXXXXXXXXXXX-XXXXXXXXXXXXXXXXXX--%%-----%%%XXXXX--XXXXX--XXXXXX
XXXXXXXXXXXXXXXXXXXX||-----|||XXXXXXXX--XXXXXXXXXX-XXXXXXXXXXXXXXXXXXX--------X-XXXXXXXXXXXXXXXXXXX-XXXXXXXXXXXXXXXXXX--|-------||XXXXX--XXXXX--XXXXXX
