------------------------------------------------------------------------------------------------------------------------------------------------------
------------------------------------------------------------------------------------------------------------------------------------------------------
------------------------------------------------------------------------------------------------------------------------------------------------------
-------------------------------------------------------------------SSS----------------------------------------SS-------S------------------------------
------------------------------------------------------------------------------------------------------------------------------------------------------
--------------------------------------------------------------------------------------------oo--------------------------------------------------------
------------------SC--------------------------------------------CSS------------------1---------------------------------S------------------------------
-----------------------------------------------------------------------------------------------------------------------------------------------y------
---------------------------------------------------------TT-SS--2----------------------------------%---------------SSS-----------------------#SS--o---
---------------------------------------------------TT----TT----2-2-------------------------------------------------------------SSS----------##--------
--------------TT---2------------QQQQ---------------TT----XX-------2----------------QQQQ---S----------------------------S%-------------------##--SC----
--------------TT---------------------K-B-----K---B-TT-------------------------------------------------TT-------##--------------------TT-----##--------
--------------TT-----------------------b---------b-TT----------------------------------------%%%%-----TT----TT-##--------------------TT-----##---SSS--
---M----------TT-----------------------b---------B-TT-----------------gg------------yy--------||------TT-k--TT-##----------------r---TT-----##--------
XXXXXXXXXXXXXXXXXXXXXXXXX--XXXXXXXXXXXXXXXXXXXXXXXXXXXXXXXXX---XXXXXXXXXXXXXXXXXXXXXXXXXXX----||----XXXXXXXXXX-XX------X----XXXXXXXXXXXXXXXXXX------XX
XXXXXXXXXXXXXXXXXXXXXXXXX--XXXXXXXXXXXXXXXXXXXXXXXXXXXXXXXXX---XXXXXXXXXXXXXXXXXXXXXXXXXXX----||----XXXXXXXXXX-XX------X----XXXXXXXXXXXXXXXXXX------XX
