------------------------------------------------------------------------------------------------------------------------------------------------------
------------------------------------------------------------------------------------------------------------------------------------------------------
------------------------------------------------------------------------------------------------------------------------------------------------------
S-----SSSS--------------------SSSSSSSSSS-----------oo--------------SSS--------------------SSSSSSSSSS----------------------------------------SSSSSSSSSS
S-------------------------------------------------%%%%-------------------o----------------------------------------------------------------------------
S--------------------------------------------------||-------------------%%%-------------oo------------oo----------------------------------------------
S--------------------------------------------------||-----------CSS------|--o---oo--------------------------------------SS--------SS------------------
S--------------------------------------------------||--SSS---------------|--SSSS----------------------------------------------------------------------
S--------------------------------------S-----------||-------SS--2-----%--|----------------------------------------------------------------------------
S--------------------------------------S-----------||----------2-2-------|-------SSS---------------------------------------TT-------------------------
S------------------%--------TT---------S-----------||-------------2------|---------------S----------------------------r----TT-----SS----------TT------
S---------------------------TT-#--------T-----TT---||--------------------|----------------------------------------%%%%%%t--TT-----K---#----B--TT------
S---------------------------TT-#-#------T-----TT--%||--------------------|-----%----------------------------tt-----|||||t--TT---------#----b--TT------
S------------%%%%-------ggg-TT-#-#------T-----TT---||--------------------|----------------------g-g---ggg---tt-----|||||t--TT---------#----B--TT------
XXXXXXXXXXX---||----XXXXXXXXXXXXXXXXXXXXXXXX--XXXX-||----------XXXXXXX%%%%%%--------------XXXXXXXXXXXXXXXXXXXX-%%%-|||||XXXXXXXXXXXXXXXXXXXXXXXX--XXXX
XXXXXXXXXXX---||----XXXXXXXXXXXXXXXXXXXXXXXX--XXXX-||----------XXXXXXX|||||---------------XXXXXXXXXXXXXXXXXXXX--|--|||||XXXXXXXXXXXXXXXXXXXXXXXX--XXXX
