------------------------------------------------------------------------------------------------------------------------------------------------------
------------------------------------------------------------------------------------------------------------------------------------------------------
------------------------------------------------------------------------------------------------------------------------------------------------------
---------------------------------------------------oo-------------------------------------------------------------------------------------------------
--------------------------------------------------%%%%------------------------------------------------------------------------------------------------
----------------------------------------ooooo------||-------------------------------------------------------------------------------------------------
------------------SC-------------------------------||---------------------SSCSS----USS-----------------------------oo--------------------##-----------
--------------------------------o----ooo--------SS-||--SSS-------------------------------------------------------------------------------##-----------
-----------------------------------------SSSS------||-------------------------------------------------------------------------SSS------####-----------
---------------------------------------------------||----------------------------------------------------------------------------------####-----------
--------------TT---2SS----------------%%-----------||----------------T--QQQQ--QQ--#----------------------------%%%%--%%%%------------######-----------
--------------TT-----K---TT------------|-----------||----------------T------------#-------------------TT--------||----||-------------######-----------
--------------TT---------TT------------|----%%%%%-%||----------------T------------##-------------B----TT----TT--||----||-------------######--------F--
-M------------TT---------TT----%%%%%%%-|-----|||---||---------ggg----T------------##--gg---------b----TT-k--TTo-||----||---------r---######--------#--
XXXXXXXXXXXXXXXXXXXXXXXXXXXXXX--|||||--|%%---|||---||-------XXXXXXXXXXXXXXXXXXXX--XXXXXXXXXXXXXXXXXXXXXXXXXXXX%-||----||----XXXXXXXXXXXXXXXXXXXXXXXXXX
XXXXXXXXXXXXXXXXXXXXXXXXXXXXXX--|||||--||----|||---||-------XXXXXXXXXXXXXXXXXXXX--XXXXXXXXXXXXXXXXXXXXXXXXXXXX--||----||----XXXXXXXXXXXXXXXXXXXXXXXXXX
