------------------------------------------------------------------------------------------------------------------------------------------------------
------------------------------------------------------------------------------------------------------------------------------------------------------
------------------------------------------------------------------------------------------------------------------------------------------------------
----------------------------------------SSSSSSSSSS----------------------------------------------------------------------------------------------------
------------------------------------------------------------------------------------------------------------------------------------------------------
--------------------------------------------------------------------------------------------oo--------------------------------------------------------
---------------------LSSS----------------oooo---------------------------------------------------------------------------------------------------------
-------------------------------------------------------------o---o---o--------------------------------------------------------------------------------
-----------------------------------------SSSS-U-------------%%%-%%%-%%---------g-------------------%--------------------------------------------------
-----------------------------------oo---oS--SoS--------------|---|---|------------o-------------------------------------------------------------------
---------Q-----------2-----#------o--o--SS--SSS-------S------|---|---|-------S@S-------TT-SS-----------------------------------------------##---------
---------------------------#----------------------TT---------|---|---|-----------------TT-------------------g-----------------------------####--------
---------------------------##---------------------TT---------|---|---|-----------------TT----%%%%-----------TT---------------------------######------#
--------------k-ggg---kk---##-------------kk------TT------k--|---|-r-|-----------------TT-----||------------TT-k----kkk---kkk--------y--########----##
XXXXXXXXXXXXXXXXXXXXXXXXXXXXXXXXXXXXXXXXXXXXXXXXXXXXXXXXXXXX%%%%%%%%%%-XXXXXXXXXXXXXXXXXXX----||------XXXXXXXXXXXXXXXXXXXXXXXXXXXXXXXXXXXXXXXXXXXXXXXX
XXXXXXXXXXXXXXXXXXXXXXXXXXXXXXXXXXXXXXXXXXXXXXXXXXXXXXXXXXXX-|||||||||-XXXXXXXXXXXXXXXXXXX----||------XXXXXXXXXXXXXXXXXXXXXXXXXXXXXXXXXXXXXXXXXXXXXXXX
