------------------------------------------------------------------------------------------------------------------------------------------------------
------------------------------------------------------------------------------------------------------------------------------------------------------
------------------------------------------------------------------------------------------------------------------------------------------------------
-----------------------oo-----------------------------------SSSSSSSSSS----------SSSSSSSSSL------------------------------------------------------------
------------------------------------------------------------SSSS--SSSS--------------------------------------------------------------------------------
-------------------------------------------------------oooo-SSSS--SSSS--------------------------------oo----------------------------------------------
------------------Q---SSSS-----------------------------%%%%---SS---S------SS--------ooooooSSS------%---------------oo-------------!S------------------
--------------------------------------------------------||----SS---S------------------------------------------------------------oo-------------y------
--------------------------------------------------------||----SS---S----------------SSSSSS---------------------------------------------------#SS--o---
--------------------------------------------------SSS---||--ooSS---SoU--------------SSSSSS--------------------------------------------------##--------
------------------?-------%%%%---------T----------------||--SSSS---SSSSS-----SS-------------%%%----------------%%%%--%%%-----TT---S------#--##--SC----
--------------TT-----------|||---------T--------------U-||-----------------------------------|------------------||----||-----TT---------##--##--------
--------------TT-----------|||---------T----------------||-----------------------------------|--------------tt--||----||-----TT--------###--##---SSS--
---M----------TT-----------|||--gg-----T-------ggg------||--k--g-g---------------------------|--------ggg---tto-||----||-y---TT-------####--##--------
XXXXXXXXXXXXXXXXXXXX%%%----|||XXXXXXXXXX-XXXXXXXXX----%%%%%-XXXXXXXXXX-------------XXXXXXX---|------XXXXXXXXXX%-||----||XXXXXXXXXXXXXXXXXXXXXX------XX
XXXXXXXXXXXXXXXXXXXX||-----|||XXXXXXXXXX-XXXXXXXXX-----|||--XXXXXXXXXX-------------XXXXXXX---|------XXXXXXXXXX--||----||XXXXXXXXXXXXXXXXXXXXXX------XX
