------------------------------------------------------------------------------------------------------------------------------------------------------
------------------------------------------------------------------------------------------------------------------------------------------------------
------------------------------------------------------------------------------------------------------------------------------------------------------
----------------------------------------------------------------------SSSSSSSSSSSSSSSSSSSL------------------------------------------------------------
----------------------------------------------------------------------------SSSS----------------------------------------------------------------------
-------------------------------------------------------------------------g--SSSS----------------------------------------------------------------------
------------------------------------------------------------------------SS----------oooooo----------------------------------------!S------------------
------------------------------------------------------------------------SS--------------------------------TT--------------------oo-------------y------
---------------------------------------------------------------------o--SS----------SSSSSS----------------TT---------------------------------#SS--o---
------------Q--?-------------------------------------------------y------SC--g-g-----SSSSSS--------oo------TT--------------------------------##--------
-------------------S----------------------------------S----------##-----SS--SSSS-------------------------SXXS----------------TT---S------#--##--SC----
--------------------------------------------------TT------------###----------------------------TT----------------------------TT---------##--##--------
--------------------------------------------------TT-----------####----------------------------TT---TT-----------------------TT--------###--##---SSS--
-M----------------K---------------k-k-------------TT------k---#####-------------------------y--TT---TT---------k----kkk--y---TT-------####--##--------
XXXXXXXXXXXXXXXXXXXXXXXXX--XXXXXXXXXXXX-X-XX-XX-XXXXXXXXXXXXXXXXXXX---XXXXXXXXXX---XXXXXXXXXXXXXXXXXXXXXXXXXXXXXXXXXXXXXXXXXXXXXXXXXXXXXXXXXXX------XX
XXXXXXXXXXXXXXXXXXXXXXXXX--XXXXXXXXXXXX-X-XX-XX-XXXXXXXXXXXXXXXXXXX---XXXXXXXXXX---XXXXXXXXXXXXXXXXXXXXXXXXXXXXXXXXXXXXXXXXXXXXXXXXXXXXXXXXXXX------XX
