------------------------------------------------------------------------------------------------------------------------------------------------------
------------------------------------------------------------------------------------------------------------------------------------------------------
------------------------------------------------------------------------------------------------------------------------------------------------------
------------------------------------------------------------------------------------------------------------------------------------------------------
------------------------------------------------------------------------------------------------------------------------------------------------------
-------------------------------------------------------oooo-----------------------------oo------------------------------------------------------------
-------------------------------------------------------%%%%---------------SS----oo----------------------------------------oo---%%%-------##-----------
--------------------------------------------------SSSS--||------------------------------------------oo--------------------SS----||-------##-----------
--------------------------------------------------------||----------------------------------------------------------------------||-----####-----------
--------------------------------------------------------||-----------------------SS---------------------------------------------||-----####-----------
----------------%%%%SS----------------------------------||-----------#SS-----SS----------S-------------------T--!-----S------SS-||---######-----------
-----------------||--K---TT-----------ttT-----TT------U-||----------##---------------------------------------T------------------||---######-----------
-----------------||------TT-----------ttT-----TT--------||--TT-----###---------------------------------------T------------------||---######--------F--
-M---------------||------TT-----------ttT-----TT--------||--TT----####-----------------------------g------y--T------------------||---######--------#--
XXXXXXXXXXX--%%%%||%XXXXXXXXXXXXXXXXXXXXXXXX--XXXX----%%%%%-XXXXXXXXXX---------------------XXXXXXXXXXXXXXXXXXXXXXXXXXXXX%%-----%%%XXXXXXXXXXXXXXXXXXXX
XXXXXXXXXXX---||-||-XXXXXXXXXXXXXXXXXXXXXXXX--XXXX-----|||--XXXXXXXXXX---------------------XXXXXXXXXXXXXXXXXXXXXXXXXXXXX|-------||XXXXXXXXXXXXXXXXXXXX
