------------------------------------------------------------------------------------------------------------------------------------------------------
------------------------------------------------------------------------------------------------------------------------------------------------------
------------------------------------------------------------------------------------------------------------------------------------------------------
------------------------------------------------------------------------------------------------------------------------------------------------------
------------------------------------------------------------------------------------------------------------------------------------------------------
--------------------------------------oo---------------oooo-------------------------------------------------------------------------------------------
--------------------USS------------SSSS----------------%%%%----------------g-------USS-----SSS!--------------R------------------------------SSS-------
--------------------------------------------------SSSS--||-------------%%%%%%----------------------------r--------------------------------------------
--------------------------------------------------------||--------------||||------------------------%%%%%%%-------------------SSS----g#---------------
--------------------------------------------------------||--------------||||------------------------||||||--------------------------g##----------SSSSS
------------------------------%----------TT---SU--------||-----------T--||||------#-----------C-----||||||--------------%-----------###---------------
---------------------B-------------------TT-----------U-||-----------T--||||------#-----------------||||||-------------------------####---------------
---------------------b-------B-----------TT-------------||-----------T--||||------##----------------||||||------------------------#####-----SSS-------
-M------------k-ggg--B-------b-----------TT------k------||----ggg----T--||||------##--gg-------g-g--||||||--oo-k----kkk----------r#####------------r--
XXXXXXXXXXXXXXXXXXXXXXXXXXXXXX--%%%%--%%XXXXXXXXXX----%%%%%-XXXXXXXXXX--||||------XXXXXXXXXXXXXXXXXX||||||--%%XXXXXXXXXX----XXXXXXXXXXX--XXX-----XXXXX
XXXXXXXXXXXXXXXXXXXXXXXXXXXXXX---||----|XXXXXXXXXX-----|||--XXXXXXXXXX--||||------XXXXXXXXXXXXXXXXXX||||||---|XXXXXXXXXX----XXXXXXXXXXX--XXX-----XXXXX
