------------------------------------------------------------------------------------------------------------------------------------------------------
------------------------------------------------------------------------------------------------------------------------------------------------------
------------------------------------------------------------------------------------------------------------------------------------------------------
--------------------SSSSSSSSSS--------------------SSSSSSSSSS-------SSS----------------------------------------------------------------------SSSSSSSSSS
--------------------SSSSSSSSSS------------------------SS--SS------------------------------------------------------------------------------------------
--------------------SSSSSSSSSS------------------------SS--SS----------------------------oo------------------------------------------------------------
--------------------SSSSSSSSSSS---------------------SS----------CSS-----SSSSS---oo---------------------------R--------------------%-------------------
----------------------------------------------------SS---------------------------------------------------r----------------------oo--------------------
----------------------------------------------------SS------SS--2-----------------------------------%%%%%%%-----------------------------SSS-----------
----------------------------------------------------SS----oo---2-2---------------SS-----------------||||||--------------------------------------------
---------Q------!-----SSSSSS?-##--SSC---------------SSSS--SS------2----------2-----------S-------tt-||||||-------------------TT---%%%%%-------TT------
----------------------SSSSS---------------------------SS-------------------TT-------------T------tt-||||||-----#-------------TT----|||--------TT------
----------------------SSSSS---------------------------SS--------------t----TT--T----------T------tt-||||||-----#-------------TT----|||--------TT------
---------------------------ooo----------------------------------------t----TT--T----------T------tt-||||||--oo-#----ggg--y---TT----|||--------TT------
XXXXXXXXXXXXXXXXXXXX-XXXXXXXXXXX--XXXXXXX-XX-XX-XXXXXXXXXXXX---XXXXXXXXXXXXXXXXX----------XXXXXXXXXX||||||--%%-XXXXXXXXXXXXXXXXXXX%|||------XXXX--XXXX
XXXXXXXXXXXXXXXXXXXX-XXXXXXXXXXX--XXXXXXX-XX-XX-XXXXXXXXXXXX---XXXXXXXXXXXXXXXXX----------XXXXXXXXXX||||||---|-XXXXXXXXXXXXXXXXXXX-|||------XXXX--XXXX
