------------------------------------------------------------------------------------------------------------------------------------------------------
------------------------------------------------------------------------------------------------------------------------------------------------------
------------------------------------------------------------------------------------------------------------------------------------------------------
-----------------------oo-------------------------SSSSSSS---------------------------------------------------------------------------------------------
------------------------------------------------------------------------------------------------------------------------------------------------------
----------------------------------------------------------------------------------------------------oo------------------------------------------k-----
----------------------SSSS------------------------QQ--------------SSoo------------------------------%%%------------------SSS----S!SS-----------SQS--SQ
----------------------------------------------------------------------------------------------------||--o----R---SSS----------------------------------
-----------------------------------------------------------S-------------------g--TT----------------||-%%%--------------------------------------------
----------------------------------------------------------------------------------TT------------g---||--|---------------------------------------------
--------------------------%%%%---------T----------QQ--QQQ---%%%%%%-----------S@S--TT------------TT--||--|------------------------SSS-----------SQS--S?
---------------------------|||---------T---------------------||||-----------------TT-----T------TT--||-o|-------------------------K---#----B----------
---------------------------|||---------T---------------------||||---------------T-TT-----T------TT--||%%%%%---------------------------#----b----------
-M------------k-ggg--------|||--gg-----T-------y-------------||||---------------T-TT---k-T------TT--||-|||------------------gg-g-g----#----B-k------gg
XXXXXXXXXXXXXXXXXXXX%%%----|||XXXXXXXXXXXXXXXXXXXXXXXXXXX----||||------XXXXXXXXXXXXXXXXXXXXXXXXXXXX-||-|||----%%%%----%%XXXXXXXXXXXXXXXXXXXXXXXXXXXXXX
XXXXXXXXXXXXXXXXXXXX||-----|||XXXXXXXXXXXXXXXXXXXXXXXXXXX----||||------XXXXXXXXXXXXXXXXXXXXXXXXXXXX-||-|||----|||------|XXXXXXXXXXXXXXXXXXXXXXXXXXXXXX
