------------------------------------------------------------------------------------------------------------------------------------------------------
------------------------------------------------------------------------------------------------------------------------------------------------------
------------------------------------------------------------------------------------------------------------------------------------------------------
------------------------------SSSSSSSSSSSSSSSSSSSS--------------------SSSSSSSSSS----------------------------------------------------------------------
------------------------------SSSSSSSSSSSSSSSSSS----------------------------SSSS----------------------------------------------------------------------
----------------------ooor----SSSSSSSSSSSSSCSSSS---------------------R---g--SSSS----------------------------------------------------------------------
---------------------%%%%%----SSSSSSSSSSSSSSSSSS------------------------SS-----------SSSS-----------------2--------oo---SS---------SSSS---------------
----------------------|||-----------------------------------------------SS---------------------------------------------------------------------y------
----------------------|||-----------------------------------------------SS-------------------------------------------------------------------#SS--o---
----------------------|||------------------ggg--------------------------SC--g-g-------------------ooo----------------------TT----------SSSS-##--------
--------SU------%%%%%%%%%%%---SSSSSSSSSSSSSSSSSS------S----------%%%----SS--SSSSQ-------------------------2----%%%%--%%%---TT---------------##--SC----
-----------------||-||||||----SSSSSSSSSSSSSSSSSS--TT--------------|----------------------------TT---------------||----||t--TT---------------##--------
-----------------||-||||||--o-SSSSSSSSSSSSSSSSSS--TT--------------|----------------------------TT---------------||----||t--TT---------------##---SSS--
--M--------------||-||||||-%%%SSSSSSSSSSSSSSSSSS--TT------k-------|--------------ggg--------y--TT-------y--y--o-||----||t--TT---------------##--------
XXXXXXXXXXX--%%%%||%||||||--|-XXXXXXXXXXXXXXXXXXXXXXXXXXXXXX%%%%%-|---XXXXXXXXXXXXXXX----XXXXXXXXXXXXXXXXXXXXX%-||----||XXXXXXXXXX---------XXX------XX
XXXXXXXXXXX---||-||-||||||--|-XXXXXXXXXXXXXXXXXXXXXXXXXXXXXX-|||--|---XXXXXXXXXXXXXXX----XXXXXXXXXXXXXXXXXXXXX--||----||XXXXXXXXXX---------XXX------XX
