------------------------------------------------------------------------------------------------------------------------------------------------------
------------------------------------------------------------------------------------------------------------------------------------------------------
------------------------------------------------------------------------------------------------------------------------------------------------------
--------------------------------------------------------------------------------ooo-------------------------------------------------------------------
--------------------------------------------------------------------------------%%%-------------------------------------------------------------------
---------------------------------------------------------------------R-----------|--------------------------------------------------------------k-----
--------------------S------------------------------------------------------1-----|--------SSS------%------------------US-SSS----S!-------------SQS--SQ
---------------------------TT----------------------------------------------------|--------------------------------------------------------------------
---------------------------TT----------------------------TT----------------------|--------------------------------------------------------------------
---------------------------XX----------------------TT----TT----------------ggg---|---%%%%---------------------------E---------------------------------
-------------------%---TT-------QQQQ---------------TT----XX------%%%--#########--|----||----%%%--------------------TT------------S-------------SQS--S?
-----------------------TT------------K-B-----------TT-------------|-----------#-%%%%%%||-----|---------------------TT--t------------------------------
-----------------------TT--------------b-----------TT-------------|-----------#--||||-||-----|------------*--------TT--t------------------------------
-M-----------%%%%---k--TT--------------b-----------TT-------------|-----------#--||||-||-----|------gg----*-----g--TT--t----gg-g-gk----------k------gg
XXXXXXXXXXX---||----XXXXXXXXXXXXXXXXXXXXX-XX-XX-XXXXXXXXXXXX%%%%%-|-----------X--||||-||%%---|------XXXXXXXXX-XXXXXXXXXXXXXXXXXXXXXX---XXXXXXXXXXXXXXX
XXXXXXXXXXX---||----XXXXXXXXXXXXXXXXXXXXX-XX-XX-XXXXXXXXXXXX-|||--|-----------X--||||-||-|---|------XXXXXXXXX-XXXXXXXXXXXXXXXXXXXXXX---XXXXXXXXXXXXXXX
