------------------------------------------------------------------------------------------------------------------------------------------------------
------------------------------------------------------------------------------------------------------------------------------------------------------
------------------------------------------------------------------------------------------------------------------------------------------------------
----------SSSSSSSSSS------------------------------SSSSSSS-----------------------ooo-----------------SSSSSSSSSS----------------------------------------
--------------------------------------------------------------------------------%%%-------------------------------------------------------------------
---------------------------------------------------------------------------------|--------------------------------------------------------------------
----------------------!---------------------------QQ-----------------------------|----------------------------------------------------------SSS-------
---------------------------------------------------------------------------------|----------------oo--------------------------------------------------
-----------------------------------------------------------S---------o-----------|--------------------------------------------------------------------
-----------------------------------------------------------------y---------------|---%%%%--------------------------------------------------------SSSSS
--------------------S@S!S--------------T----------QQ--QQQ--------##--------------|----||---------------------T-----------------------------#----------
---------------------------------------T------------------------###-------------%%%%%%||--------#------TT----T----------------------------##----------
----------------------------tt---------T-----------------------####--------------||||-||--------#------TT----T---------------------------###SSS-------
-M-------------------g------tt--gg-----T-------ggg------------#####--------------||||-||--------#---g--TT----T-k----kkk--k----ggg----y--####-------r--
XXXXXXXXXXX--XX--X--XXXXXXXXXXXXXXXXXXXX-XXXXXXXXXXXXXXXX---XXXXXXX---X----XXXXX-||||-||%%XXXXXXXXXXXXXXXXXXXXXXXXXXXXXXXXXXXXXXXXXXXXXXXXXX-----XXXXX
XXXXXXXXXXX--XX--X--XXXXXXXXXXXXXXXXXXXX-XXXXXXXXXXXXXXXX---XXXXXXX---X----XXXXX-||||-||-|XXXXXXXXXXXXXXXXXXXXXXXXXXXXXXXXXXXXXXXXXXXXXXXXXX-----XXXXX
