------------------------------------------------------------------------------------------------------------------------------------------------------
------------------------------------------------------------------------------------------------------------------------------------------------------
------------------------------------------------------------------------------------------------------------------------------------------------------
--------------------------------------------------------------------------------------------------------------SS-------S------------------------------
------------------------------------------------------------------------------------------------------------------------------------------------------
----------------------ooor----------------------------------------------------------------------------------------------------------------------------
---------------------%%%%%------------------------Q-----------USSS---------1-------o--o----SSS!-----------2------------SSSS--------------##-----------
----------------------|||----------------------------------------------------------------------------------------------------------------##-----------
----------------------|||------------------------------------------------------------------------------------------SSS-----------------####-----------
----------------------|||--------------------------------------------------ggg-----SSSS-------------o----------------------------------####-----------
---------Q---------%%%%%%%%--------------TT---SU--Q----------S-----TT-#########---------------C-----------2------------S-------------######-----------
--------------------||||||------------tt-TT------------------------TT---------#--------------------------------##--------------------######--------#--
--------------------||||||--o---------tt-TT------------------------TT---------#-%%%----------------------------##-------------TT-----######----K---#--
-M-----------%%%%---||||||-%%%--------tt-TT------k---gg----k-ggg---TT---------#-||-------------g-g------y--y---##-------------TT-----######--------#--
XXXXXXXXXXX---||----||||||--|-XXXXXXXXXXXXXXXXXXXXXXXXXXXXXXXXXXXXXXXX--------X-||--------XXXXXXXXXXXXXXXXXXXX-XX------X----XXXXXXXXXXXXXXXXXXXXX--XXX
XXXXXXXXXXX---||----||||||--|-XXXXXXXXXXXXXXXXXXXXXXXXXXXXXXXXXXXXXXXX--------X-||--------XXXXXXXXXXXXXXXXXXXX-XX------X----XXXXXXXXXXXXXXXXXXXXX--XXX
