------------------------------------------------------------------------------------------------------------------------------------------------------
------------------------------------------------------------------------------------------------------------------------------------------------------
------------------------------------------------------------------------------------------------------------------------------------------------------
----------SSSSSSSSSS----------SSSSSSSSSS--------------------------------------------------SSSSSSSSSS--------------------------------------------------
------------------------------SSSSSSSSSS----?---------------------------------------------------------------------------------------------------------
------------------------------SSSSSSSSSS------------------------------------------------oo------------------------------------------------------------
------------------------------SSSSSSSSSS-----------------Q-Q----------------SSSSoo---------------------------R-----------SSS----S!--------------------
----------------------------------------------r------------------------------------------------------r------------------------------------------------
------------------------------------------%%%%%%----------------------------------------------------%%%%%%%-------------------------------------------
-------------------------------------------||||------------------------------K---SSS----------------||||||--------------------------------------------
--------------------SS--------SSSSSSSSSS%%-||||ooo-------Q-Q---------------SSSSS---------S----------||||||-----------------------S---------#----------
---------------------K---TT---SSSSSSSSSS|--||||--r--------------------T-------------------t---------||||||--------------------------------##----------
-------------------------TT---SSSSSSSSSS|%%%%%%%%%--------------------T-------------------t---------||||||---------B---------------------###-------F--
-M-----------------------TT---SSSSSSSSSS|-||||||||----------gg-------gT-------------------t---------||||||--oo-----b--------gg-g-g---y--####-------#--
XXXXXXXXXXX--XX--X--XXXXXXXXXXXXXXXXXXXX|-||||||||XXXXXXXXXXXXXXXXXXXXXXXXXXXXXX----------XXXXXXXXXX||||||--%%XXXXXXXXXXXXXXXXXXXXXXXXXXXXXXXXXXXXXXXX
XXXXXXXXXXX--XX--X--XXXXXXXXXXXXXXXXXXXX|-||||||||XXXXXXXXXXXXXXXXXXXXXXXXXXXXXX----------XXXXXXXXXX||||||---|XXXXXXXXXXXXXXXXXXXXXXXXXXXXXXXXXXXXXXXX
