------------------------------------------------------------------------------------------------------------------------------------------------------
------------------------------------------------------------------------------------------------------------------------------------------------------
------------------------------------------------------------------------------------------------------------------------------------------------------
------------------------------------------------------------------------------------------------------------------------------------------------------
-------------------------------------------------------------------------o----------------------------------------------------------------------------
------------------------------------------------------------------------%%%----------------------------------------k----------------------------------
--------------------------------------------------Q----------------------|--o------USS------------------------S---SSSSSS--SSC----------------------SSS
-------------------------------------------------------------------------|--SSSS----------------------------------------------------------------------
----------------------------------------------------------------------%--|-----------------------------------------------------------g#---------------
-------------------------------------------------------------------------|------------------------------------------------SSS-------g##---------------
--------------------SS----------------------------Q----------------------|--------#--------------tt---------------------------------###-----------#---
---------------------K---TT-----------ttT-----TT-------------------------|--------#-------T------tt--------------------------------####-----------#---
-------------------------TT-----------ttT-----TT-------------------------|-----%--##------T------tt-------*---TT------------------#####-----------#---
----------k---ggg--------TT-----------ttT-----TT-----gg----k-y-----------|--------##--gg--T------tt-gg----*---TT-----------------######------ggg--#---
XXXXXXXXXXXXXXXXXXXXXXXXXXXXXXXXXXXXXXXXXXXX--XXXXXXXXXXXXXXXXXXXXXXXX%%%%%%------XXXXXXXXXXXXXXXXXXXXXXXXXXX-XXXXXXXX--X----XXXXXXXXXX--XXXXXXXXXXXXX
XXXXXXXXXXXXXXXXXXXXXXXXXXXXXXXXXXXXXXXXXXXX--XXXXXXXXXXXXXXXXXXXXXXXX|||||-------XXXXXXXXXXXXXXXXXXXXXXXXXXX-XXXXXXXX--X----XXXXXXXXXX--XXXXXXXXXXXXX
