------------------------------------------------------------------------------------------------------------------------------------------------------
------------------------------------------------------------------------------------------------------------------------------------------------------
------------------------------------------------------------------------------------------------------------------------------------------------------
---------------------------------------------------oo-------------------------------------------------------------------------------------------------
--------------------------------------------------%%%%------------------------------------------------------------------------------------------------
---------------------------------------------------||-----------------------------------oo------------------------------------------------------------
-----------------------------U---------------------||-----------------------SSSSoo---------------------------R--------US--oo---%%%-------##-----------
--------------------------------o----ooo-----------||--SSS---o---o---o----------------------------oo-----r----------------SS----||-------##-----------
---------------------------------------------------||-------%%%-%%%-%%------------------------------%%%%%%%---------------------||-----####-----------
---------------------------------------------------||--------|---|---|-------K---SS-----------------||||||----------E-----------||-----####-----------
----------------------------##--------%%-----------||--------|---|---|-----SSSSS---------S----------||||||---------TT--------SS-||---######-#---------
-----------------------y-#####---------|-----------||--------|---|---|T-------------------------#---||||||---------TT--t--------||---######-##--------
--------------------y-######-----------|----------%||--------|---|---|T-------------------------#---||||||---------TT--t--------||---######-###------#
-M--------k---ggg---######-----%%%%%%%-|----y-y----||--------|---|-r-|T-------------------------#---||||||--oo--g--TT--t--------||---######-####----##
XXXXXXXXXXXXXXXXXXXXXXXX--------|||||--|XXXXXXXXXX-||-------%%%%%%%%%%XXXXXXXXXX----------XXXXXXXXXX||||||--%%XXXXXXXXXX%%-----%%%XXXXXXXXXXXXXXXXXXXX
XXXXXXXXXXXXXXXXXXXXXXXX--------|||||--|XXXXXXXXXX-||--------|||||||||XXXXXXXXXX----------XXXXXXXXXX||||||---|XXXXXXXXXX|-------||XXXXXXXXXXXXXXXXXXXX
