------------------------------------------------------------------------------------------------------------------------------------------------------
------------------------------------------------------------------------------------------------------------------------------------------------------
------------------------------------------------------------------------------------------------------------------------------------------------------
------------------------------------------------------------SSSSSSSSSS------------------------------SSSSSSSSSS--------------------SSSSSSSSSS----------
------------------------------------------------------------SSSS--SSSS--------------------------------------------------------------------------------
------------------------------------------------------------SSSS--SSSS----------------------oo--------------------------------------------------------
--------------------------------------------------------------SS---S-----------------1--------------------------------US------------------------------
--------------------------------------------------------------SS---S----------------------------------------------------------------------------------
-----------------%%%------------------------------------------SS---S-----------g-------------------%-------------------------SSS----------------------
------------------||----------------------------------------ooSS---SoU----------------------------------------------E---------------------------------
------------------||SS----------QQQQ----------tt------------SSSS---SSS-------S@S---QQQQ---S----------------TT------TT---r-------------------#---------
-------------%%%%%||-K---TT----------K-B------tt----K---------------------------------------------------#--TT------TT--t%%%%%%------------TT##--------
--------------|||-||-----TT------------b------tt---------------------------------------------%%%%------##--TT------TT--t|||||------tt-----TT###------#
-M------------|||-||-----TT------------b-g----tt-----------gk--g-g------------------yy--------||----kk-##--TT---g--TT--t|||||------tt----kTT####----##
XXXXXXXXXXX---|||-||XXXXXXXXXXXXXXXXXXXXXXXXXXXXXXXXXXXXXXXXXXXXXXXXXX-XXXXXXXXXXXXXXXXXXX----||----XXXXX--XX-XXXXXXXXXX|||||-----XXXXXXXXXXXXXXXXXXXX
XXXXXXXXXXX---|||-||XXXXXXXXXXXXXXXXXXXXXXXXXXXXXXXXXXXXXXXXXXXXXXXXXX-XXXXXXXXXXXXXXXXXXX----||----XXXXX--XX-XXXXXXXXXX|||||-----XXXXXXXXXXXXXXXXXXXX
