------------------------------------------------------------------------------------------------------------------------------------------------------
------------------------------------------------------------------------------------------------------------------------------------------------------
------------------------------------------------------------------------------------------------------------------------------------------------------
S-----SSSS------------------------------SSSSSSSSSS------------------------------------------------------------------------------------------SSSSSSSSSS
S-----------------------------------------------------------------------------------------------------------------------------------------------------
S--------------------------------------------------------------------R--------------------------------------------------------------------------------
S---------------------!------------------oooo--------------------------------------o--o---SSS------%---------------oo---------------------------------
S-------------------------------------------------------------------------------------------------------------------------------oo--------------------
S----------------------------------------SSSS-U--------------------------------------------------------------------------------------g#---------------
S---------------------------------------oS--SoS------------------------------------SSSS---------------------------------------------g##---------------
S---------------%%%%S@S!S-------QQQQ----SS--SSS-------S----------%%%------------------------%%%----------------%%%%--%%%-----TT-----###-------TT------
S----------------||------------------K-B----------TT--------------|--------------------------|------------------||----||-----TT----####-------TT------
S----------------||---------tt---------b----------TT--------------|-------------%%%----------|------------*-----||----||-----TT---#####-------TT------
S----------------||--g------tt---------b--kk------TT------k-------|---gg--------||-----------|------gg----*---o-||----||-y---TT---#####-------TT------
XXXXXXXXXXX--%%%%||%XXXXXXXXXXXXXXXXXXXXXXXXXXXXXXXXXXXXXXXX%%%%%-|---XXXXXXXXXX||-----------|------XXXXXXXXX-%-||----||XXXXXXXXXXXXXXX--XXXXXXX--XXXX
XXXXXXXXXXX---||-||-XXXXXXXXXXXXXXXXXXXXXXXXXXXXXXXXXXXXXXXX-|||--|---XXXXXXXXXX||-----------|------XXXXXXXXX---||----||XXXXXXXXXXXXXXX--XXXXXXX--XXXX
