------------------------------------------------------------------------------------------------------------------------------------------------------
------------------------------------------------------------------------------------------------------------------------------------------------------
------------------------------------------------------------------------------------------------------------------------------------------------------
----------------------------------------------------------------------SSSSSSSSSSSSSSSSSSSL------------------------------------------------------------
------------------------------------------------------------------------------------------------------------------------------------------------------
-------------------------------------------------------oooo-------------------------------------------------------------------------------------------
-------------------------------------------------------%%%%-------------------------ooooooSSS------%---------R-----oo-------------%-------------------
--------------------------------------------------SSSS--||--------------------TT-------------------------r-------------------------------------y------
--------------------------------------------------------||--------------------TT----SSSSSS----------%%%%%%%-----------------------------SSS--#SS--o---
-----------------------------------oo-------------------||--------------------TT----SSSSSS----------||||||---------------------SSS----------##--------
----------------------------TT----o--o------------------||-----------#------SCTT------------%%%-----||||||-----%%%%--%%%%---------%%%%%-----##--SC----
----------------------------TT---------------K---B----U-||----------##--TT----TT-------------|------||||||------||----||-----------|||------##--------
----------------------------TT-------------------b------||--TT-----###--TT----TT-------------|------||||||------||----||-----------|||------##---SSS--
--------------k-ggg-----ggg-TT-------------------B------||--TT----####--TT---kTT-------------|------||||||--ooo-||----||---------r-|||------##--------
XXXXXXXXXXXXXXXXXXXXXXXXXXXXXXXXXXXXXXXXXXXXXXXXXX----%%%%%-XXXXXXXXXXXXXXXXXXXX---XXXXXXX---|------||||||--%%%-||----||----XXXXXX%|||------XX------XX
XXXXXXXXXXXXXXXXXXXXXXXXXXXXXXXXXXXXXXXXXXXXXXXXXX-----|||--XXXXXXXXXXXXXXXXXXXX---XXXXXXX---|------||||||---|--||----||----XXXXXX-|||------XX------XX
