------------------------------------------------------------------------------------------------------------------------------------------------------
------------------------------------------------------------------------------------------------------------------------------------------------------
------------------------------------------------------------------------------------------------------------------------------------------------------
----------------------------------------------------------------------------------------------------SSSSSSSSSS----------SSSSSSSSSS--------------U-----
--------------------------------------------?---------------------------------------------------------------------------------------------------------
--------------------------------------------------------------------------------K---------------------------------------------------------------------
--------------------------------------------------------------------------------SS----1----SSS!-------------------------------------------------------
----------------------------------------------r-----------------------------------------------------------------------------------oo--------------SS--
------------------------------------------%%%%%%----------------------o-------------------------------------------------------------------------------
-------------------------------------------||||-----------------------------------------------------------------------------------------------SS------
--------SU----------SS------------------%%-||||ooo-------tt----------#----------SS------------C------------TT------------------------------Q---------#
---------------------K---TT-------------|--||||--r-------tt---------##--------#-------TT----------------#--TT-------------SS------------------------##
-------------------------TT-------------|%%%%%%%%%-------tt-TT-----###-------##-------TT---------------##--TT-------------SS-----------------------###
--M-------k---ggg--------TT-------k-k---|-||||||||---g-g-tt-TT----####----------------TT-------g-g--kk-##--TT--k----kkk---SS----------------------####
XXXXXXXXXXXXXXXXXXXXXXXXXXXXXXXXXXXXXXX-|-||||||||XXXXXXXXXXXXXXXXXXXXXXXXXXXXXXXXXXXXXXXXXXXXXXXXXXXXXXX--XX-XXXXXXXXXX--XX--XXXXXXXXXXXXXXXXXXX-XXXX
XXXXXXXXXXXXXXXXXXXXXXXXXXXXXXXXXXXXXXX-|-||||||||XXXXXXXXXXXXXXXXXXXXXXXXXXXXXXXXXXXXXXXXXXXXXXXXXXXXXXX--XX-XXXXXXXXXX--XX--XXXXXXXXXXXXXXXXXXX-XXXX
