------------------------------------------------------------------------------------------------------------------------------------------------------
------------------------------------------------------------------------------------------------------------------------------------------------------
------------------------------------------------------------------------------------------------------------------------------------------------------
----------SSSSSSSSSS--------------------------------------------------------------------------------SSSSSSSSSS--------------------SSSSSSSS--SSSSSSSSSS
------------------------------------------------------------------------------------------------------------------------------------------------------
------------------------------------------------------------------------------------------------------------------------------------------------------
--------------------USS----------------------------------Q-Q--------------SS--------------------------------------------------------------------------
------------------------------------------------------------------------------------------------------------------------------------------------------
----------------------------------------------------------------------------------TT------------------------------------------------------------------
----------------------------------------------------------------1-----------------TT------------g-----------------------------------------------------
-------------------------------TT------------------------Q-Q----------SS-----SS---TT------------TT-----------T-------------------------g##----TT------
---------------------B---------TT-------T-----TT----------------------------------TT-----T------TT-----TT----T-------------------------###----TT------
---------------------b-------B-TT-------T-----TT--------------------------------T-TT-----T------TT-----TT----T-----------------------g####----TT------
---------------------B-------bgTT-------T-----TT--------------------------------T-TT---k-T------TT--g--TT----T-k----kkk---kkk--------#####----TT------
XXXXXXXXXXX--XX--X--XXXXXXXXXXXXXXXXXX--XXXX--XXXXXXXXXXXXXXXXXXXXXXX-----------XXXXXXXXXXXXXXXXXXX-XXXXXXXXXXXXXXXXXXXXXXXXXXXXXXXXXXXXXX--XXXX--XXXX
XXXXXXXXXXX--XX--X--XXXXXXXXXXXXXXXXXX--XXXX--XXXXXXXXXXXXXXXXXXXXXXX-----------XXXXXXXXXXXXXXXXXXX-XXXXXXXXXXXXXXXXXXXXXXXXXXXXXXXXXXXXXX--XXXX--XXXX
