------------------------------------------------------------------------------------------------------------------------------------------------------
------------------------------------------------------------------------------------------------------------------------------------------------------
------------------------------------------------------------------------------------------------------------------------------------------------------
--------------------------------------------------SSSSSSSSSS------------------------------SSSSSSSSSSSSSSSSSSSS----------------------------------------
------------------------------------------------------SS--SS------------------------------------------------------------------------------------------
----------------------------------------ooooo---------SS--SS------------------------------------------------------------------------------------------
---------------------LSSS---------------------------SS------------SSoo-----g---------SSSS----------------------------------------------------------SSS
------------------------------------------------SS--SS-----------------%%%%%%-------------------------------------------------------------------------
-----------------------------------------SSSS-------SS------------------||||--------------------------------------------------------------------------
----------------------------------------------------SS----oo------------||||--------------------------------------------------------------------------
-----SSS-----------%-2-----#------------------------SSSS--SS%%%%%%------||||----Q--------------------------TT---------r---------------------------#---
---------------------------#--------------------------SS-----||||-------||||----------------------------#--TT-----%%%%%%--------------------------#---
---------------------------##---------------%%%%%-----SS-----||||-------||||---------------------------##--TT------|||||--------------------------#---
-------------%%%%-----kk---##-----k-k--------|||-------------||||-------||||-----ggg------------g-g-kk-##--TT------|||||-k----ggg-k----------ggg--#---
XXXXXXXXXXX---||----XXXXXXXXXXXXXXXXXXX-%%---|||--XXXXXXXXXX-||||-------||||----XXXXX----XXXXXXXXXXXXXXXX--XX--%%%-|||||XXXXXXXXXXXX---XXXXXXXXXXXXXXX
XXXXXXXXXXX---||----XXXXXXXXXXXXXXXXXXX-|----|||--XXXXXXXXXX-||||-------||||----XXXXX----XXXXXXXXXXXXXXXX--XX---|--|||||XXXXXXXXXXXX---XXXXXXXXXXXXXXX
