------------------------------------------------------------------------------------------------------------------------------------------------------
------------------------------------------------------------------------------------------------------------------------------------------------------
------------------------------------------------------------------------------------------------------------------------------------------------------
--------------------------------oo------------------------------------SSSSSSSSSS----------SSSSSSSSSS--------------------------------------------------
-------------------------------------g-g--------------------------------------------------------------------------------------------------------------
-----------------------------------%%%%%%%------------------------------------------------------------------------------------------------------------
----------------------!-------------|||||------------------------------------------o--o----------------------R------------SSC-------------------------
------------------------------------|||||----oo--------------o---o---o--------TT---------------------r----------------------------oo-----------y------
------------------------------------|||||----------------B--%%%-%%%-%%--------TT--------------------%%%%%%%----------------------------------#SS--o---
------------Q--?--------------%%%%%-|||||----------------b---|---|---|--------TT---SSSS-------------||||||----------------SSS---------------##--------
-------------------SS@S!S------|||--|||||--------------SS#CS-|---|---|------SCTT--------------------||||||------------r--------------------Q##--SC----
-------------------------------|||--|||||--------------------|---|---|--TT----TT----------t---------||||||--------%%%%%%--------------------##--------
----------------------------tt-|||--|||||------------------K-|---|---|--TT----TT%%%-------t---------||||||---------|||||--------------------##---SSS--
---M--------------K--g------tt-|||--|||||--------------------|---|-r-|--TT---kTT||--------t---------||||||--oo-----|||||---------#----------##--------
XXXXXXXXXXXXXXXXXXXXXXXXXXXXXX-|||--|||||----%%%%-XXXXXXXXXX%%%%%%%%%%XXXXXXXXXX||--------XXXXXXXXXX||||||--%%-%%%-|||||X----XXXXXXXXXXXXXXXXX------XX
XXXXXXXXXXXXXXXXXXXXXXXXXXXXXX-|||--|||||-----||--XXXXXXXXXX-|||||||||XXXXXXXXXX||--------XXXXXXXXXX||||||---|--|--|||||X----XXXXXXXXXXXXXXXXX------XX
