------------------------------------------------------------------------------------------------------------------------------------------------------
------------------------------------------------------------------------------------------------------------------------------------------------------
------------------------------------------------------------------------------------------------------------------------------------------------------
------------------------------SSSSSSSSSS--------------------------------------------------------------------------------------------------------------
------------------------------SSSSSSSSSS----?---------------------------------------------------------------------------------------------------------
------------------------------SSSSSSSSSS---------------oooo-----------------------------oo------------------------------------------------------------
------------------------------SSSSSSSSSS---------------%%%%---------------SSCSS-oo----------------------SSQSSS------------------------------SSS-------
----------------------------------------------r---SSSS--||----------------------------------------------------------------------oo--------------------
------------------------------------------%%%%%%--------||--------------------------------------------------------------------------------------------
-------------------------------------------||||---------||------1----------------SSS--------------oo------K--------------------------------------SSSSS
--------------------SS--------SSSSSSSSSS%%-||||ooo------||--------------QQQQ--QQ---------S--------------SSSSSS--!-----S------TT-----------------------
---------------------K---TT---SSSSSSSSSS|--||||--r----U-||-------------------------------------TT----------------------------TT-----------------------
-------------------------TT---SSSSSSSSSS|%%%%%%%%%------||-------------------------------------TT----------------------------TT-------------SSS-------
-M--------k---ggg--------TT---SSSSSSSSSS|-||||||||------||----------------------------------y--TT------------------------y---TT--------------------r--
XXXXXXXXXXXXXXXXXXXXXXXXXXXXXXXXXXXXXXXX|-||||||||----%%%%%-XXXXXXXXX-XXXXXXXXXX----------XXXXXXXXXXXXXXXXXXXXXXXXXXXXXXXXXXXXXXXXXXXXXXXXXX-----XXXXX
XXXXXXXXXXXXXXXXXXXXXXXXXXXXXXXXXXXXXXXX|-||||||||-----|||--XXXXXXXXX-XXXXXXXXXX----------XXXXXXXXXXXXXXXXXXXXXXXXXXXXXXXXXXXXXXXXXXXXXXXXXX-----XXXXX
