------------------------------------------------------------------------------------------------------------------------------------------------------
------------------------------------------------------------------------------------------------------------------------------------------------------
------------------------------------------------------------------------------------------------------------------------------------------------------
------------------------------------------------------------------------------------------SSSSSSSSSS--------------------SSS-----SS--------------------
--------------------------------------------------?---------------------------------------------------------------------------------------------------
----------------------------------------------------------------------------------------oo------------------------------------------------------k-----
--------------------------------------------------------------------------SSCSS-oo---------------------------R----------US---------------------SQS--SQ
--------------------------------------------------SS-------------------------------------------------r------------------------------------------------
----------------------------------------------------------------------------------------------------%%%%%%%-----------------SSS-----------------------
---------------------------------------------------------------------------------SSS----------------||||||--------------------------------------------
-----SSS--------%%%%--------TT---------------------------------------T--QQQQ--QQ---------S----------||||||------------r-SSS--------------------SQS--S?
-----------------||---------TT---------T---------------SSS-----------T--------------------t---------||||||--------%%%%%%------------------------------
-----------------||---------TT---------T-----------------------------T--------------------t---------||||||---------|||||------------------------------
-----------------||-----ggg-TT-------kkT-------ggg------------ggg----T--------------------t---------||||||--oo-----|||||----------k----------k------gg
XXXXXXXXXXX--%%%%||%XXXXXXXXXXXXXXXXXXXX-XXXXXXXXX----------XXXXXXXXXXXXXXXXXXXX----------XXXXXXXXXX||||||--%%-%%%-|||||XXX------XXX---XXXXXXXXXXXXXXX
XXXXXXXXXXX---||-||-XXXXXXXXXXXXXXXXXXXX-XXXXXXXXX----------XXXXXXXXXXXXXXXXXXXX----------XXXXXXXXXX||||||---|--|--|||||XXX------XXX---XXXXXXXXXXXXXXX
