------------------------------------------------------------------------------------------------------------------------------------------------------
------------------------------------------------------------------------------------------------------------------------------------------------------
------------------------------------------------------------------------------------------------------------------------------------------------------
------------------------------------------------------------------------------------------SSSSSSSSSS--------------------------------------------------
------------------------------------------------------------------------------------------------------------------------------------------------------
------------------------------------------------------------------------------------------------------------------------------------------------------
----------------------------------------------QQQQ-------Q-Q-------------------------1------------------------?SSS----------------%-------------------
------------------------------------------------------------------------------------------------------------------------------------------------------
-------------------------------------------------------------------------------g----------------------------------------------SSS-------SSS-----------
------------------------------------------------k-----------------------------------------------------------------------------------------------------
----------------------------------------T-----?QQQ-------Q-Q---------T-------S@S---QQQQ---------------%%%%%%--SSSSS-----%---------%%%%%---------------
-----------------K--------------------ttT----------------------------T--------------------t------------||||------------------------|||----------------
------------B-------------------------ttT----------------------------T--------------------t------------||||------------------------|||-------------F--
-M----------b-------------------------ttT---------------------ggg----T--------------yy----t------------||||-----K----------------r-|||-------------#--
XXXXXXXXXXXXXXXXXXXXXXXXX--XXXXXXXXXXXXXXXXXXXXXXXXXXXXXXXXXXXXXXXXXXX-XXXXXXXXXXXXXXXXXXXXXXXXXXXXX%%-||||-%%XXXXXXXXXX----XXXXXX%|||------XXXXXXXXXX
XXXXXXXXXXXXXXXXXXXXXXXXX--XXXXXXXXXXXXXXXXXXXXXXXXXXXXXXXXXXXXXXXXXXX-XXXXXXXXXXXXXXXXXXXXXXXXXXXXX|--||||--|XXXXXXXXXX----XXXXXX-|||------XXXXXXXXXX
