------------------------------------------------------------------------------------------------------------------------------------------------------
------------------------------------------------------------------------------------------------------------------------------------------------------
------------------------------------------------------------------------------------------------------------------------------------------------------
S-----SSSS--------------------SSSSSSSSSS--------------------------------------------------------------------------------------------------------U-----
S-----------------------------------------------------------------------------------------------------------------------------------------------------
S---------------------ooor--------------------------------------------------------g-------------------oo----------------------------------------------
S--------------------%%%%%-------------------------------------------------g----SSSSSSSS---------------------------oo----------SSS--------------------
S---------------------|||------------------------------------o---o---o-%%%%%%---------------------oo----------------------------------------------SS--
S---------------------|||--------------S--------------------%%%-%%%-%%--||||---------------------------------------------------------g#---------------
S---------------------|||--------------S-----------------o---|---|---|--||||----------------------------------------------------K---g##-------SS------
S---------Q---------%%%%%%%------------S---------------------|---|---|--||||-----------------------------------%%%%--%%%-------SSS--###--------------#
S-------------------||||||-----#-----------------------------|---|---|--||||--------------------#---------------||----||-----------####-------------##
S-------------------||||||--o--#-#---------------------------|---|---|--||||--------------------#-----------tt--||----||-TT-------#####------------###
S------------------#||||||-%%%-#-#------------------k--------|---|-r-|--||||--------------------#-----ggg---tto-||----||-TT-------#####-----------####
XXXXXXXXXXXXX--XXXXX||||||--|-XXXXXXXXXXX-XX-XX-XX-XXXXXXXXX%%%%%%%%%%--||||----XXXXXX---XXXXXXXXXXXXXXXXXXXXX%-||----||XXXXXXXXXXXXXXX--XXXXXXXX-XXXX
XXXXXXXXXXXXX--XXXXX||||||--|-XXXXXXXXXXX-XX-XX-XX-XXXXXXXXX-|||||||||--||||----XXXXXX---XXXXXXXXXXXXXXXXXXXXX--||----||XXXXXXXXXXXXXXX--XXXXXXXX-XXXX
