------------------------------------------------------------------------------------------------------------------------------------------------------
------------------------------------------------------------------------------------------------------------------------------------------------------
------------------------------------------------------------------------------------------------------------------------------------------------------
S-----SSSS----------------------------------------SSSSSSSSSS--------------------SSSSSSSSSS------------------------------------------------------------
S-----------------------------------------------------SS--SS-------------o----------------------------------------------------------------------------
S-----------------------------------------------------SS--SS------------%%%---------------------------------------------------------------------------
S---------------------!-----------------------------SS-------------------|--o--------------SSS!-------------------------------------------------------
S---------------------------------------------------SS-------o---o---o---|--SSSS--------------------------------oooo----------------------------------
S---------------------------------------------------SS------%%%-%%%-%%%--|-----------------------------------------------------------g#---------------
S---------------------------------------------------SS----oo-|---|---|---|-------------S--------------------------------------------g##---------------
S---------------%%%%S@S!S-------QQQQ----------------SSSS--SS-|---|---|---|------SU------------C-------%%%%%%--T---------------------###---------------
S----------------||------------------K-B--------------SS-----|---|---|---|----------TT---t-------------||||---T--------------------####------------#--
S----------------||---------tt---------b--------------SS-----|---|---|---|-----%----TT---t-------------||||---T-------------------#####--------K---#--
S----------------||--g------tt---------b-------ggg-----------|---|-r-|---|---------kTT--kt-----g-g-----||||---T---y-------kkk-----#####------------#--
XXXXXXXXXXX--%%%%||%XXXXXXXXXXXXXXXXXXXX-XXXXXXXXXXXXXXXXXXX%%%%%%%%%%%%%%%%----XXXXXXXXXXXXXXXXXXXX%%-||||-%%XXXXXXXXXXXXXXXXXXXXXXXXX--XXXXXXXX--XXX
XXXXXXXXXXX---||-||-XXXXXXXXXXXXXXXXXXXX-XXXXXXXXXXXXXXXXXXX-||||||||||||||-----XXXXXXXXXXXXXXXXXXXX|--||||--|XXXXXXXXXXXXXXXXXXXXXXXXX--XXXXXXXX--XXX
