------------------------------------------------------------------------------------------------------------------------------------------------------
------------------------------------------------------------------------------------------------------------------------------------------------------
------------------------------------------------------------------------------------------------------------------------------------------------------
------------------------------------------------------------------------------------------------------------------------------------------------U-----
------------------------------------------------------------------------------------------------------------------------------------------------------
-------------------------------------------------------oooo---------------------------------oo--------------------------------------------------------
------------------SC-----------------------------------%%%%-------------------------y-----------------------------------------------------------------
--------------------------------------------------SSSS--||------------------------#SSS------------------------------------------------------------SS--
--------------------------------------------------------||-----------------------##----------------%--------------------------------------------------
--------------------------------------------------------||----------------------###1------------------------------------SS-?Q-----------------SS------
--------------TT---2-------------------T----------------||----------------------###-------SS---------------------------------------------------------#
--------------TT-----------------------T--------------U-||----------------------###--SSS------------------------------------------------------------##
--------------TT-----------------------T----------------||----------------------###----------%%%%---------*--------------------y-------------------###
-M------------TT----------------gg-----T-------y--------||--gg-------ggg--------###-----------||----gg----*----k----kkk----SSSSS--k---------------####
XXXXXXXXXXXXXXXXXXXXXXXXX--XXXXXXXXXXXXXXXXXXXXXXX----%%%%%-XXXXXXXXXXXXXXXXXXXXXXXXXX---X----||----XXXXXXXXX-XXXXXXXXXX-------XX-XX---XXXXXXXXXX-XXXX
XXXXXXXXXXXXXXXXXXXXXXXXX--XXXXXXXXXXXXXXXXXXXXXXX-----|||--XXXXXXXXXXXXXXXXXXXXXXXXXX---X----||----XXXXXXXXX-XXXXXXXXXX-------XX-XX---XXXXXXXXXX-XXXX
