------------------------------------------------------------------------------------------------------------------------------------------------------
------------------------------------------------------------------------------------------------------------------------------------------------------
------------------------------------------------------------------------------------------------------------------------------------------------------
S-----SSSS--------------------SSSSSSSSSS------------------------------------------------------------------------------------------SSSSSSSS------------
S-----------------------------------------------------------------------------------------------------------------------------------------------------
S---------------------------------------%%------------------------------------------------------------------------------------------------------k-----
S---------------------!-----------------|----------------------------------1---------SSSS---------------------?SSS--------oo---%%%-------------SQS--SQ
S---------------------------------------|----oo---------------------------------------------------------------------------SS----||--------------------
S--------------------------------------S|----------------B----------------------------------------------------------------------||--------------------
S--------------------------------------S|----------------b------1----------ggg--------------------------------------------------||--------------------
S---------------!---S@S!S--------------S|--------------SS#CS----------#########-Q----------------tt-----------SSSSS----------SS-||-----g##-----SQS--S?
S------------------------------#--------|-------------------------------------#-----------T------tt---TT------------------------||-----###------------
S---------------------------tt-#-#------|------------------K------------------#-----------T------tt---TT----TT------------------||---g####------------
S--------------------g------tt-#-#------|-------------------------------------#--ggg------T------tt---TT-k--TT--K---------------||---#####---k------gg
XXXXXXXXXXXXXXXXXXXXXXXXXXXXXXXXXXXXXXXX|----%%%%-XXXXXXXXXXXXXXXXXXX---------X-XXXXX----XXXXXXXXXXXXXXXXXXXXXXXXXXXXXXX%%-----%%%XXXXXXXX--XXXXXXXXXX
XXXXXXXXXXXXXXXXXXXXXXXXXXXXXXXXXXXXXXXX|-----||--XXXXXXXXXXXXXXXXXXX---------X-XXXXX----XXXXXXXXXXXXXXXXXXXXXXXXXXXXXXX|-------||XXXXXXXX--XXXXXXXXXX
