------------------------------------------------------------------------------------------------------------------------------------------------------
------------------------------------------------------------------------------------------------------------------------------------------------------
------------------------------------------------------------------------------------------------------------------------------------------------------
------------------------------SSSSSSSSSSSSSSSSSSSS-----------------SSS--------------------SSSSSSSSSS--------------------------------------------------
----------------------------------------SSSSSSSS------------------------------------------------------------------------------------------------------
----------------------------------------SSSCSSSS------------------------------------------------------------------------------------------------------
--------------------USS-----------------SSSSSSSS----------------CSS--------g---------SUS---------------------------------------SSS----------SSS-------
-----------------------------------------------------------------------%%%%%%-----------------------------TT------------------------------------------
---------------------------------------S--------------------SS--2-------||||------------------------------TT------------------------------------------
---------------------------------------S---ggg-----------------2-2------||||------------------------------TT--------------------K----------------SSSSS
-------------------%-------------------SSSSSSSSS------S-----------2-----||||--------#####----------------SXXS------------------SSS--------------------
---------------------B---------#--------SSSSSSSS--TT--------------------||||--------#-----t-----------------------------------------------------------
---------------------b-------B-#-#------SSSSSSSS--TT--------------------||||-------K#-----t---------TT-------------B-----TT-----------------SSS-------
-M-----------%%%%----B-------b-#-#------SSSSSSSS--TT------k-------------||||--------#-----t---------TT-------------b-----TT------------------------r--
XXXXXXXXXXX---||----XXXXXXXXXXXXXXXXXXXXXXXXXXXXXXXXXXXXXXXX---XXXXXXX--||||----XXXXXXX---XXXXXXXXXXXXXXXXXXXXXXXXXXXXXXXXXXXXXXXXXXXXXXXXXX-----XXXXX
XXXXXXXXXXX---||----XXXXXXXXXXXXXXXXXXXXXXXXXXXXXXXXXXXXXXXX---XXXXXXX--||||----XXXXXXX---XXXXXXXXXXXXXXXXXXXXXXXXXXXXXXXXXXXXXXXXXXXXXXXXXX-----XXXXX
