------------------------------------------------------------------------------------------------------------------------------------------------------
------------------------------------------------------------------------------------------------------------------------------------------------------
------------------------------------------------------------------------------------------------------------------------------------------------------
----------SSSSSSSSSS----------------------------------------------------------------------SSSSSSSSSS--------------------------------------------------
--------------------------------------------------?---------------------------------------------------------------------------------------------------
------------------------------------------------------------------------------------------------------------------------------------------------------
----------------------------------------------QQQQ--------------------------SSSS-----SUS---------------------------------SSS----S!-----US---SS--------
--------------------------------------------------SS---------o---o---o------------------------------------TT------------------------------------------
------------------------------------------------------------%%%-%%%-%%------------------------------------TT------------------------------------------
------------------------------------------------k------------|---|---|-------K----------------------------TT-------------------------SS---------------
----------------------------------------T-----?QQQ-----------|---|---|-----SSSSS----#####----------------SXXS--------------------S---------SSS--------
--------------------------------------ttT--------------SSS---|---|---|T-------------#--------------------------#----------------------------------#-TT
--------------------------------------ttT--------------------|---|---|T------------K#---------------TT---------#------------------TT-------------##-TT
-M------------------------------------ttT--------------------|---|-r-|T-------------#-----------g-g-TT---------#----ggg-----gg-g-gTT------------###-TT
XXXXXXXXXXX--XX--X--XXXXX--XXXXXXXXXXXXXXXXXXXXXXX----------%%%%%%%%%%XXXXXXXXXXXXXXXXX---XXXXXXXXXXXXXXXXXXXX-XXXXXXXXXXXXXXXXXXXXXXXXX-X-XXXXXXXX-XX
XXXXXXXXXXX--XX--X--XXXXX--XXXXXXXXXXXXXXXXXXXXXXX-----------|||||||||XXXXXXXXXXXXXXXXX---XXXXXXXXXXXXXXXXXXXX-XXXXXXXXXXXXXXXXXXXXXXXXX-X-XXXXXXXX-XX
