------------------------------------------------------------------------------------------------------------------------------------------------------
------------------------------------------------------------------------------------------------------------------------------------------------------
------------------------------------------------------------------------------------------------------------------------------------------------------
------------------------------------------------------------------------------------------------------------------------------------------------------
------------------------------------------------------------------------------------------------------------------------------------------------------
------------------------------------------------------------------------------------------------------------------------------------------------------
----------------------!-------------------------------------------------------------------SSS------%--------------------SS------------------SSS-------
----------------------------------------------------------------------------------------------------------TT----oooo----------------------------------
-------------------------------------------------------------------------------g--------------------------TT-------------------------g#---------------
------------Q--?-----------------------------------------o------------------------o-----------------------TT---------------TT-------g##----------SSSSS
---------Q---------SS@S!S-------QQQQ-----------------------------------------S@S-------TT---%%%----------SXXS-T------------TT-------###---------------
-------------------------------------K-B-----------------------------T-----------------TT----|----------------T---------t--TT------####---------------
----------------------------tt---------b---------------------B-------T-----------------TT----|------TT--------T---------t--TT-----#####-----SSS-------
-M----------------K--g------tt---------b----y-y-----k--------b-------T-----------------TT----|------TT--------T---y-----t--TT-----#####------------r--
XXXXXXXXXXXXXXXXXXXXXXXXXXXXXXXXXXXXXXXXXXXXXXXXXX-XXXXXXXXXXXXXXX--XX-XXXXXXXXXXXXXXXXXXX---|------XXXXXXXXXXXXXXXXXXXXXXXXXXXXXXXXXXX--XXX-----XXXXX
XXXXXXXXXXXXXXXXXXXXXXXXXXXXXXXXXXXXXXXXXXXXXXXXXX-XXXXXXXXXXXXXXX--XX-XXXXXXXXXXXXXXXXXXX---|------XXXXXXXXXXXXXXXXXXXXXXXXXXXXXXXXXXX--XXX-----XXXXX
