------------------------------------------------------------------------------------------------------------------------------------------------------
------------------------------------------------------------------------------------------------------------------------------------------------------
------------------------------------------------------------------------------------------------------------------------------------------------------
------------------------------------------------------------------------------------------SSSSSSSSSS--------------------SSS-----SS--------------------
------------------------------------------------------------------------------------------------------------------------------------------------------
-----------------------SSS--------------------------------------------------------------oo----------oo-------------k----------------------------------
---------------------------------------------------------------------------1----oo------------------%%%-------S---SSSSSSUS---------SSSS---------------
---------------------g------------------------------------------------------------------------------||--o----R----------------------------------------
--------------------%%%-----------------------------------------------------------------------------||-%%%------------------SSS-----------------------
--------------------||----SSS-----------------------------------1----------ggg---SSS----------------||--|------------------------------SSSS-----------
---------Q----------||--------------------------------S---------------#########----------S----------||--|---------------SSS-------------------#LSS----
--------------------||-----------------TT-----TT--TT--------------------------#---------------------||-o|-------------------------------------#-------
--------------------||-----------------TT-----TT--TT--------------------------#---------------------||%%%%%---TT------------------------------#-------
-M--------k---ggg---||----oo---------kkTT-----TT--TT------k-------------------#-----------------g-g-||-|||----TT----------------------------kk#-------
XXXXXXXXXXXXXXXXXXXX||---%%%--XXXXXXXXXXXXXX--XXXXXXXXXXXXXXXXXXXXXXX---------X-----------XXXXXXXXXX||-|||----XXXXXXXX--XXX------X---------XXXXXXXX---
XXXXXXXXXXXXXXXXXXXX||----|---XXXXXXXXXXXXXX--XXXXXXXXXXXXXXXXXXXXXXX---------X-----------XXXXXXXXXX||-|||----XXXXXXXX--XXX------X---------XXXXXXXX---
