------------------------------------------------------------------------------------------------------------------------------------------------------
------------------------------------------------------------------------------------------------------------------------------------------------------
------------------------------------------------------------------------------------------------------------------------------------------------------
--------------------SSSSSSSSSS------------------------------------------------------------------------------------------------------------------------
--------------------SSSSSSSSSS------------------------------------------------------------------------------------------------------------------------
--------------------SSSSSSSSSS--------------------------------g-------------------g-------------------------------------------------------------------
--------------------SSSSSSSSSS---------------------------Q-Q--SSSSS-----SSSSS---SSSSSSSS--------------------------------SS--------!S--------SS--------
--------------------------------o----ooo-------------------------------------------------------------------------SSS----------------------------------
------------------------------------------------------------------------------------------------------------------------------------------------------
---------------------------------------------------------------------------------------------------------------------------TT-------------------------
----------------------SSSSSS?---------%%-----------------Q-Q-----------------2------------------TT-------------------------TT-----S------#--SS--------
----------------------SSSSS------------|-----------------------------------TT-------------------TT----------g-----------t--TT-----------##--------#-TT
----------------------SSSSS------------|----------------------TT-----tt----TT--T----------------TT----------TT----------t--TT----------###-------##-TT
-M--------k---ggg----------ooo-%%%%%%%-|-------y--------------TT-----tt----TT--T------------k---TT----------TT----------t--TT---------####------###-TT
XXXXXXXXXXXXXXXXXXXX-XXXXXXXXX--|||||--|XXXXXXXXXXXXXXXXXXXXXXXXXXXXXXXXXXXXXXXXXXXXXX---XXXXXXXXXXX--XXXXXXXX%%%%----%%XXXXXXXXXXXXXXXXXXXXXXXXXXX-XX
XXXXXXXXXXXXXXXXXXXX-XXXXXXXXX--|||||--|XXXXXXXXXXXXXXXXXXXXXXXXXXXXXXXXXXXXXXXXXXXXXX---XXXXXXXXXXX--XXXXXXXX|||------|XXXXXXXXXXXXXXXXXXXXXXXXXXX-XX
