------------------------------------------------------------------------------------------------------------------------------------------------------
------------------------------------------------------------------------------------------------------------------------------------------------------
------------------------------------------------------------------------------------------------------------------------------------------------------
------------------------------SSSSSSSSSS----------------------------------------------------------------------SSSSSSSSSS------------------------------
------------------------------------------------------------------------------------------------------------------------------------------------------
----------------------ooor-----------------------------oooo-----------------------------oo------------------------------------------------------k-----
---------------------%%%%%-----------------------------%%%%---------------SSCSS-oo---------------------------R--------------------!S-----------SQS--SQ
----------------------|||-------------------------SSSS--||-----------------------------------------------r--------------------------------------------
-----------------g----|||--------------S----------------||------------------------------------------%%%%%%%------------------SSS----------------------
-----------------#----|||--------------S----------------||-----------------------SSS----------------||||||--------------------------------------------
----------S-----##--%%%%%%%------------S----------------||--------------QQQQ--QQ---------S-------tt-||||||----T---------r---------S------#-----SQS--S?
---------------###--||||||-----#----------------------U-||-----------T--------------------T------tt-||||||----T---------%%%%%%----------##------------
--------------####--||||||--o--#-#----------------------||---B-------T--------------------T------tt-||||||----T----TT---|||||----------###------------
-M-----------#####--||||||-%%%-#-#----------y-y---------||---b-------T--------------------T------tt-||||||--ooT--g-TT---|||||---------####---k------gg
XXXXXXXXXXXXXXXXXXXX||||||--|-XXXXXXXXXXXXXXXXXXXX----%%%%%-XXXXXX--XXXXXXXXXXXX----------XXXXXXXXXX||||||--%%XXXXXXXXXX|||||-----XXXXXXXXXXXXXXXXXXXX
XXXXXXXXXXXXXXXXXXXX||||||--|-XXXXXXXXXXXXXXXXXXXX-----|||--XXXXXX--XXXXXXXXXXXX----------XXXXXXXXXX||||||---|XXXXXXXXXX|||||-----XXXXXXXXXXXXXXXXXXXX
