------------------------------------------------------------------------------------------------------------------------------------------------------
------------------------------------------------------------------------------------------------------------------------------------------------------
------------------------------------------------------------------------------------------------------------------------------------------------------
----------------------------------------SSSSSSSSSS--------------------------------------------------SSSSSSSSSS------------------------------SSSSSSSSSS
----------------------------------------SSSSSSSS------------------------------------------------------------------------------------------------------
----------------------------------------SSSCSSSS------------------------------------------------------------------------------------------------------
------------------------------S---------SSSSSSSS--Q------------------------g--------------------------------------------SS----------------------------
-------------------------------------------------------------o---o---o-%%%%%%-------------------------------------------------------------------------
------------------------------------------------------------%%%-%%%-%%--||||---------------------------------------------------------g#---------------
------------Q--?---------------------------ggg---------------|---|---|--||||------o-------------g--------------------------TT-------g##---------------
---------Q---------S--------TT##--SSC---SSSSSSSS--Q----------|---|---|--||||-----------TT-------TT---------TT---!-----S----TT-------###-------TT------
----------------------------TT----------SSSSSSSS-------------|---|---|--||||-----------TT-------TT------#--TT-----------t--TT------####-------TT------
----------------------------TT----------SSSSSSSS-------------|---|---|--||||-----------TT-------TT-----##--TT-----------t--TT-----#####-------TT------
------------------K-----ggg-TT----------SSSSSSSS-----gg----k-|---|-r-|--||||-----------TT-------TT--kk-##--TT-----------t--TT-----#####-------TT------
XXXXXXXXXXXXXXXXXXXXXXXXXXXXXXXX--XXXXXXXXXXXXXXXXXXXXXXXXXX%%%%%%%%%%--||||----XXXXXXXXXXXXXXXXXXX-XXXXX--XX-XXXXXXXXXXXXXXXXXXXXXXXXX--XXXXXXX--XXXX
XXXXXXXXXXXXXXXXXXXXXXXXXXXXXXXX--XXXXXXXXXXXXXXXXXXXXXXXXXX-|||||||||--||||----XXXXXXXXXXXXXXXXXXX-XXXXX--XX-XXXXXXXXXXXXXXXXXXXXXXXXX--XXXXXXX--XXXX
