------------------------------------------------------------------------------------------------------------------------------------------------------
------------------------------------------------------------------------------------------------------------------------------------------------------
------------------------------------------------------------------------------------------------------------------------------------------------------
-------------------------------------------------------------------SSS--------------------------------------------------------------------------------
--------------------------------------------------?----------------------o----------------------------------------------------------------------------
----------------------ooor----------------------------------------------%%%-------------oo------------------------------------------------------k-----
---------------------%%%%%--------------------------------------CSS------|--o---oo---------SSS!---------------?SSS-----------------------##----SQS--SQ
----------------------|||-------------------------SS---------------------|--SSSS--------------------------TT-----------------------------##-----------
----------------------|||-----------------------------------SS--2-----%--|--------------------------------TT-----------------SSS-------####-----------
----------------------|||--------------------------------------2-2-------|-------SSS----------------------TT---------------------------####-----------
--------------------%%%%%%%---------------------------------------2------|---------------S----C----------SXXS-SSSSS-----r------------######----SQS--S?
-----------------K--||||||------------tt---------------SSS---------------|----------------------------------------------%%%%%%-------######-----------
------------B-------||||||--o---------tt---------------------------------|-----%--------------------TT------------------|||||--------######-----------
-M----------b-------||||||-%%%--------tt----y-y--------------------------|---------------------g-g--TT----------K-------|||||--------######--k------gg
XXXXXXXXXXXXXXXXXXXX||||||--|-XXXXXXXXXXXXXXXXXXXX-------------XXXXXXX%%%%%%--------------XXXXXXXXXXXXXXXXXXXXXXXXXXXXXX|||||-----XXXXXXXXXXXXXXXXXXXX
XXXXXXXXXXXXXXXXXXXX||||||--|-XXXXXXXXXXXXXXXXXXXX-------------XXXXXXX|||||---------------XXXXXXXXXXXXXXXXXXXXXXXXXXXXXX|||||-----XXXXXXXXXXXXXXXXXXXX
