------------------------------------------------------------------------------------------------------------------------------------------------------
------------------------------------------------------------------------------------------------------------------------------------------------------
------------------------------------------------------------------------------------------------------------------------------------------------------
----------SSSSSSSSSS-----------------------------------------------SSSSSSSSSSSSSSSSSSSSSSL------------------------------SSSSSSSSSS--------------------
----------------------------------------------------------------------------SSSS----------------------------------------------------------------------
----------------------ooor-----------------------------------------------g--SSSS----------------------oo----------------------------------------------
---------------------%%%%%-------------------------------Q-Q----CSS-----SS----------oooooo-SSS!-------------------------------------------------------
----------------------|||-------o----ooo--------------------------------SS---------------------------------------------------------------------y------
----------------------|||-----------------------------------SS--2-------SS----------SSSSSS-------------------------------------------g#------#SS--o---
----------------------|||--------------------------------------2-2------SC--g-g-----SSSSSS------------------------------------------g##-----##--------
---------Q----------%%%%%%%-----------%%-----------------Q-Q------2-----SS--SSSS--------------C-----------------------r-------------###-----##--SC----
--------------------||||||-------------|T-----TT------------------------------------------------------------------%%%%%%--SS-------####-----##--------
--------------------||||||--o----------|T-----TT------------------------------------------------------------tt-----|||||--SS------#####-----##---SSS--
-M------------------||||||-%%%-%%%%%%%-|T-----TT-----------------------------------------------g-g----ggg---tt-----|||||--SS------#####-----##--------
XXXXXXXXXXX--XX--X--||||||--|---|||||--|XXXX--XXXXXXXXXXXXXX---XXXXXXXXXXXXXXXXX---XXXXXXXXXXXXXXXXXXXXXXXXXXX-%%%-|||||--XX--XXXXXXXXX--XXXXX------XX
XXXXXXXXXXX--XX--X--||||||--|---|||||--|XXXX--XXXXXXXXXXXXXX---XXXXXXXXXXXXXXXXX---XXXXXXXXXXXXXXXXXXXXXXXXXXX--|--|||||--XX--XXXXXXXXX--XXXXX------XX
