------------------------------------------------------------------------------------------------------------------------------------------------------
------------------------------------------------------------------------------------------------------------------------------------------------------
------------------------------------------------------------------------------------------------------------------------------------------------------
--------------------SSSSSSSSSS--oo------SSSSSSSSSS----------------------------------------------------------------------------------------------------
--------------------SSSSSSSSSS---------gSSSSSSSS------------------------------------------------------------------------------------------------------
--------------------SSSSSSSSSS-----%%%%%SSSCSSSS------------------------------------------------------------------------------------------------------
--------------------SSSSSSSSSS------||||SSSSSSSS--------------USSS---------1---------SUS-------------------------------------------------##-----------
------------------------------------||||-------------------------------------------------------------------------------------------------##----y------
------------------------------------||||-----------------------------------------------------------------------------------------------####--#SS--o---
------------------------------%%%%%-||||---ggg-----------------------------ggg------------------------------------------SS-?Q----------####-##--------
----------------------SSSSSS?--|||--||||SSSSSSSS-------ooo---S-----TT-#########-----#####--------tt-------------!-----S--------------######-##--SC----
----------------------SSSSS----|||--||||SSSSSSSS-------------------TT---------#-----#-----T------tt---------g------------------------######-##--------
----------------------SSSSS----|||--||||SSSSSSSS-------------------TT---------#----K#-----T------tt---------TT-----------------y-----######-##---SSS--
-M--------k---ggg----------ooo-|||--||||SSSSSSSS-------------ggg---TT---------#-----#-----T------tt---------TT-------------SSSSS-----######-##--------
XXXXXXXXXXXXXXXXXXXX-XXXXXXXXX-|||--||||XXXXXXXXXX--XXXXXXXXXXXXXXXXXX--------X-XXXXXXX---XXXXXXXXXX--XXXXXXXXXXXXXXXXXX-------XX-XXXXXXXXXXXX------XX
XXXXXXXXXXXXXXXXXXXX-XXXXXXXXX-|||--||||XXXXXXXXXX--XXXXXXXXXXXXXXXXXX--------X-XXXXXXX---XXXXXXXXXX--XXXXXXXXXXXXXXXXXX-------XX-XXXXXXXXXXXX------XX
