------------------------------------------------------------------------------------------------------------------------------------------------------
------------------------------------------------------------------------------------------------------------------------------------------------------
------------------------------------------------------------------------------------------------------------------------------------------------------
------------------------------------------------------------------------------------------------------------------------SSSSSSSSSS--------------------
------------------------------------------------------------------------------------------------------------------------------------------------------
----------------------------------------%%----------------------------------------------oo------------------------------------------------------------
----------------------!-----------------|----------------Q-Q------------SSSSS---oo------------------------------------------------SS------------------
----------------------------------------|----oo-------------------------------------------------------------------------------------------------------
----------------------------------------|-------------------------------------------------------------------------------------------------------------
----------------------------------------|----------------------------------------SSS------------------------------------------------------------------
-------------------%S@S!S---------------|----------------Q-Q---------T-------2-----------S-------tt-------------------------------SS------------------
--------------------------------------K-|----------------------------T-----TT-------------T------tt---------g--#----------SS------K---#----B----------
----------------------------ttTTTT------|----------------------------Tt----TT--T----------T------tt---------TT-#----------SS----------#----b-------F--
-M-----------%%%%----g------ttTTTT------|---------------------ggg----Tt----TT--T----------T------tt---------TT-#----ggg---SS----------#----B-------#--
XXXXXXXXXXX---||----XXXXXXXXXXXXXXXXXXXX|----%%%%-XXXXXXXXXXXXXXXXXXXXXXXXXXXXXX----------XXXXXXXXXX--XXXXXXXX-XXXXXXXXX--XX--XXXXXXXXXXXXXXXXXXXXXXXX
XXXXXXXXXXX---||----XXXXXXXXXXXXXXXXXXXX|-----||--XXXXXXXXXXXXXXXXXXXXXXXXXXXXXX----------XXXXXXXXXX--XXXXXXXX-XXXXXXXXX--XX--XXXXXXXXXXXXXXXXXXXXXXXX
