------------------------------------------------------------------------------------------------------------------------------------------------------
------------------------------------------------------------------------------------------------------------------------------------------------------
------------------------------------------------------------------------------------------------------------------------------------------------------
------------------------------SSSSSSSSSSSSSSSSSSSSSSSSSSS-------------------------------------------------------------------------SSSSSSSSSSSSSSSSSSSS
----------------------------------------SSSSSSSS------------------------------------------------------------------------------------------------------
----------------------------------------SSSCSSSS----------------------------------------oo------------------------------------------------------------
--------------------USS-----------------SSSSSSSS--QQ----------------------------oo---------SSS!--------------------oo---------------------------------
----------------------------------------------------------------------------------------------------oo------------------------------------------------
---------------------------------------S-------------------S------------------------------------------------------------------------------------------
---------------------------------------S---ggg---------------------------1-------SS--------------------------------------------SSS--------------------
----------------!----------------------SSSSSSSSS--QQ--QQQ------------#T------------------S----C--------------T-%%%%--%%%%---------------------TT------
---------------------B---------#--------SSSSSSSS--------------------##T----TT--------------------------------T--||----||------------------TT--TT------
---------------------b-------B-#-#------SSSSSSSS------------TT-----###T----TT--------------------------------T--||----||-----------tt-----TT--TT------
-M-------------------B-------b-#-#------SSSSSSSS------------TT----####T---kTT------------------g-g--------y--To-||----||---------r-tt----kTT--TT------
XXXXXXXXXXXXXXXXXXXXXXXXXXXXXXXXXXXXXXXXXXXXXXXXXXXXXXXXX---XXXXXXXXXXXXXXXXXXXX----------XXXXXXXXXXXXXXXXXXXX%-||----||----XXXXXXXXXXXXXXXXXXXX--XXXX
XXXXXXXXXXXXXXXXXXXXXXXXXXXXXXXXXXXXXXXXXXXXXXXXXXXXXXXXX---XXXXXXXXXXXXXXXXXXXX----------XXXXXXXXXXXXXXXXXXXX--||----||----XXXXXXXXXXXXXXXXXXXX--XXXX
