------------------------------------------------------------------------------------------------------------------------------------------------------
------------------------------------------------------------------------------------------------------------------------------------------------------
------------------------------------------------------------------------------------------------------------------------------------------------------
------------------------------------------------------------------------------------------------------------------------------------------------------
------------------------------------------------------------------------------------------------------------------------------------------------------
-------------------------------------------------------oooo-------------------------------------------------------------------------------------------
------------------------------S---------------QQQQ-----%%%%----------------g---------1------------------------------------oo---%%%----------SS--------
--------------------------------------------------------||-------------%%%%%%---------------------------------------------SS----||--------------------
--------------------------------------------------------||-----------o--||||----------------------------------------------------||--------------------
------------------------------------------------k-SSS---||-------y------||||----------------------------------------------------||--------------------
---------Q----------SS--------##--SSC---T-----?QQQ------||-------##-----||||-------QQQQ---------TT---------------------------SS-||----------SS--------
---------------------K---TT-------------T-------------U-||------###-----||||--------------------TT------------------------------||----------------#-TT
-------------------------TT-------------T---------------||-----####-----||||--------------------TT--------*--------B------------||---------------##-TT
-M------------k-ggg------TT-------------T---------------||----#####-----||||--------yy------k---TT--gg----*--------b------------||k-------------###-TT
XXXXXXXXXXXXXXXXXXXXXXXXXXXXXXXX--XXXXXXXXXXXXXXXX----%%%%%-XXXXXXX-----||||----XXXXXXXXXXXXXXXXXXXXXXXXXXXXX-XXXXXXXXXX%%-----%%%XX---XXXXXXXXXXXX-XX
XXXXXXXXXXXXXXXXXXXXXXXXXXXXXXXX--XXXXXXXXXXXXXXXX-----|||--XXXXXXX-----||||----XXXXXXXXXXXXXXXXXXXXXXXXXXXXX-XXXXXXXXXX|-------||XX---XXXXXXXXXXXX-XX
