------------------------------------------------------------------------------------------------------------------------------------------------------
------------------------------------------------------------------------------------------------------------------------------------------------------
------------------------------------------------------------------------------------------------------------------------------------------------------
--------------------------------------------------SSSSSSSSSSSSSSSSSSSS--------------------SSSSSSSSSS--------------------------------------------------
------------------------------------------------------SS--SSSSSS--SSSS--------------------------------------------------------------------------------
----------------------ooor----------------------------SS--SSSSSS--SSSS------------g-------------------------------------------------------------------
---------------------%%%%%--------------------------SS--------SS---S------------SSSSSSSS----------------------?SSS----------------SS---------QQQQ-----
----------------------|||---------------------------SS--------SS---S--------------------------------------TT------------------------------------------
----------------------|||---------------------------SS--------SS---S-----------g--------------------------TT------------------------------------------
------------Q--?------|||---------------------------SS----ooooSS---SoU------------------------------------TT-----------------------------------y------
-------------------S%%%%%%%-------------------------SSSS--SSSSSS---SSS-------S@S-------------------------SXXS-SSSSS---------------SS--------Q?SSQQQ---
--------------------||||||------------ttT-----TT------SS--------------------------------------------------------------------------K---#----B----------
--------------------||||||--o---------ttT-----TT------SS--------------------------------------------TT--------------------------------#----b----------
-M----------------K-||||||-%%%--------ttT-----TT------------k--g-g------------------------------g-g-TT----------K---------kkk---------#----B----------
XXXXXXXXXXXXXXXXXXXX||||||--|-XXXXXXXXXXXXXX--XXXXXXXXXXXXXXXXXXXXXXXX-XXXXXXXXXXXXXXX---XXXXXXXXXXXXXXXXXXXXXXXXXXXXXXXXXXXXXXXXXXXXXXXXXXXXX--XXXXXX
XXXXXXXXXXXXXXXXXXXX||||||--|-XXXXXXXXXXXXXX--XXXXXXXXXXXXXXXXXXXXXXXX-XXXXXXXXXXXXXXX---XXXXXXXXXXXXXXXXXXXXXXXXXXXXXXXXXXXXXXXXXXXXXXXXXXXXX--XXXXXX
