------------------------------------------------------------------------------------------------------------------------------------------------------
------------------------------------------------------------------------------------------------------------------------------------------------------
------------------------------------------------------------------------------------------------------------------------------------------------------
--------------------------------oo--------------------------------------------------------------------------------------------------------------------
-------------------------------------g-g--------------------------------------------------------------------------------------------------------------
-----------------------------------%%%%%------------------------------------------g-------------------------------------------------------------------
------------------SC-LSSS-----------||||-----------------------------------1----SSSSSSSS--------------------------------------------------------------
------------------------------------||||-------------------------------------------------------------------------------------------------------y------
------------------------------------||||-----------------TT------------------------------------------------------------y---------------------#SS--o---
------------------------------%%%%%-||||-----------TT----TT----------------ggg-------------o---------------------------X--------------------##--------
---------Q----TT---2-2-----#---|||--||||-TT---SU---TT----XX-----------#########------------------TT-------------------XX--------------------##--SC----
--------------TT-----------#---|||--||||-TT--------TT-------------------------#------------------TT------------------XXX--------------------##--------
--------------TT-----------##--|||--||||-TT--------TT-------------------------#------------------TT-------*---------XXXX--------------------##---SSS--
--------------TT------kk---##--|||--||||-TT------k-TT--------y----------------#------------------TT-gg----*--------XXXXX-k----ggg-k---------##--------
XXXXXXXXXXXXXXXXXXXXXXXXXXXXXX-|||--||||XXXXXXXXXXXXXXXXXXXXXXXXXXXXXX--------X-XXXXXX---XXXXXXXXXXXXXXXXXXXX-XXXXXXXXXXXXXXXXXXXXXX---XXXXXXX------XX
XXXXXXXXXXXXXXXXXXXXXXXXXXXXXX-|||--||||XXXXXXXXXXXXXXXXXXXXXXXXXXXXXX--------X-XXXXXX---XXXXXXXXXXXXXXXXXXXX-XXXXXXXXXXXXXXXXXXXXXX---XXXXXXX------XX
