------------------------------------------------------------------------------------------------------------------------------------------------------
------------------------------------------------------------------------------------------------------------------------------------------------------
------------------------------------------------------------------------------------------------------------------------------------------------------
--------------------SSSSSSSSSSSSSSSSSSSSSSSSSSSSSS----------------------------------------------------------------------------------------------------
--------------------SSSSSSSSSS------------------------------------------------------------------------------------------------------------------------
--------------------SSSSSSSSSS----------------------------------------------------------oo------------------------------------------------------------
--------------------SSSSSSSSSS-----------oooo---------------------------SSSSS---oo---------------------------R----------------------------------------
---------------------------------------------------------------------------------------------------------r------oooo----------------------------------
-----------------%%%-------------------S-SSSS-U-----------------------------------------------------%%%%%%%-------------------------------------------
------------------||-------------------SoS--SoS----------------------------------SS--------o--------||||||---------------------SSS--------------------
------------------||--SSSSSS?----------SSS--SSS----------tt------------------2-----------S-------TT-||||||----T---------%-----------------------------
-------------%%%%%||--SSSSS----#-------------------------tt----------------TT--------------------TT-||||||----T----------------------TT---------------
--------------|||-||--SSSSS----#-#-----------------------tt-----------t----TT--T-----------------TT-||||||----T----------------------TT------------F--
-M------------|||-||-------ooo-#-#--------kk---------g-g-tt--y--------t----TT--T-----------------TT-||||||--ooT---y--------------r---TT------------#--
XXXXXXXXXXX---|||-||-XXXXXXXXXXXXXXXXXXXXXXXXXXXXXXXXXXXXXXXXXXXXXXXXXXXXXXXXXXX----------XXXXXXXXXX||||||--%%XXXXXXXXXX----XXXXXXXXXXXXXXXXXXXXXXXXXX
XXXXXXXXXXX---|||-||-XXXXXXXXXXXXXXXXXXXXXXXXXXXXXXXXXXXXXXXXXXXXXXXXXXXXXXXXXXX----------XXXXXXXXXX||||||---|XXXXXXXXXX----XXXXXXXXXXXXXXXXXXXXXXXXXX
