------------------------------------------------------------------------------------------------------------------------------------------------------
------------------------------------------------------------------------------------------------------------------------------------------------------
------------------------------------------------------------------------------------------------------------------------------------------------------
------------------------------------------------------------SSSSSSSSSSSSSSSSSSSS----------------------------------------SSS-----SS--------------U-----
--------------------------------------------?---------------SSSS--SSSS--------------------------------------------------------------------------------
------------------------------------------------------------SSSS--SSSS--------------------------------------------------------------------------------
------------------Q----------US-------------------------------SS---S-----------------------------------------R--------USUS---------------##-----------
----------------------------------------------r---------------SS---S----------TT---------------------r-----------------------------------##-------SS--
------------------------------------------%%%%%%--------------SS---S----------TT--TT----------------%%%%%%%-----------------SSS--------####-----------
-------------------------------------------||||----------o--ooSS---SoU--------TT--TT----------------||||||----------E------------------####---SS------
-----SSS----------?---------####--SSC---%%-||||ooo----------SSSS---SSS------SCTT--TT----------------||||||---------TT---SSS----------######----------#
--------------TT-------y-#####----------|--||||--r----------------------TT----TT--TT-----T----------||||||---------TT--t-------------######---------##
--------------TT----y-######------------|%%%%%%%%%----------------------TT----TTT-TT-----T----------||||||---------TT--t-------------######--------###
--------------TT----######--------------|-||||||||--k-------k--g-g------TT---kTTT-TT---k-T---------g||||||--oo--g--TT--t-------------######-------####
XXXXXXXXXXXXXXXXXXXXXXXX------XX--XXXXXX|-||||||||-XXXXXXXXXXXXXXXXXXXXXXXXXXXXXXXXXXXXXXX-XXXXXXXXX||||||--%%XXXXXXXXXXXXX------XXXXXXXXXXXXXXXX-XXXX
XXXXXXXXXXXXXXXXXXXXXXXX------XX--XXXXXX|-||||||||-XXXXXXXXXXXXXXXXXXXXXXXXXXXXXXXXXXXXXXX-XXXXXXXXX||||||---|XXXXXXXXXXXXX------XXXXXXXXXXXXXXXX-XXXX
