------------------------------------------------------------------------------------------------------------------------------------------------------
------------------------------------------------------------------------------------------------------------------------------------------------------
------------------------------------------------------------------------------------------------------------------------------------------------------
--------------------SSSSSSSSSS----------SSSSSSSSSS----------------------------------------SSSSSSSSSS--------------------------------------------------
------------------------------------------------------------------------------------------------------------------------------------------------------
------------------------------------------------------------------------------------------------------------------------------------------------------
-----------------------------------------oooo-----------------------------SSCSS------1------------------------------------oo---%%%!S------------------
-------------------------------------------------------------o---o---o-------------------------------------------SSS------SS----||--------------------
-----------------------------------------SSSS-U----------TT-%%%-%%%-%%----------------------------------------------------------||--------------------
-----------------------------C----------oS--SoS----TT----TT--|---|---|----------------------------------------------------------||--------------------
-------------------%---#-#--------------SS--SSS----TT----XX--|---|---|--QQQQ--QQ---QQQQ---------------%%%%%%-----------------SS-||S------#----#LSS----
---------------------#-#-#-#----------K------------TT--------|---|---|---------------------------------||||---------------------||------##----#-------
---------------------#-#-#-#--TTTT-----------------TT--------|---|---|---------------------------------||||---------------------||-----###----#-------
-M-----------%%%%----#-#-#-#-ETTTT--------kk-------TT--------|---|-r-|--------------yy----------g-g----||||---------------------||----####--kk#-------
XXXXXXXXXXX---||----XXXXXXXXXXXXXXXXXXXXXXXXXXXXXXXXXXXXXXXX%%%%%%%%%%XXXXXXXXXXXXXXXXXXXXXXXXXXXXXX%%-||||-%%%%%%----%%%%-----%%%XXXXXXXXXXXXXXXXX---
XXXXXXXXXXX---||----XXXXXXXXXXXXXXXXXXXXXXXXXXXXXXXXXXXXXXXX-|||||||||XXXXXXXXXXXXXXXXXXXXXXXXXXXXXX|--||||--||||------||-------||XXXXXXXXXXXXXXXXX---
