------------------------------------------------------------------------------------------------------------------------------------------------------
------------------------------------------------------------------------------------------------------------------------------------------------------
------------------------------------------------------------------------------------------------------------------------------------------------------
------------------------------------------------------------------------------------------------------------------------SSS-----SS--------------------
------------------------------------------------------------------------------------------------------------------------------------------------------
----------------------------------------ooooo---------------------------------------------------------------------------------------------------------
-----------------------------US-----------------------------------SSoo-----g---------SUS------------------------------USUS------------------SSS-------
------------------------------------------------SS---------------------%%%%%%-----------------------oo------------------------------------------------
-----------------g-----------------------SSSS---------------------------||||------------------------------------------------SSS-----------------------
-----------------#------------------------------------------------------||||-------------------oooo-----------------E----------------------------SSSSS
-----SSS--S-----##----------####--SSC------------------ooo--%%%%%%------||||--------#####--------------------T-----TT---SSS---------------------------
---------------###-----y-#####-------------------------------||||-------||||--------#------------------------T-----TT--t-------------TT---------------
--------------####--y-######----------------%%%%%------------||||-------||||-------K#------------------------T-----TT--t-------------TT-----SSS-------
-------------#####--######-------------------|||-------------||||-------||||--------#---------------------y--T--g--TT--t-------------TT------------r--
XXXXXXXXXXXXXXXXXXXXXXXX------XX--XXXXXX%%---|||----XXXXXXXX-||||-------||||----XXXXXXX---%%%%%%%-%%XXXXXXXXXXXXXXXXXXXXXXX------XXXXXXXXXXX-----XXXXX
XXXXXXXXXXXXXXXXXXXXXXXX------XX--XXXXXX|----|||----XXXXXXXX-||||-------||||----XXXXXXX---||||||---|XXXXXXXXXXXXXXXXXXXXXXX------XXXXXXXXXXX-----XXXXX
