------------------------------------------------------------------------------------------------------------------------------------------------------
------------------------------------------------------------------------------------------------------------------------------------------------------
------------------------------------------------------------------------------------------------------------------------------------------------------
----------SSSSSSSSSS------------------------------------------------------------SSSSSSSSSL----------------------------------------SSSSSSSS------------
------------------------------------------------------------------------------------------------------------------------------------------------------
--------------------------------------oo--------------------------------------------------------------------------------------------------------------
-----------------------------------SSSS---------------------------------------------oooooo----------------------------US---------------------------SSS
----------------------------------------------------------------------------------------------------------TT------------------------------------------
----------------------------------------------------------------------o-------------SSSSSS----------------TT-----------------SSS----------------------
------------------------------------------------------------------------------------SSSSSS-----oooo-------TT--------E---------------------------------
----------------------------TT%-----------------------S--------------T-----------------------------------SXXS------TT---r--------------g##--------#---
----------------------------TT--------------------TT-----------------T--------#------------------------------------TT--t%%%%%%---------###--------#---
----------------------------TT--------------------TT-----------------T-------##---------------------TT-------------TT--t|||||--------g####--------#---
-M----------------------ggg-TT--------------y-y---TT------k---ggg----T------------------------------TT----------g--TT--t|||||--------#####---ggg--#---
XXXXXXXXXXX--XX--X--XXXXXXXXXX--%%%%--%%XXXXXXXXXXXXXXXXXXXXXXXXXXXXXXXXXXXXXXXX---XXXXXXX%%%%%%%-%%XXXXXXXXXXXXXXXXXXXX|||||-----XXXXXXXX--XXXXXXXXXX
XXXXXXXXXXX--XX--X--XXXXXXXXXX---||----|XXXXXXXXXXXXXXXXXXXXXXXXXXXXXXXXXXXXXXXX---XXXXXXX||||||---|XXXXXXXXXXXXXXXXXXXX|||||-----XXXXXXXX--XXXXXXXXXX
