------------------------------------------------------------------------------------------------------------------------------------------------------
------------------------------------------------------------------------------------------------------------------------------------------------------
------------------------------------------------------------------------------------------------------------------------------------------------------
----------------------------------------------------------------------SSSSSSSSSS----------SSSSSSSSSS--------------------------------------------------
------------------------------------------------------------------------------------------------------------------------------------------------------
--------------------------------------oo------------------------------------------g-------------------------------------------------------------------
-----------------------------------SSSS---------------------------SSoo----------SSSSSSSS-----------------------------------------------------QQQQ-----
------------------------------------------------------------------------------TT--------------------------------oooo----------------------------------
---------------------------------------------------------B--------------------TT-----------------------------------------------------g#---------------
---------------------------------------------------------b--------------------TT-----------------------------------------------SSS--g##--------y------
--------SU------%%%%--------TT%------------------------SS#CS%%%%%%----------SCTT------------------------------T---------%-----------###-----Q?SSQQQ---
-----------------||---------TT-------------------------------||||-------TT----TT----------t-----------------g-T--------------------####---------------
-----------------||---------TT-----------------------------K-||||-------TT----TT----------t-----------------TTT-------------------#####---------------
--M--------------||-----ggg-TT-----------------ggg-----------||||-------TT---kTT----------t-----------------TTT---y--------------r#####---------------
XXXXXXXXXXX--%%%%||%XXXXXXXXXX--%%%%--%%-XXXXXXXXXXXXXXXXXXX-||||-----XXXXXXXXXXXXXXXX---XXXXXXXXXXX--XXXXXXXXXXXXXXXXXX----XXXXXXXXXXX--XXXXX--XXXXXX
XXXXXXXXXXX---||-||-XXXXXXXXXX---||----|-XXXXXXXXXXXXXXXXXXX-||||-----XXXXXXXXXXXXXXXX---XXXXXXXXXXX--XXXXXXXXXXXXXXXXXX----XXXXXXXXXXX--XXXXX--XXXXXX
