------------------------------------------------------------------------------------------------------------------------------------------------------
------------------------------------------------------------------------------------------------------------------------------------------------------
------------------------------------------------------------------------------------------------------------------------------------------------------
----------SSSSSSSSSS------------------------------------------------------------------------------------------SS-------S------------------------------
--------------------------------------------------?---------------------------------------------------------------------------------------------------
----------------------ooor--------------ooooo---------------------------------------------------------------------------------------------------------
---------------------%%%%%----S-----------------------------------------SSSSS--------SUS-------------------------------S----------%-------------------
----------------------|||-----------------------SSSS--------------------------------------------------------------------------------------------------
----------------------|||----------------SSSS----------------------------------------------------------------------SSS------------------SSS-----------
----------------------|||------------------------------------------------------------------o----------------------------------------------------------
--------------------%%%%%%%---##--SSC----------------------------------------2------#####--------TT--------------------S----------%%%%%---------------
--------------------||||||-----------------------------SSS-----------------TT-------#------------TT---------g--##------------------|||-------------#--
--------------------||||||--o---------------%%%%%---------------------t----TT--T---K#------------TT---------TT-##------------------|||---------K---#--
-M------------------||||||-%%%---------------|||------------gg-------gt----TT--T----#------------TT---------TT-##---------kkk------|||-------------#--
XXXXXXXXXXX--XX--X--||||||--|-XX--XXXXXX%%---|||------------XXXXXXXXXXXXXXXXXXXXXXXXXXX---XXXXXXXXXX--XXXXXXXX-XX------XXXXXXXXXXX%|||------XXXXX--XXX
XXXXXXXXXXX--XX--X--||||||--|-XX--XXXXXX|----|||------------XXXXXXXXXXXXXXXXXXXXXXXXXXX---XXXXXXXXXX--XXXXXXXX-XX------XXXXXXXXXXX-|||------XXXXX--XXX
