------------------------------------------------------------------------------------------------------------------------------------------------------
------------------------------------------------------------------------------------------------------------------------------------------------------
------------------------------------------------------------------------------------------------------------------------------------------------------
----------SSSSSSSSSS--------------------------------------------------SSSSSSSSSS----------------------------------------------------------------------
------------------------------------------------------------------------------------------------------------------------------------------------------
-------------------------------------------------------oooo-----------------------g-------------------oo----------------------------------------------
----------------------!-----------------------QQQQ-----%%%%---USSS--------------SSSSSSSS-----------------------------------------------------QQQQ-----
--------------------------------o----ooo----------SSSS--||--------------------TT----------------------------------------------------------------------
--------------------------------------------------------||--------------------TT----------------------------------------------------------------------
------------------------------------------------k-------||--------------------TT---------------------------------------------------------------y------
--------SU----------S@S!S-------------%%T-----?QQQ------||---S-----TT-------SCTT----------------TT------------------------------------------Q?SSQQQ---
---------------------------------------|T-------------U-||---------TT---TT----TT----------------TT-------------#---------------------TT---------------
----------------------------tt---------|T---------------||---------TT---TT----TT----------------TT----------tt-#---------------------TT---------------
--M------------------g------tt-%%%%%%%-|T---------------||---ggg---TT---TT---kTT------------k---TT----ggg---tt-#----ggg--k----ggg----TT---------------
XXXXXXXXXXX--XX--X--XXXXXXXXXX--|||||--|XXXXXXXXXX----%%%%%-XXXXXXXXXXXXXXXXXXXXXXXXXX---XXXXXXXXXXXXXXXXXXXXX-XXXXXXXXXXXXXXXXXXXXXXXXXXXXXXX--XXXXXX
XXXXXXXXXXX--XX--X--XXXXXXXXXX--|||||--|XXXXXXXXXX-----|||--XXXXXXXXXXXXXXXXXXXXXXXXXX---XXXXXXXXXXXXXXXXXXXXX-XXXXXXXXXXXXXXXXXXXXXXXXXXXXXXX--XXXXXX
