------------------------------------------------------------------------------------------------------------------------------------------------------
------------------------------------------------------------------------------------------------------------------------------------------------------
------------------------------------------------------------------------------------------------------------------------------------------------------
----------SSSSSSSSSS----------------------------------------------------------------------------------------------------SSS-----SS--------------------
------------------------------------------------------------------------------------------------------------------------------------------------------
----------------------------------------ooooo-------------------------------------------------------oo------------------------------------------------
--------------------USS------------------------------------------------------------USS--------------%%%-------?SSS------US-------------US-------------
------------------------------------------------SS--------------------------------------------------||--o----R----------------------------------------
-----------------------------------------SSSS-------------------------------------------------------||-%%%------------------SSS-----------------------
------------------------------------------------------------------------------------------------g---||--|----------------------------SS---------------
----------@QQQQ------------------------T---------------ooo------------------------#-------------TT--||--|-----SSSSS-----SSS----------------S--#LSS----
---------------------B-----------------T------------------------------------------#-------------TT--||-o|-------------------------------------#-------
-----------------g-#-b-------B---------T----%%%%%---------------------------------##------------TT--||%%%%%-----------------------TT----------#-------
----------------g#-#-B-------b--gg-----T-----|||------------gg-------g------------##--gg--------TT--||-|||------K-----------------TT--------kk#-------
XXXXXXXXXXXXXXXXXXXXXXXXXXXXXXXXXXXXXXXX%%---|||----XXXXXXXXXXXXXXXXXXX----XXXXX--XXXXXXXXXXXXXXXXX-||-|||----XXXXXXXXXXXXX------XXXXXXX-X-XXXXXXXX---
XXXXXXXXXXXXXXXXXXXXXXXXXXXXXXXXXXXXXXXX|----|||----XXXXXXXXXXXXXXXXXXX----XXXXX--XXXXXXXXXXXXXXXXX-||-|||----XXXXXXXXXXXXX------XXXXXXX-X-XXXXXXXX---
