------------------------------------------------------------------------------------------------------------------------------------------------------
------------------------------------------------------------------------------------------------------------------------------------------------------
------------------------------------------------------------------------------------------------------------------------------------------------------
--------------------------------------------------SSSSSSSSSS----------SSSSSSSSSSSSSSSSSSSLSSSSSSSSSS--------------------------------------------------
--------------------------------------------?---------SS--SS------------------------------------------------------------------------------------------
------------------------------------------------------SS--SS---------R--------------------------------oo----------------------------------------------
--------------------S-------------------------------SS------------------------------oooooo-------------------------oo---SS---------------##-SS--------
---------------------------TT-----------------r-----SS------------------------TT---------------------------------------------------------##-----------
---------------------------TT-------------%%%%%%----SS------------------------TT----SSSSSS---------------------------------------------####-----------
---------------------------XX------oo------||||-----SS----oo------------------TT----SSSSSS---------------------------------TT----------####-----------
-----SSS---------------TT---------o--o--%%-||||ooo--SSSS--SS-----%%%--------SCTT-------------------------------%%%%--%%%---TT--------######-SS--------
-----------------------TT---------------|--||||--r----SS----------|-----TT----TT----------t---------------------||----||t--TT--------######-------#-TT
-----------------------TT---------------|%%%%%%%%%----SS----------|-----TT----TT----------t-----------------tt--||----||t--TT--------######------##-TT
----------k---ggg---k--TT---------------|-||||||||----------------|-----TT---kTT----------t-----------ggg---tto-||----||t--TT--------######-----###-TT
XXXXXXXXXXXXXXXXXXXXXXXXXXXXXXXXXXXXXXXX|-||||||||XXXXXXXXXX%%%%%-|---XXXXXXXXXX---XXXXXXXXXXXXXXXXXXXXXXXXXXX%-||----||XXXXXXXXXXXXXXXXXXXXXXXXXXX-XX
XXXXXXXXXXXXXXXXXXXXXXXXXXXXXXXXXXXXXXXX|-||||||||XXXXXXXXXX-|||--|---XXXXXXXXXX---XXXXXXXXXXXXXXXXXXXXXXXXXXX--||----||XXXXXXXXXXXXXXXXXXXXXXXXXXX-XX
