------------------------------------------------------------------------------------------------------------------------------------------------------
------------------------------------------------------------------------------------------------------------------------------------------------------
------------------------------------------------------------------------------------------------------------------------------------------------------
----------------------------------------SSSSSSSSSS--------------------SSSSSSSSSS----------------------------------------------------------------------
------------------------------------------------------------------------------------------------------------------------------------------------------
-----------------------SSS-------------------------------------------R------------------oo------------------------------------------------------------
-----------------------------------------oooo-----------------------------------oo---------------------------@----------SS---------SSSS-----SS--------
---------------------g--------------------------------------------------------TT----------------------------------------------------------------------
--------------------%%%------------------SSSS-U-------------------------------TT----------------------------------------------------------------------
--------------------||----SSS-----------oS--SoS-------------------------------TT-SS-------------g--------------------------TT----------SSSS-----------
-----SSS------------||---------TT-------SS--SSS-------S----------%%%--------SCTT---------S------TT--SU----!--!-------------TT---------------SS--------
-----------------K--||---------TT-----------------TT--------------|-----TT----TT----------------TT----------------------t--TT---------------------#-TT
------------B-------||---------TT-----------------TT--------------|-----TT----TT----------------TT-----------------B----t--TT--------------------##-TT
------------b-------||----oo--gTT---------kk------TT------k-------|-----TT---kTT----------------TT--------k--------b----t--TT-------------------###-TT
XXXXXXXXXXXXXXXXXXXX||---%%%--XXXXXXXX--XXXXXXXXXXXXXXXXXXXX%%%%%-|---XXXXXXXXXX----------XXXXXXXXX-XXXXXXXXXXXXXXXXXXXXXXXXXXXXXX---------XXXXXXXX-XX
XXXXXXXXXXXXXXXXXXXX||----|---XXXXXXXX--XXXXXXXXXXXXXXXXXXXX-|||--|---XXXXXXXXXX----------XXXXXXXXX-XXXXXXXXXXXXXXXXXXXXXXXXXXXXXX---------XXXXXXXX-XX
