------------------------------------------------------------------------------------------------------------------------------------------------------
------------------------------------------------------------------------------------------------------------------------------------------------------
------------------------------------------------------------------------------------------------------------------------------------------------------
--------------------SSSSSSSSSS----------------------------------------SSSSSSSSSS----------------------------------------------------------------------
------------------------------------------------------------------------------------------------------------------------------------------------------
----------------------------------------------------------------------------------------oo------------oo----------------------------------------------
---------------------------------------------------------Q-Q--------------------oo---------SSS!-------------------------SSS-----------------SSS-------
------------------------------------------------------------------------------TT----------------------------------------------------------------------
------------------------------------------------------------------------------TT----------------------------------------------------------------------
-----------------------------C----------------------------------1-------------TT-SSS-------------------------------------------------------------SSSSS
-------------------%---#-#-------------------------------Q-Q----------------SCTT---------S----C-----------------------r-------------------------------
---------------------#-#-#-#----------K---------------------------------TT----TT----------------------------------%%%%%%-------------TT---------------
---------------------#-#-#-#--TTTT--------------------------------------TT----TT----------------------------tt-----|||||------TT-----TT-----SSS-------
-M-----------%%%%----#-#-#-#-ETTTT-------------ggg----------------------TT---kTT---------------g-g----ggg---tt-----|||||------TT-----TT------------r--
XXXXXXXXXXX---||----XXXXXXXXXXXXXXXXXXXX-XXXXXXXXXXXXXXXXXXXXXXXXXXXX-XXXXXXXXXX----------XXXXXXXXXXXXXXXXXXXX-%%%-|||||----XXXXXXXXXXXXXXXX-----XXXXX
XXXXXXXXXXX---||----XXXXXXXXXXXXXXXXXXXX-XXXXXXXXXXXXXXXXXXXXXXXXXXXX-XXXXXXXXXX----------XXXXXXXXXXXXXXXXXXXX--|--|||||----XXXXXXXXXXXXXXXX-----XXXXX
