------------------------------------------------------------------------------------------------------------------------------------------------------
------------------------------------------------------------------------------------------------------------------------------------------------------
------------------------------------------------------------------------------------------------------------------------------------------------------
------------------------------------------------------------------------------------------------------------------------------------------------------
------------------------------------------------------------------------------------------------------------------------------------------------------
----------------------------------------------------------------------------------------oo------------------------------------------------------------
--------------------------------------------------------------------------SSCSS-oo--------------------------------------------------------------------
------------------------------------------------------------------------------------------------------------------------------------------------------
-----------------%%%-------------------------------------TT----------o--------------------------------------------------------SSS---------------------
------------------||-------------------------------TT----TT------y---------------SSS--------------oo--------------------------------------------------
---------Q--------||SS-----------------------------TT----XX------##-----QQQQ--QQ---------S------------------------------%-----------------------------
-------------%%%%%||-K---TT-----------tt-----------TT-----------###----------------------------TT------------------------------------TT---------------
--------------|||-||-----TT-----------tt-----------TT----------####----------------------------TT---------*--------------------------TT------------F--
--------------|||-||-----TT-----------tt-------y---TT---------#####-------------------------y--TT---gg----*----k----kkk----------r---TT------------#--
XXXXXXXXXXX---|||-||XXXXXXXXXXXXXXXXXXXXXXXXXXXXXXXXXXXXXXXXXXXXXXX---XXXXXXXXXX----------XXXXXXXXXXXXXXXXXXX-XXXXXXXXXX----XXXXXXXXXXXXXXXXXXXXXXXXXX
XXXXXXXXXXX---|||-||XXXXXXXXXXXXXXXXXXXXXXXXXXXXXXXXXXXXXXXXXXXXXXX---XXXXXXXXXX----------XXXXXXXXXXXXXXXXXXX-XXXXXXXXXX----XXXXXXXXXXXXXXXXXXXXXXXXXX
