------------------------------------------------------------------------------------------------------------------------------------------------------
------------------------------------------------------------------------------------------------------------------------------------------------------
------------------------------------------------------------------------------------------------------------------------------------------------------
------------------------------SSSSSSSSSS----------------------------------------ooo-------------------------------------------------------------------
------------------------------SSSSSSSSSS----------------------------------------%%%------------------------------------------------------------------o
------------------------------SSSSSSSSSS-----------------------------------------|--------------------------------------------------------------------
------------------------------SSSSSSSSSS----------------------------------SS-----|--------SSS------%---------------oo-------------!S------------------
-------------------------------------------------------------o---o---o-----------|--------------------------------------------------------------SSS---
------------------------------------------------------------%%%-%%%-%%-----------|----------------------------------------------------------oo--------
-------------------------------------------------------------|---|---|-----------|---%%%%-------------------------------------------------------------
---------Q------%%%%----------SSSSSSSSSS-----------------tt--|---|---|SS-----SS--|----||----%%%----------------%%%%--%%%----------S------#--SS--------
-----------------||-----------SSSSSSSSSS-----------------tt--|---|---|----------%%%%%%||-----|--------------g---||----||----------------##------------
-----------------||-----------SSSSSSSSSS-----------------tt--|---|---|-----------||||-||-----|--------------TT--||----||---------------###------------
-M---------------||------ggg--SSSSSSSSSS-------y-----g-g-tt--|---|-r-|-----------||||-||-----|--------------TTo-||----||-k----ggg-----####------------
XXXXXXXXXXX--%%%%||%XXXXXXXXXXXXXXXXXXXXXXXXXXXXXXXXXXXXXXXX%%%%%%%%%%-----------||||-||%%---|--------XXXXXXXX%-||----||XXXXXXXXXXXXXXXXXXXX----------
XXXXXXXXXXX---||-||-XXXXXXXXXXXXXXXXXXXXXXXXXXXXXXXXXXXXXXXX-|||||||||-----------||||-||-|---|--------XXXXXXXX--||----||XXXXXXXXXXXXXXXXXXXX----------
