------------------------------------------------------------------------------------------------------------------------------------------------------
------------------------------------------------------------------------------------------------------------------------------------------------------
------------------------------------------------------------------------------------------------------------------------------------------------------
----------SSSSSSSSSS----------------------------------------------------------------------------------------------------------------------------------
------------------------------------------------------------------------------------------------------------------------------------------------------
------------------------------------------------------------------------------------------------------oo----------------------------------------------
---------------------------------------------------------Q-Q--USSS------SSSSS--------SSSS---------------------?SSS------------------------------------
----------------------------------------------------------------------------------------------------------------------------------oo------------------
------------------------------------------------------------------------------------------------------------------------------------------------------
------------------------------------------------------------------------------------------------g-----------------------------------------------------
-------------------------------TT------------------------Q-Q-S-----TT--------2--Q---------------TT------------SSSSS------------------------Q--#LSS----
-------------------------------TT------------K---B-----------------TT------TT-------------------TT--------------------------------------------#-------
-------------------------------TT----------------b-----------------TT-t----TT--T----------------TT----------tt--------------------------------#-------
---M---------------------ggg--gTT----------------B-----------ggg---TT-t----TT--T-ggg------------TT----ggg---tt--K--------k----ggg-----------kk#-------
XXXXXXXXXXX--XX--X--XXXXXXXXXXXXXXXXXX--XXXXXXXXXXXXXXXXXXXXXXXXXXXXXXXXXXXXXXXXXXXXX----XXXXXXXXXX-XXXXXXXXXXXXXXXXXXXXXXXXXXXXXXXXXXXXXXXXXXXXXXX---
XXXXXXXXXXX--XX--X--XXXXXXXXXXXXXXXXXX--XXXXXXXXXXXXXXXXXXXXXXXXXXXXXXXXXXXXXXXXXXXXX----XXXXXXXXXX-XXXXXXXXXXXXXXXXXXXXXXXXXXXXXXXXXXXXXXXXXXXXXXX---
