------------------------------------------------------------------------------------------------------------------------------------------------------
------------------------------------------------------------------------------------------------------------------------------------------------------
------------------------------------------------------------------------------------------------------------------------------------------------------
------------------------------SSSSSSSSSS----------------------------------------SSSSSSSSSS--------------------------------------------------SSSSSSSSSS
------------------------------SSSSSSSSSS--------------------------------------------------------------------------------------------------------------
-----------------------SSS----SSSSSSSSSS------------------------------------------------------------oo------------------------------------------------
------------------------------SSSSSSSSSS------------------------------------------------------------%%%-------?SSS------SSS---------------------------
---------------------g------------------------------------------------------------------------------||--o----R----------------------------------------
--------------------%%%-----------------------------------------------------------------------------||-%%%--------------------------------------------
------------Q--?----||----SSS----------------------------------------------------------S------------||--|---------------------------------------------
-------------------S||--------SSSSSSSSSS---------------ooo----------------------SU------------------||--|-----SSSSS------------------------#--TT------
--------------------||--------SSSSSSSSSST-----TT------------------------------------TT---t----------||-o|---------------------------------##--TT------
--------------------||--------SSSSSSSSSST-----TT------------------------------------TT---t-------B--||%%%%%-------------------TT---------###--TT------
-M----------------K-||----oo--SSSSSSSSSST-----TT-------------y---------------------kTT--kt-------b--||-|||------K-------------TT-----y--####--TT------
XXXXXXXXXXXXXXXXXXXX||---%%%--XXXXXXXXXXXXXX--XXXX--XXXXXXXXXXXXXXXXXXX----XXXXXXXXXXXXXXXXXXXXXXXXX||-|||----XXXXXXXXXX----XXXXXXXXXXXXXXXXXXXX--XXXX
XXXXXXXXXXXXXXXXXXXX||----|---XXXXXXXXXXXXXX--XXXX--XXXXXXXXXXXXXXXXXXX----XXXXXXXXXXXXXXXXXXXXXXXXX||-|||----XXXXXXXXXX----XXXXXXXXXXXXXXXXXXXX--XXXX
