------------------------------------------------------------------------------------------------------------------------------------------------------
------------------------------------------------------------------------------------------------------------------------------------------------------
------------------------------------------------------------------------------------------------------------------------------------------------------
----------------------------------------SSSSSSSSSS------------------------------ooo-------------------------------------------------------------------
--------------------------------------------------?-----------------------------%%%-------------------------------------------------------------------
---------------------------------------------------------------------------------|--------------------------------------------------------------------
--------------------S--------------------oooo-----------------------------SS-----|---------------------------@-------------------------US-------------
---------------------------TT---------------------SS-----------------------------|------------------------------oooo----------------------------------
---------------------------TT------------SSSS-U----------------------------------|-------------------------------------------SSS----------------------
---------------------------XX-----------oS--SoS----------------------------------|---%%%%---------oo---------------------------------SS---------------
---------Q---------%---TT---------------SS--SSS----------------------#SS-----SS--|----||------------SU----!--!T---------r------------------S#---------
-----------------------TT------------------------------SSS----------##----------%%%%%%||-------TT-------------T---------%%%%%%--------------##--------
-----------------------TT-----------------------------------TT-----###-----------||||-||-------TT-------------T---------|||||-----TT--------###------#
-------------%%%%---k--TT---------k-k-----kk----------------TT----####-----------||||-||----y--TT---------k---T---y-----|||||-----TT--------####----##
XXXXXXXXXXX---||----XXXXXXXXXXXXXXXXXXX-XXXXXXXXXX----------XXXXXXXXXX-----------||||-||%%XXXXXXXXXXXXXXXXXXXXXXXXXXXXXX|||||-----XXXXXX-X-XXXXXXXXXXX
XXXXXXXXXXX---||----XXXXXXXXXXXXXXXXXXX-XXXXXXXXXX----------XXXXXXXXXX-----------||||-||-|XXXXXXXXXXXXXXXXXXXXXXXXXXXXXX|||||-----XXXXXX-X-XXXXXXXXXXX
