------------------------------------------------------------------------------------------------------------------------------------------------------
------------------------------------------------------------------------------------------------------------------------------------------------------
------------------------------------------------------------------------------------------------------------------------------------------------------
------------------------------------------------------------------------------------------------------------------------------------------------------
------------------------------------------------------------------------------------------------------------------------------------------------------
----------------------------------------ooooo-------------------------------------------oo------------------------------------------------------------
------------------------------S--------------------------------------------g----oo--------------------------------------------------------------------
------------------------------------------------SS---------------------%%%%%%-----------------------------------------------------oo------------------
-----------------------------------------SSSS---------------------------||||-------------------------------------------------SSS----------------------
------------------------------------------------------------------------||||-----SSS------------g-----------------------------------------------------
------------------------------##--SSC--------------------tt-------------||||-------------S------TT--------------------r-r------------------Q----------
---------------------------------------------------------tt-------------||||--------------------TT----TT----------%%%%%%%%%%%%---------------------#--
--------------------------------------------%%%%%--------tt-------------||||--------------------TT----TT----TT-----||||||||||------------------K---#--
-M------------k-ggg------ggg-----------------|||-----g-g-tt-gg-------g--||||--------------------TT----TT-k--TT-----||||||||||----------------------#--
XXXXXXXXXXXXXXXXXXXXXXXXXXXXXXXX--XXXXXX%%---|||--XXXXXXXXXXXXXXXXXXXX--||||--------------XXXXXXXXX-XXXXXXXXXX-%%%-||||||||||-----XXXXXXXXXXXXXXX--XXX
XXXXXXXXXXXXXXXXXXXXXXXXXXXXXXXX--XXXXXX|----|||--XXXXXXXXXXXXXXXXXXXX--||||--------------XXXXXXXXX-XXXXXXXXXX--|--||||||||||-----XXXXXXXXXXXXXXX--XXX
