------------------------------------------------------------------------------------------------------------------------------------------------------
------------------------------------------------------------------------------------------------------------------------------------------------------
------------------------------------------------------------------------------------------------------------------------------------------------------
--------------------------------------------------SSSSSSSSSS--------------------------------------------------------------------------------SSSSSSSSSS
-----------------------------------------g------------SS--SS------------------------------------------------------------------------------------------
----------------------------------------%%------------SS--SS---------R------------------oo------------------------------------------------------------
---------------------LSSS---------------|-----------SS---------------------g----oo--------------------------------------------------------------------
--------------------------------o----ooo|----oo-----SS-----------------%%%%%%---------------------oooo------------------------------------------------
----------------------------------------|-----------SS------------------||||-------------------------------------------------SSS-----g#---------------
----------------------------------------|-----------SS----oo------------||||-----SS-------------------------------------------------g##---------------
---------Q---------%-2-----#----------%%|-----------SSSS--SS-----%%%----||||-------------S-------------------T----------r-----------###-------TT------
---------------------------#-----------||-------------SS----------|-----||||--------------------#------------T----------%%%%%%-----####-------TT------
---------------------------##----------||-------------SS----------|-----||||--------------------#------------T-----B----|||||-----#####-------TT------
-------------%%%%-----kk---##--%%%%%%%-||-------------------------|-----||||--------------------#---------y--T-----b----|||||-----#####-------TT------
XXXXXXXXXXX---||----XXXXXXXXXX--|||||--||----%%%%-XXXXXXXXXX%%%%%-|-----||||--------------XXXXXXXXXXXXXXXXXXXXXXXXXXXXXX|||||-----XXXXX--XXXXXXX--XXXX
XXXXXXXXXXX---||----XXXXXXXXXX--|||||--||-----||--XXXXXXXXXX-|||--|-----||||--------------XXXXXXXXXXXXXXXXXXXXXXXXXXXXXX|||||-----XXXXX--XXXXXXX--XXXX
