------------------------------------------------------------------------------------------------------------------------------------------------------
------------------------------------------------------------------------------------------------------------------------------------------------------
------------------------------------------------------------------------------------------------------------------------------------------------------
------------------------------SSSSSSSSSS--------------------------------------------------------------------------------------------------------------
------------------------------------------------------------------------------------------------------------------------------------------------------
-----------------------SSS-----------------------------oooo-----------------------------------------oo------------------------------------------------
----------------------------------------------QQQQ-----%%%%-------------------------y---------------%%%-------?SSS-------SSS----S!--------------------
---------------------g----------------------------------||------------------------#SSS--------------||--o----R----------------------------------------
--------------------%%%----------------S----------------||---------------------g-##-----------------||-%%%--------------------------------------------
--------------------||----SSS----------S--------k-SSS---||----------------------###1----------------||--|---------------------------------------------
--------------------||-----------------ST-----?QQQ------||-----------T-------S@S###-----------------||--|-----SSSSS--------------S--------------------
-----------------K--||---------#--------T-------------U-||-----------T----------###--SSS------------||-o|---------------------------------------------
------------B-------||---------#-#------T---------------||-----------T----------###--------------B--||%%%%%----------------------------------------F--
-M----------b-------||----oo---#-#------T---------------||----ggg----T----------###--------------b--||-|||------K-----------gg-g-g-----------------#--
XXXXXXXXXXXXXXXXXXXX||---%%%--XXXXXXXXXXXXXXXXXXXX----%%%%%-XXXXXXXXXX-XXXXXXXXXXXXXXX---XXXXXXXXXXX||-|||----XXXXXXXXXXXXXXXXXXXXXXXXXXXXXXXXXXXXXXXX
XXXXXXXXXXXXXXXXXXXX||----|---XXXXXXXXXXXXXXXXXXXX-----|||--XXXXXXXXXX-XXXXXXXXXXXXXXX---XXXXXXXXXXX||-|||----XXXXXXXXXXXXXXXXXXXXXXXXXXXXXXXXXXXXXXXX
