------------------------------------------------------------------------------------------------------------------------------------------------------
------------------------------------------------------------------------------------------------------------------------------------------------------
------------------------------------------------------------------------------------------------------------------------------------------------------
S-----SSSS------------------------------SSSSSSSSSS-oo---------------------------------------------------------SSSSSSSSSSSSS-----SS--------------------
S---------------------------------------SSSSSSSS--%%%%------------------------------------------------------------------------------------------------
S---------------------------------------SSSCSSSS---||-----------------------------------oo------------------------------------------------------------
S-------------------USS-------S---------SSSSSSSS---||----------------------1----oo----------------------SSQSSS----------US---------------##-----------
S--------------------------------------------------||--SSS---o---o---o----------------------------oo-------------------------------------##-----------
S--------------------------------------------------||-------%%%-%%%-%%------------------------------------------------------SSS--------####-----------
S-----------Q--?---------------------------ggg-----||--------|---|---|-----ggg---SSS----------------------K----------------------------####-----------
S------------------S----------##--SSC---SSSSSSSS---||--------|---|---|#########----------S--------------SSSSSST---------SSS----------######---#LSS----
S--------------------B------------------SSSSSSSS---||--------|---|---|--------#-----------------#-------------T----------------------######---#-------
S--------------------b-------B----------SSSSSSSS--%||--------|---|---|--------#-----------------#-------------T----TT----------------######---#-------
S-----------------K--B-------b----------SSSSSSSS---||--------|---|-r-|--------#-----------------#-------------T--g-TT----------------######-kk#-------
XXXXXXXXXXXXXXXXXXXXXXXXXXXXXXXX--XXXXXXXXXXXXXXXX-||-------%%%%%%%%%%--------X-----------XXXXXXXXXXXXXXXXXXXXXXXXXXXXXXXXX------XXXXXXXXXXXXXXXXXX---
XXXXXXXXXXXXXXXXXXXXXXXXXXXXXXXX--XXXXXXXXXXXXXXXX-||--------|||||||||--------X-----------XXXXXXXXXXXXXXXXXXXXXXXXXXXXXXXXX------XXXXXXXXXXXXXXXXXX---
