------------------------------------------------------------------------------------------------------------------------------------------------------
------------------------------------------------------------------------------------------------------------------------------------------------------
------------------------------------------------------------------------------------------------------------------------------------------------------
----------------------------------------SSSSSSSSSS--------------------SSSSSSSSSS----------------------------------------SSS-----SS--------------------
----------------------------------------SSSSSSSS----------------------------SSSS----------------------------------------------------------------------
----------------------ooor--------------SSSCSSSS-------------------------g--SSSS--------oo------------oo----------------------------------------------
---------------------%%%%%--------------SSSSSSSS------------------------SS------oo---------------------------------oo---US---------------##-----------
----------------------|||------------------------------------o---o---o--SS---------------------------------------------------------------##-----------
----------------------|||-----------------------------------%%%-%%%-%%--SS--------------------------------------------------SSS--------####-----------
----------------------|||------------------ggg---------------|---|---|--SC--g-g--SSS---------------------------------------------------####-----------
---------Q------!---%%%%%%%-------------SSSSSSSS-------ooo---|---|---|--SS--SSSS---------S---------------------%%%%--%%%SSS----------######-----------
--------------------||||||--------------SSSSSSSS-------------|---|---|------------------------------------------||----||-------------######-----------
--------------------||||||--o-----------SSSSSSSS-------------|---|---|--------------------------------------tt--||----||-------------######--------F--
--------------------||||||-%%%----k-k---SSSSSSSS-------------|---|-r-|-----------------------------g--ggg---tto-||----||-------------######--------#--
XXXXXXXXXXXXXXXXXXXX||||||--|-XXXXXXXXX-XXXXXXXXXX--XXXXXXXX%%%%%%%%%%XXXXXXXXXX-----------XXXXXXXXXXXXXXXXXXX%-||----||XXX------XXXXXXXXXXXXXXXXXXXXX
XXXXXXXXXXXXXXXXXXXX||||||--|-XXXXXXXXX-XXXXXXXXXX--XXXXXXXX-|||||||||XXXXXXXXXX-----------XXXXXXXXXXXXXXXXXXX--||----||XXX------XXXXXXXXXXXXXXXXXXXXX
