------------------------------------------------------------------------------------------------------------------------------------------------------
------------------------------------------------------------------------------------------------------------------------------------------------------
------------------------------------------------------------------------------------------------------------------------------------------------------
-----------------------oo-----------------------------------------------------------------------------------------------SSSSSSSSSSSSSSSSSS------------
------------------------------------------------------------------------------------------------------------------------------------------------------
----------------------------------------------------------------------------------------oo----------oo------------------------------------------------
----------------------SSSS-------------------------------------------------g----oo------------------%%%-----------------------------------------------
-----------------------------------------------------------------------%%%%%%-----------------------||--o----R----------------------------------------
------------------------------------------------------------------------||||------------------------||-%%%--------------------------------------------
------------------------------------------------------------------------||||-----SS-----------------||--|---------------------------------------------
-------------------%------%%%%-TT----------------------ooo--------------||||-------------S-------tt-||--|------------------------------g##------------
---------------------------|||-TT---------------------------------------||||--------------T------tt-||-o|-----------------SS-----------###------------
---------------------------|||-TT---------------------------------------||||--------------T------tt-||%%%%%--------B------SS---------g####---------F--
-M-----------%%%%----------|||gTT----------------------------y----------||||--------------T------tt-||-|||---------b------SS---------#####---------#--
XXXXXXXXXXX---||----%%%----|||XXXXXXXX--X-XX-XX-XX--XXXXXXXXXXXXXXXXXX--||||--------------XXXXXXXXXX||-|||----XXXXXXXXXX--XX--XXXXXXXXXXXX--XXXXXXXXXX
XXXXXXXXXXX---||----||-----|||XXXXXXXX--X-XX-XX-XX--XXXXXXXXXXXXXXXXXX--||||--------------XXXXXXXXXX||-|||----XXXXXXXXXX--XX--XXXXXXXXXXXX--XXXXXXXXXX
