------------------------------------------------------------------------------------------------------------------------------------------------------
------------------------------------------------------------------------------------------------------------------------------------------------------
------------------------------------------------------------------------------------------------------------------------------------------------------
------------------------------SSSSSSSSSS--------------------SSSSSSSSSSSSSSSSSSSS------------------------------SS-------S------------------------------
------------------------------------------------------------SSSS--SSSS------SSSS----------------------------------------------------------------------
-----------------------SSS-----------------------------oooo-SSSS--SSSS---g--SSSS------------oo--------------------------------------------------------
------------------SC-----------------------------------%%%%---SS---S----SS---------o--o--------------------------------S------------------------------
---------------------g----------------------------------||----SS---S----SS--------------------------------TT----------------------oo------------------
--------------------%%%----------------S----------------||----SS---S----SS-------------------------%------TT-------SSS-------SSS----------------------
--------------------||----SSS----------S----------SSS---||--ooSS---SoU--SC--g-g----SSSS-------------------TT------------------------------------------
--------------TT---2||-----------------S-TT---SU--------||--SSSS---SSS--SS--SSSS----------SS-------------SXXS----------Sr------------------Q#---------
--------------TT----||---------#---------TT-----------U-||-----------------------------------------------------##-------%%%%%%--------------##--------
--------------TT----||---------#-#-------TT-------------||----------------------%%%----------%%%%---TT---------##-------|||||---------------###------#
-M------------TT----||----oo---#-#-------TT------k------||--k--g-g--------------||------------||----TT---------##-------|||||---------------####----##
XXXXXXXXXXXXXXXXXXXX||---%%%--XXXXXXXXXXXXXXXXXXXX----%%%%%-XXXXXXXXXXXXXXXXXXXX||------------||----XXXXXXXXXX-XX------X|||||-----XXXXXXXXXXXXXXXXXXXX
XXXXXXXXXXXXXXXXXXXX||----|---XXXXXXXXXXXXXXXXXXXX-----|||--XXXXXXXXXXXXXXXXXXXX||------------||----XXXXXXXXXX-XX------X|||||-----XXXXXXXXXXXXXXXXXXXX
