------------------------------------------------------------------------------------------------------------------------------------------------------
------------------------------------------------------------------------------------------------------------------------------------------------------
------------------------------------------------------------------------------------------------------------------------------------------------------
----------------------------------------------------------------------------------------------------------------------------------SSSSSSSSSS----------
--------------------------------------------?---------------------------------------------------------------------------------------------------------
---------------------------------------------------------------------R----------------------oo--------------------------------------------------------
---------------------------------------------------------Q-Q-------------------------SSSS---------------SSQSSS----------------------------------------
----------------------------------------------r-------------------------------------------------------------------------------------------------------
------------------------------------------%%%%%%---------------------------------------------------%-------------------y------------------------------
-------------------------------------------||||--------------------------1--------------------------------K------------XSS-?Q-------------------------
----------Q-----------------TT--QQQQ----%%-||||ooo-------Q-Q-----%%%--T---------Q---------SS------------SSSSSS--------XX------------------------------
----------------------------TT-------K-B|--||||--r----------------|---T----TT----------------------------------------XXX------------------TT----------
----------------------------TT---------b|%%%%%%%%%----------------|---T----TT----------------%%%%-------------------XXXX-------y---tt-----TT-------F--
---M---------------#----ggg-TT---------b|-||||||||----------------|---T---kTT----ggg----------||-------------------XXXXX---SSSSS---tt----kTT-------#--
XXXXXXXXXXXXX--XXXXXXXXXXXXXXXXXXXXXXXXX|-||||||||XXXXXXXXXX%%%%%-|---XXXXXXXXXXXXXXX----X----||----XXXXXXXXXXXXXXXXXXXX-------XX-XXXXXXXXXXXXXXXXXXXX
XXXXXXXXXXXXX--XXXXXXXXXXXXXXXXXXXXXXXXX|-||||||||XXXXXXXXXX-|||--|---XXXXXXXXXXXXXXX----X----||----XXXXXXXXXXXXXXXXXXXX-------XX-XXXXXXXXXXXXXXXXXXXX
