------------------------------------------------------------------------------------------------------------------------------------------------------
------------------------------------------------------------------------------------------------------------------------------------------------------
------------------------------------------------------------------------------------------------------------------------------------------------------
--------------------SSSSSSSSSS------------------------------------------------------------------------------------------------------------------------
------------------------------------------------------------------------------------------------------------------------------------------------------
--------------------------------------oo-----------------------------R--------------------------------------------------------------------------------
------------------Q----------------SSSS----------------------------------------------------------------------@?SSS--------------------------SS--------
------------------------------------------------------------------------------------------------------------------------------------------------------
----------------------------------------------------------------------------------TT-----------------------------------------SSS----------------------
-----------------------------C----------------------------------------------------TT-----------oooo---------------------------------------------------
--------SU--------?----#-#----%---------------tt-------ooo-------%%%--------------TT----------------SU----!--!SSSSS-----r-------------------SS--------
--------------TT-----#-#-#-#------------------tt------------------|---------------TT-----T------------------------------%%%%%%--------------------#-TT
--------------TT-----#-#-#-#------------------tt------------------|-------------T-TT-----T------------------------------|||||--------------------##-TT
--M-----------TT-----#-#-#-#-E-----------g----tt------------------|-------------T-TT---k-T----------------k-----K-------|||||-------------------###-TT
XXXXXXXXXXXXXXXXXXXXXXXXXXXXXX--%%%%--%%XXXXXXXXXX--XXXXXXXX%%%%%-|---X----XXXXXXXXXXXXXXX%%%%%%%-%%XXXXXXXXXXXXXXXXXXXX|||||-----XXXXXXXXXXXXXXXXX-XX
XXXXXXXXXXXXXXXXXXXXXXXXXXXXXX---||----|XXXXXXXXXX--XXXXXXXX-|||--|---X----XXXXXXXXXXXXXXX||||||---|XXXXXXXXXXXXXXXXXXXX|||||-----XXXXXXXXXXXXXXXXX-XX
