------------------------------------------------------------------------------------------------------------------------------------------------------
------------------------------------------------------------------------------------------------------------------------------------------------------
------------------------------------------------------------------------------------------------------------------------------------------------------
--------------------SSSSSSSSSS----------------------------------------------------------------------------------------------------SSSSSSSSSS----------
------------------------------------------------------------------------------------------------------------------------------------------------------
-------------------------------------------------------oooo-------------------------------------------------------------------------------------------
-------------------------------------------------------%%%%--------------------------1-----------------------------oo---SS------------------SS--------
--------------------------------------------------SSSS--||--------------------------------------------------------------------------------------------
--------------------------------------------------------||--------------------------------------------------------------------------------------------
-----------------------------C--------------------------||---------------1-------------------------------------------------TT-------------------------
----------Q------------#-#-----TT-------------tt--------||------------T------------QQQQ------------------------%%%%--%%%---TT---------------SS--------
---------------------#-#-#-#---TT-------------tt------U-||------------T----TT-----------------------------------||----||t--TT-------------TT------#-TT
---------------------#-#-#-#---TT-------------tt--------||------------T----TT-----------------------------*-----||----||t--TT------tt-----TT-----##-TT
-M-----------------#-#-#-#-#-EgTT--------g----tt--------||--gg-------gT---kTT-------yy-------------ggg----*---o-||----||t--TT------tt----kTT----###-TT
XXXXXXXXXXXXX--XXXXXXXXXXXXXXXXXXXXXXX--XXXXXXXXXX----%%%%%-XXXXXXXXXXXXXXXXXXXXXXXXXXXXXX-XXXXXXXXXXXXXXXXXX-%-||----||XXXXXXXXXXXXXXXXXXXXXXXXXXX-XX
XXXXXXXXXXXXX--XXXXXXXXXXXXXXXXXXXXXXX--XXXXXXXXXX-----|||--XXXXXXXXXXXXXXXXXXXXXXXXXXXXXX-XXXXXXXXXXXXXXXXXX---||----||XXXXXXXXXXXXXXXXXXXXXXXXXXX-XX
