------------------------------------------------------------------------------------------------------------------------------------------------------
------------------------------------------------------------------------------------------------------------------------------------------------------
------------------------------------------------------------------------------------------------------------------------------------------------------
S-----SSSS----------------------------------------SSSSSSS---------------------------------------------------------------------------------------U-----
S-----------------------------------------------------------------------------------------------------------------------------------------------------
S-------------------------------------oo-----------------------------R------------------oo------------------------------------------------------------
S--------------------LSSS----------SSSS-----------QQ----------------------------oo---------------------------------oo----------SSS-SSSS---------------
S-------------------------------------------------------------------------------------------------------------------------------------------------SS--
S----------------------------------------------------------S------------------------------------------------------------------------------------------
S--------------------------------------------------------------------------------SSS--------------------------------------------K------SSSS---SS------
S--------------------2-----#--%-------------------QQ--QQQ--------%%%---------------------S---------------------%%%%--%%%-------SSS-------------------#
S--------------------------#--------------------------------------|---------------------------------------------||----||----------------------------##
S--------------------------##-------------------------------------|---------------------------------------*-----||----||-TT------------------------###
S-------------k-ggg---kk---##-------------------------------------|---gg---------------------------ggg----*---o-||----||-TT-----------------------####
XXXXXXXXXXXXXXXXXXXXXXXXXXXXXX--%%%%--%%X-XX-XX-XXXXXXXXX---%%%%%-|---XXXXXXXXXX-----------XXXXXXXXXXXXXXXXXX-%-||----||XXXXXXXXXX---------XXXXXX-XXXX
XXXXXXXXXXXXXXXXXXXXXXXXXXXXXX---||----|X-XX-XX-XXXXXXXXX----|||--|---XXXXXXXXXX-----------XXXXXXXXXXXXXXXXXX---||----||XXXXXXXXXX---------XXXXXX-XXXX
