------------------------------------------------------------------------------------------------------------------------------------------------------
------------------------------------------------------------------------------------------------------------------------------------------------------
------------------------------------------------------------------------------------------------------------------------------------------------------
--------------------------------------------------------------------------------ooo-------------------------------------------------------------------
--------------------------------------------------?-----------------------------%%%-------------------------------------------------------------------
---------------------------------------------------------------------------------|--------------------------------------------------------------------
------------------SC----------------------------------------------------SSSSS----|---------SSS!--------------------oo------------------US---SSS-------
--------------------------------------------------SS-----------------------------|--------------------------------------------------------------------
---------------------------------------------------------------------------------|-------------------------------------------SSS----------------------
---------------------------------------------------------------------------------|---%%%%--------------------------------------------SS----------SSSSS
--------SU----TT---2SS-----------------T-------------------------------------2---|----||------C-------%%%%%%---%%%%--%%%r------------------S----------
--------------TT-----K---TT------------T---------------SSS-----------------TT---%%%%%%||---------------||||-----||----||%%%%%%------------------------
--------------TT---------TT------------T------------------------------t----TT--T-||||-||---------------||||-----||----|||||||-----TT--------SSS-------
--M-----------TT---------TT-----gg-----T-------ggg----------gg-------gt----TT--T-||||-||-------g-g-----||||---o-||----|||||||-----TT---------------r--
XXXXXXXXXXXXXXXXXXXXXXXXXXXXXXXXXXXXXXXX-XXXXXXXXX----------XXXXXXXXXXXXXXXXXXXX-||||-||%%XXXXXXXXXX%%-||||-%%%-||----|||||||-----XXXXXX-X-X-----XXXXX
XXXXXXXXXXXXXXXXXXXXXXXXXXXXXXXXXXXXXXXX-XXXXXXXXX----------XXXXXXXXXXXXXXXXXXXX-||||-||-|XXXXXXXXXX|--||||--|--||----|||||||-----XXXXXX-X-X-----XXXXX
