------------------------------------------------------------------------------------------------------------------------------------------------------
------------------------------------------------------------------------------------------------------------------------------------------------------
------------------------------------------------------------------------------------------------------------------------------------------------------
----------------------------------------SSSSSSSSSS-oo-------SSSSSSSSSS----------SSSSSSSSSS------------------------------SSS-----SS--------------U-----
----------------------------------------SSSSSSSS--%%%%------SSSS--SSSS--------------------------------------------------------------------------------
----------------------------------------SSSCSSSS---||-------SSSS--SSSS--------------------------------------------------------------------------------
--------------------S-------------------SSSSSSSS---||---------SS---S----SSSSS--------------------------------------oo---US--------%-------------------
---------------------------TT----------------------||--SSS----SS---S------------------------------------------------------------------------------SS--
---------------------------TT----------------------||---------SS---S--------------------------------------------------------SSS---------SSS-----------
------------Q--?-----------XX--------------ggg-----||-------ooSS---SoU-----------------S------------------------------------------------------SS------
---------Q---------S---TT---------------SSSSSSSS---||-------SSSS---SSS-------2--SU-----------------------------%%%%--%%%SSS-------%%%%%--------------#
-----------------------TT--------------TSSSSSSSS---||----------------------TT-------TT---t------------TT--------||----||-----------|||--------------##
-----------------------TT--------------TSSSSSSSS--%||-----------------t----TT--T----TT---t------------TT----TT--||----||-----------|||-------------###
-M----------------K-k--TT------------kkTSSSSSSSS---||-------k--g-g----t----TT--T---kTT--kt---------g--TT-k--TTo-||----||-----------|||------------####
XXXXXXXXXXXXXXXXXXXXXXXXXXXXXXXXXXXXXXXXXXXXXXXXXX-||-------XXXXXXXXXXXXXXXXXXXXXXXXXXXXXX-XXXXXXXXXXXXXXXXXXX%-||----||XXX------X%|||------XXXXX-XXXX
XXXXXXXXXXXXXXXXXXXXXXXXXXXXXXXXXXXXXXXXXXXXXXXXXX-||-------XXXXXXXXXXXXXXXXXXXXXXXXXXXXXX-XXXXXXXXXXXXXXXXXXX--||----||XXX------X-|||------XXXXX-XXXX
