------------------------------------------------------------------------------------------------------------------------------------------------------
------------------------------------------------------------------------------------------------------------------------------------------------------
------------------------------------------------------------------------------------------------------------------------------------------------------
S-----SSSS----------------------oo-----------------oo-------------------------------------------------------------------------------------------------
S------------------------------------g-g----?-----%%%%-----------------------------------------------------------------------------------------------o
S---------------------ooor---------%%%%%-----------||---------g-------------------------oo------------------------------------------------------------
S--------------------%%%%%----------||||-----------||---------SSSSS-----SSSSS---oo---------------------------R----------SS----------------------------
S---------------------|||-----------||||------r----||--SSS-----------------------------------------------r--------------------------------------SSS---
S---------------------|||-----------||||--%%%%%%---||-----------------------------------------------%%%%%%%---------------------------------oo--------
S---------------------|||-----%%%%%-||||---||||----||----------------------------SSS----------------||||||-----------------TT-------------------------
S------------------%%%%%%%%----|||--||||%%-||||ooo-||------------------------2-----------S----------||||||------!-----S----TT---------------SS--------
S-------------------||||||-----|||--|||||--||||--r-||----------------------TT-----------------------||||||--------------t--TT--------TT---------------
S-------------------||||||--o--|||--|||||%%%%%%%%%%||---------TT-----tt----TT--T-----------------B--||||||--------------t--TT--------TT---------------
S------------%%%%---||||||-%%%-|||--|||||-||||||||-||---------TT-----tt----TT--T-----------------b--||||||--oo----------t--TT--------TT---------------
XXXXXXXXXXX---||----||||||--|--|||--|||||-||||||||-||-------XXXXXXXXXXXXXXXXXXXX----------XXXXXXXXXX||||||--%%XXXXXXXXXXXXXXXXXXXXXXXXXXXXXX----------
XXXXXXXXXXX---||----||||||--|--|||--|||||-||||||||-||-------XXXXXXXXXXXXXXXXXXXX----------XXXXXXXXXX||||||---|XXXXXXXXXXXXXXXXXXXXXXXXXXXXXX----------
