------------------------------------------------------------------------------------------------------------------------------------------------------
------------------------------------------------------------------------------------------------------------------------------------------------------
------------------------------------------------------------------------------------------------------------------------------------------------------
------------------------------------------------------------------------------------------------------------------------SSSSSSSSSS--------------U-----
-------------------------------------------------------------------------o----------------------------------------------------------------------------
------------------------------------------------------------------------%%%-------------oo------------------------------------------------------------
------------------Q-------------------------------------------USSS-------|--o---oo--------------------------------------------------------------------
--------------------------------o----ooo---------------------------------|--SSSS------------------oooo----------oooo------------------------------SS--
----------------------------------------------------------------------%--|----------------------------------------------------------------------------
-------------------------------------------------------------------------|-------SS-----------------------------------------------------------SS------
------------------?-------------------%%---------------ooo---S-----TT----|---------------S-------------------TT--------------------------------------#
--------------TT-----------------------|---------------------------TT----|----------------------#------------TT-----------SS------------------------##
--------------TT-----------------------|---------------------------TT----|-----%----------------#------------TT-----------SS-----------------------###
-M------------TT---------ggg---%%%%%%%-|----y-y--------------ggg---TT----|----------------------#---------y--TT---y-------SS----------------------####
XXXXXXXXXXXXXXXXXXXXXXXXXXXXXX--|||||--|XXXXXXXXXX--XXXXXXXXXXXXXXXXXX%%%%%%--------------XXXXXXXXXXXXXXXXXXXXXXXXXXXXXX--XX--XXXXXXXXXXXXXXXXXXX-XXXX
XXXXXXXXXXXXXXXXXXXXXXXXXXXXXX--|||||--|XXXXXXXXXX--XXXXXXXXXXXXXXXXXX|||||---------------XXXXXXXXXXXXXXXXXXXXXXXXXXXXXX--XX--XXXXXXXXXXXXXXXXXXX-XXXX
