------------------------------------------------------------------------------------------------------------------------------------------------------
------------------------------------------------------------------------------------------------------------------------------------------------------
------------------------------------------------------------------------------------------------------------------------------------------------------
---------------------------------------------------oo-----------------------------------------------------------------------------SSSSSSSS------U-----
--------------------------------------------------%%%%------------------------------------------------------------------------------------------------
---------------------------------------------------||---------g---------------------------------------------------------------------------------------
---------------------------------------------------||---------SSSSS--------g----------------------------SSQSSS----------------------------------------
---------------------------------------------------||--SSS-------------%%%%%%-----------------------------------oooo------------------------------SS--
---------------------------------------------------||-------------------||||------TT-----------------------------------------SSS----------------------
---------------------------------------------------||-------------------||||------TT--------------oo------K-----------------------------------SS------
---------QQ--------------------TT------------------||-------------------||||------TT--------------------SSSSSST---------r--------------g##-----------#
-------------------------------TT------------------||-------------------||||------TT-----T-----TT-------------T---------%%%%%%---------###----------##
-------------------------------TT-----------------%||---------TT-----t--||||----T-TT-----T-----TT-------------T---------|||||--------g####---------###
-------------------#-----ggg--gTT-----------y-y----||---------TT-----t--||||----T-TT---k-T--y--TT-------------T---y-----|||||--------#####--------####
XXXXXXXXXXXXX--XXXXXXXXXXXXXXXXXXXXXXX--XXXXXXXXXX-||-------XXXXXXXXXX--||||----XXXXXXXXXXXXXXXXXXXXXXXXXXXXXXXXXXXXXXXX|||||-----XXXXXXXX--XXXXX-XXXX
XXXXXXXXXXXXX--XXXXXXXXXXXXXXXXXXXXXXX--XXXXXXXXXX-||-------XXXXXXXXXX--||||----XXXXXXXXXXXXXXXXXXXXXXXXXXXXXXXXXXXXXXXX|||||-----XXXXXXXX--XXXXX-XXXX
