------------------------------------------------------------------------------------------------------------------------------------------------------
------------------------------------------------------------------------------------------------------------------------------------------------------
------------------------------------------------------------------------------------------------------------------------------------------------------
-------------------------------------------------------------------SSS--------------------------------------------------------------------------------
------------------------------------------------------------------------------------------------------------------------------------------------------
----------------------ooor----------------------------------------------------------------------------------------------------------------------------
---------------------%%%%%-------------------------------Q-Q----CSS-------SS--------y---------------------2-------------------------------------------
----------------------|||---------------------------------------------------------#SSS----------------------------------------------------------------
-----------------%%%--|||-----------------------------------SS--2----------------##------------------------------------y-------------g#---------------
------------------||--|||--------------------------------------2-2--------------###1-------o--------o------------------X------------g##---------------
------------------||%%%%%%%------------------------------Q-Q------2---SS-----SS-###--------------TT-------2-----------XX------------###-------#LSS----
-------------%%%%%||||||||------------K-----------------------------------------###--SSS---------TT------------------XXX-----------####-------#-------
--------------|||-||||||||--o-TTTT----------------------------------------------###--------------TT-----------------XXXX----------#####-------#-------
-M------------|||-||||||||-%%%TTTT-------------y--------------------------------###--------------TT-----y--y-------XXXXX--kkk-----#####-----kk#-------
XXXXXXXXXXX---|||-||||||||--|-XXXXXXXXXXXXXXXXXXXXXXXXXXXXXX---XXXXXXX----------XXXXXX---XXXXXXXXXXXXXXXXXXXXXXXXXXXXXXXXXXXXXXXXXXXXXX--XXXXXXXXXX---
XXXXXXXXXXX---|||-||||||||--|-XXXXXXXXXXXXXXXXXXXXXXXXXXXXXX---XXXXXXX----------XXXXXX---XXXXXXXXXXXXXXXXXXXXXXXXXXXXXXXXXXXXXXXXXXXXXX--XXXXXXXXXX---
