------------------------------------------------------------------------------------------------------------------------------------------------------
------------------------------------------------------------------------------------------------------------------------------------------------------
------------------------------------------------------------------------------------------------------------------------------------------------------
------------------------------SSSSSSSSSS------------------------------------------------------------SSSSSSSSSS----------SSSSSSSSSS--------------------
-----------------------------------------g------------------------------------------------------------------------------------------------------------
----------------------ooor--------------%%------------------------------------------------------------------------------------------------------------
---------------------%%%%%--------------|-------------------------SSoo---------------SSSS--SSS!-----------------------------------%---------SS--------
----------------------|||---------------|----oo-------------------------------------------------------------------------------------------------------
-----------------g----|||--------------S|--------------------------------------g--------------------------------------------------------SSS-----------
-----------------#----|||--------------S|-------------------------------------------------------------------------------------------------------------
----------S-----##--%%%%%%%------------S|----------------tt-%%%%%%-----------S@SQ-------------C--------------T--------------------%%%%%-----SS--------
---------------###--||||||-----#--------|----------------tt--||||--------------------------------------TT----T------------SS-------|||------------#-TT
--------------####--||||||--o--#-#------|----------------tt--||||--------------------------------------TT----T-----B------SS-------|||-----------##-TT
---M---------#####--||||||-%%%-#-#------|------------g-g-tt--||||----------------ggg-----------g-g--g--TT----T-----b------SS-------|||----------###-TT
XXXXXXXXXXXXXXXXXXXX||||||--|-XXXXXXXXXX|----%%%%-XXXXXXXXXX-||||------XXXXXXXXXXXXXX----XXXXXXXXXXXXXXXXXXXXXXXXXXXXXXX--XX--XXXX%|||------XXXXXXX-XX
XXXXXXXXXXXXXXXXXXXX||||||--|-XXXXXXXXXX|-----||--XXXXXXXXXX-||||------XXXXXXXXXXXXXX----XXXXXXXXXXXXXXXXXXXXXXXXXXXXXXX--XX--XXXX-|||------XXXXXXX-XX
