------------------------------------------------------------------------------------------------------------------------------------------------------
------------------------------------------------------------------------------------------------------------------------------------------------------
------------------------------------------------------------------------------------------------------------------------------------------------------
----------------------------------------SSSSSSSSSS------------------------------------------------------------SS-------SSSSSSSSSSS--------------------
----------------------------------------SSSSSSSS--?---------------------------------------------------------------------------------------------------
----------------------------------------SSSCSSSS------------------------------------------------------------------------------------------------------
---------------------LSSS---------------SSSSSSSS-----------------------------------o--o--------------------------------S------------------------------
--------------------------------------------------SS----------------------------------------------oo------------------------------oo------------------
-------------------------------------------------------------------------------g-----------------------------------SSS--------------------------------
-----------------------------------oo------ggg-------------------------------------SSSS---------------------------------------------------------------
---------------------2-----#------o--o--SSSSSSSS---------------------#-------S@S---------------------------------------S-------------------Q--#LSS----
---------------------------#------------SSSSSSSS-------SSS----------##--------------------------#-----TT-------##---------SS------------------#-------
---------------------------##-----------SSSSSSSS------------TT-----###----------%%%-------------#-----TT----TT-##---------SS------------------#-------
-M------------k-ggg---kk---##-----------SSSSSSSS------------TT----####----------||--------------#-----TT-k--TT-##---------SS----------------kk#-------
XXXXXXXXXXXXXXXXXXXXXXXXXXXXXXXXXXXXXXXXXXXXXXXXXX----------XXXXXXXXXX-XXXXXXXXX||--------XXXXXXXXXXXXXXXXXXXX-XX------X--XX--XXXXXXXXXXXXXXXXXXXXX---
XXXXXXXXXXXXXXXXXXXXXXXXXXXXXXXXXXXXXXXXXXXXXXXXXX----------XXXXXXXXXX-XXXXXXXXX||--------XXXXXXXXXXXXXXXXXXXX-XX------X--XX--XXXXXXXXXXXXXXXXXXXXX---
