------------------------------------------------------------------------------------------------------------------------------------------------------
------------------------------------------------------------------------------------------------------------------------------------------------------
------------------------------------------------------------------------------------------------------------------------------------------------------
----------SSSSSSSSSSSSSSSSSSSS----------SSSSSSSSSS------------------------------ooo-----------------SSSSSSSSSS----------SSS-----SS--------------------
--------------------SSSSSSSSSS--------------------------------------------------%%%-------------------------------------------------------------------
--------------------SSSSSSSSSS---------------------------------------------------|--------------------------------------------------------------------
--------------------SSSSSSSSSS-----------oooo---------------------------SSSSS----|---------SSS!-------------------------US----------------------------
---------------------------------------------------------------------------------|--------------------------------------------------------------------
-----------------------------------------SSSS-U----------------------------------|------------------------------------------SSS-----------------------
----------------------------------------oS--SoS-----------------1----------------|---%%%%-------------------------------------------------------------
----------@QQQQ-------SSSSSS?--TT-------SS--SSS----------tt------------------2---|----||------C--------------T----------SSS---------------------------
----------------------SSSSS----TT------------------------tt----------------TT---%%%%%%||---------------TT----T----------------------------------------
-----------------g-#--SSSSS----TT------------------------tt-----------t----TT--T-||||-||---------------TT----T-------------------------------------F--
-M--------------g#-#-------ooogTT---------kk---------g-g-tt-----------t----TT--T-||||-||-------g-g--g--TT----T-k----kkk-----------k----------------#--
XXXXXXXXXXXXXXXXXXXX-XXXXXXXXXXXXXXXXX--XXXXXXXXXXXXXXXXXXXXXXXXXXXXX-XXXXXXXXXX-||||-||%%XXXXXXXXXXXXXXXXXXXXXXXXXXXXXXXXX------XXX---XXXXXXXXXXXXXXX
XXXXXXXXXXXXXXXXXXXX-XXXXXXXXXXXXXXXXX--XXXXXXXXXXXXXXXXXXXXXXXXXXXXX-XXXXXXXXXX-||||-||-|XXXXXXXXXXXXXXXXXXXXXXXXXXXXXXXXX------XXX---XXXXXXXXXXXXXXX
