------------------------------------------------------------------------------------------------------------------------------------------------------
------------------------------------------------------------------------------------------------------------------------------------------------------
------------------------------------------------------------------------------------------------------------------------------------------------------
----------------------------------------------------------------------SSSSSSSSSS----------------------------------------------------------------------
----------------------------------------------------------------------------SSSS----------------------------------------------------------------------
---------------------------------------------------------------------R---g--SSSS------------oo--------------------------------------------------------
------------------------------------------------------------------------SS--------------------------------2---------------SSC---------------SS--------
------------------------------------------------------------------------SS----------------------------------------------------------------------------
------------------------------------------------------------------------SS-------------------------%---------------------------------g#---------------
------------------------------------------------------------------------SC--g-g---o-----------------o---------------------SSS-------g##---------------
-----SSS-----------%--------TT-TT------------------------tt------%%%----SS--SSSS-------TT-SS--------------2-------------------------###-----SS--------
----------------------------TT-TT------------------------tt-------|--------------------TT------------------------------------------####-----------#-TT
----------------------------TT-TT------------------------tt-------|--------------------TT----%%%%---------------------------------#####----------##-TT
-------------%%%%-------ggg-TTgTT--------------ggg---g-g-tt-------|--------------------TT-----||--------y--y---k----kkk----------######---------###-TT
XXXXXXXXXXX---||----XXXXXXXXXXXXXXXXXX---XXXXXXXXXXXXXXXXXXX%%%%%-|---XXXXXXXXXXXXXXXXXXXX----||----XXXXXXXXXXXXXXXXXXXXX----XXXXXXXXXX--XXXXXXXXXX-XX
XXXXXXXXXXX---||----XXXXXXXXXXXXXXXXXX---XXXXXXXXXXXXXXXXXXX-|||--|---XXXXXXXXXXXXXXXXXXXX----||----XXXXXXXXXXXXXXXXXXXXX----XXXXXXXXXX--XXXXXXXXXX-XX
