------------------------------------------------------------------------------------------------------------------------------------------------------
------------------------------------------------------------------------------------------------------------------------------------------------------
------------------------------------------------------------------------------------------------------------------------------------------------------
----------SSSSSSSSSS--------------------SSSSSSSSSS------------------------------------------------------------------------------------------SSSSSSSSSS
------------------------------------------------------------------------------------------------------------------------------------------------------
-------------------------------------------------------oooo-------------------------------------------------------------------------------------------
-----------------------------------------oooo----------%%%%-----------------SSSS-----1----SSS------%-----------------------------------US-------------
--------------------------------------------------SSSS--||--------------------------------------------------------------------------------------------
-----------------------------------------SSSS-U---------||--------------------------------------------------------------------------------------------
----------------------------------------oS--SoS---------||-------------------K-------------------------------------------------------SS---------------
-----SSS------------SS------------------SS--SSS---------||-----------T-----SSSSS---QQQQ-----%%%-----------------!-----S--------------------S--TT------
---------------------K---TT-----------K---------------U-||-----------TT----------------------|------------------------------------------------TT------
-------------------------TT---TTTT----------------------||-----------TT----------------------|------------*-----------------------TT----------TT------
-------------------------TT---TTTT--------kk------------||----ggg----TT-------------yy-------|------gg----*--------------k----ggg-TT----------TT------
XXXXXXXXXXX--XX--X--XXXXXXXXXXXXXXXXXXXXXXXXXXXXXX----%%%%%-XXXXXXXXXXXXXXXXXXXXXXXXXXXXXX---|------XXXXXXXXX-XXXXXXXXXXXXXXXXXXXXXXXXXX-X-XXXXX--XXXX
XXXXXXXXXXX--XX--X--XXXXXXXXXXXXXXXXXXXXXXXXXXXXXX-----|||--XXXXXXXXXXXXXXXXXXXXXXXXXXXXXX---|------XXXXXXXXX-XXXXXXXXXXXXXXXXXXXXXXXXXX-X-XXXXX--XXXX
