------------------------------------------------------------------------------------------------------------------------------------------------------
------------------------------------------------------------------------------------------------------------------------------------------------------
------------------------------------------------------------------------------------------------------------------------------------------------------
------------------------------------------------------------------------------------------------------------------------------------------------------
--------------------------------------------?---------------------------------------------------------------------------------------------------------
---------------------------------------------------------------------R--------------------------------------------------------------------------------
---------------------LSSS--------------------------------Q-Q-------------------------------------------------------oo-------------SS------------------
----------------------------------------------r---------------------------------------------------oo-------------------------------------------y------
------------------------------------------%%%%%%----------------------------------TT-----------------------------------------SSS-------------#SS--o---
-----------------------------------oo------||||-----------------------------------TT--------------------------------------------------------##--------
--------SU------!----2-----#------o--o--%%-||||ooo-------Q-Q-----%%%--------------TT---------------------------%%%%--%%%r---------SS--------##--SC----
---------------------------#------------|--||||--r----------------|---------------TT-----T------#-----TT--------||----||%%%%%%----K---#----B##--------
---------------------------##-----------|%%%%%%%%%----------------|-------------T-TT-----T------#-----TT----TT--||----|||||||---------#----b##---SSS--
--M-------------------kk---##-----------|-||||||||----------------|---gg--------T-TT---k-T------#-----TT-k--TTo-||----|||||||---------#----B##--------
XXXXXXXXXXXXXXXXXXXXXXXXXXXXXXXXXXXXXXXX|-||||||||XXXXXXXXXX%%%%%-|---XXXXXXXXXXXXXXXXXXXXXXXXXXXXXXXXXXXXXXXX%-||----|||||||-----XXXXXXXXXXXX------XX
XXXXXXXXXXXXXXXXXXXXXXXXXXXXXXXXXXXXXXXX|-||||||||XXXXXXXXXX-|||--|---XXXXXXXXXXXXXXXXXXXXXXXXXXXXXXXXXXXXXXXX--||----|||||||-----XXXXXXXXXXXX------XX
