------------------------------------------------------------------------------------------------------------------------------------------------------
------------------------------------------------------------------------------------------------------------------------------------------------------
------------------------------------------------------------------------------------------------------------------------------------------------------
----------------------------------------SSSSSSSSSSSSSSSSS---------------------------------------------------------------------------------------------
------------------------------------------------------------------------------------------------------------------------------------------------------
----------------------ooor------------------------------------------------------K---------------------oo----------------------------------------------
------------------SC-%%%%%---------------oooo-----QQ-----------------------1----SS----1---SSS------%------------------USSS----------------------------
----------------------|||---------------------------------------------------------------------------------------------------------oo------------------
----------------------|||----------------SSSS-U------------S------------------------------------------------------------------------------------------
----------------------|||---------------oS--SoS-----------------1----------ggg--------------------------------------E------TT-------------------------
--------------TT---2%%%%%%%-------------SS--SSS---QQ--QQQ-------------#########-SS----------%%%--------------------TT------TT--------------Q----------
--------------TT----||||||-------------T--------------------------------------#-------TT-----|---------------------TT--tt--TT-------------------------
--------------TT----||||||--o----------T--------------------------------------#-------TT-----|--------------tt-----TT--tt--TT----------------------F--
-M------------TT----||||||-%%%-------kkT--kk----------------------------------#-------TT-----|--------ggg---tt--g--TT--tt--TT----------------------#--
XXXXXXXXXXXXXXXXXXXX||||||--|-XXXXXXXXXXXXXXXXXXXXXXXXXXX---XXXXXXXXX---------X-XXXXXXXXXX---|------XXXXXXXXXXXXXXXXXXXXXXXXXXXXXXXXXXXXXXXXXXXXXXXXXX
XXXXXXXXXXXXXXXXXXXX||||||--|-XXXXXXXXXXXXXXXXXXXXXXXXXXX---XXXXXXXXX---------X-XXXXXXXXXX---|------XXXXXXXXXXXXXXXXXXXXXXXXXXXXXXXXXXXXXXXXXXXXXXXXXX
