------------------------------------------------------------------------------------------------------------------------------------------------------
------------------------------------------------------------------------------------------------------------------------------------------------------
------------------------------------------------------------------------------------------------------------------------------------------------------
------------------------------SSSSSSSSSS--------------------------------------------------------------------------------------------------------------
------------------------------------------------------------------------------------------------------------------------------------------------------
----------------------------------------ooooo----------oooo---------------------------------oo--------------------------------------------------------
------------------SC-LSSS------------------------------%%%%--------------------------1-----------------------------oo-----oo---%%%SS--------SSS-------
------------------------------------------------SS------||----------------------------------------------------------------SS----||--------------------
---------------------------------------S-SSSS-----------||-----------------------------------------%----------------------------||--------------------
---------------------------------------S----------SSS---||---------------1------------------------------------------------------||---------------SSSSS
--------------TT---2-2-----#-----------S----------------||------------T------------QQQQ---SS-------------------%%%%--%%%-----SS-||SS------------------
--------------TT-----------#---#----------------------U-||------------T----TT-------------------------TT--------||----||--------||K---#----B----------
--------------TT-----------##--#-#----------%%%%%-------||------------T----TT----------------%%%%-----TT----TT--||----||--------||----#----bSSS-------
-M------------TT------kk---##--#-#-----------|||--------||--gg-------gT---kTT-------yy--------||------TT-k--TTo-||----||--------||----#----B-------r--
XXXXXXXXXXXXXXXXXXXXXXXXXXXXXXXXXXXXXXXX%%---|||------%%%%%-XXXXXXXXXXXXXXXXXXXXXXXXXXXXXX----||----XXXXXXXXXX%-||----||%%-----%%%XXXXXXXXXX-----XXXXX
XXXXXXXXXXXXXXXXXXXXXXXXXXXXXXXXXXXXXXXX|----|||-------|||--XXXXXXXXXXXXXXXXXXXXXXXXXXXXXX----||----XXXXXXXXXX--||----|||-------||XXXXXXXXXX-----XXXXX
