------------------------------------------------------------------------------------------------------------------------------------------------------
------------------------------------------------------------------------------------------------------------------------------------------------------
------------------------------------------------------------------------------------------------------------------------------------------------------
S-----SSSS-------------oo---------------------------------------------------------------------------SSSSSSSSSS----------------------------------------
S-----------------------------------------------------------------------------------------------------------------------------------------------------
S-------------------------------------------------------------------------------------------oo--------------------------------------------------------
S---------------------SSSS------------------------------------------------SSCSS------1------------------------------------SSC----------US-------------
S----------------------------------------------------------------------------------------------------------------SSS---------------------------y------
S----------------g---------------------------------------TT----------------------------------------%-----------------------------------------#SS--o---
S----------------#---------------------------------TT----TT-----1---------------------------------------------------------SSS--------SS-----##--------
S---------S-----##--------%%%%---------------------TT----XX-------------QQQQ--QQ---QQQQ---S------------------T-----------------------------S##--SC----
S--------------###---------|||--------ttT-----TT---TT--------------------------------------------------TT----T------------------------------##--------
S-------------####---------|||--------ttT-----TT---TT----------------------------------------%%%%------TT----T--------------------TT--------##---SSS--
S--M---------#####---------|||--------ttT-----TT---TT-------------------------------yy--------||----g--TT----T-------------------#TT--------##--------
XXXXXXXXXXXXXXXXXXXX%%%----|||XXXXXXXXXXXXXX--XXXXXXXXXXXXXXXXXXXXXXX-XXXXXXXXXXXXXXXXXXXX----||----XXXXXXXXXX%%%%----%%X----XXXXXXXXXXX-X-XXX------XX
XXXXXXXXXXXXXXXXXXXX||-----|||XXXXXXXXXXXXXX--XXXXXXXXXXXXXXXXXXXXXXX-XXXXXXXXXXXXXXXXXXXX----||----XXXXXXXXXX|||------|X----XXXXXXXXXXX-X-XXX------XX
