------------------------------------------------------------------------------------------------------------------------------------------------------
------------------------------------------------------------------------------------------------------------------------------------------------------
------------------------------------------------------------------------------------------------------------------------------------------------------
S-----SSSS--------------------------------------------------------------------------------------------------------------------------------------------
S-----------------------------------------------------------------------------------------------------------------------------------------------------
S---------------------------------------------------------------------------------------oo-------------------------k----------------------------------
S-----------------Q-S-----------------------------Q-----------------------------oo---------------------------RS---SSSSSS------------------------------
S--------------------------TT----------------------------------------------------------------------------r----------------------oo--------------------
S--------------------------TT-----------------------------------------------------------------------%%%%%%%-------------------------------------------
S--------------------------XX----------------------------------------------------SS---------------oo||||||--------------------------------------------
S-----------------?----TT----------------TT---SU--Q------------------T-------------------S----------||||||-------------------TT-----------------------
S-------------TT-------TT--------------T-TT--------------------------T-------------------------TT---||||||-------------------TT--------------------#--
S-------------TT-------TT--------------T-TT--------------------------T-------------------------TT---||||||----TT-------------TT----------------K---#--
S-------------TT----k--TT------------kkT-TT------k---gg----k--ggg----Tgg--------------------y--TT---||||||--ooTT---------y---TT---k----------------#--
XXXXXXXXXXXXXXXXXXXXXXXXXXXXXXXXXXXXXXXXXXXXXXXXXXXXXXXXXXXXXXXXXXXXXXXXXXXXXXXX----------XXXXXXXXXX||||||--%%XXXXXXXX--XXXXXXXXXXXX---XXXXXXXXXX--XXX
XXXXXXXXXXXXXXXXXXXXXXXXXXXXXXXXXXXXXXXXXXXXXXXXXXXXXXXXXXXXXXXXXXXXXXXXXXXXXXXX----------XXXXXXXXXX||||||---|XXXXXXXX--XXXXXXXXXXXX---XXXXXXXXXX--XXX
