------------------------------------------------------------------------------------------------------------------------------------------------------
------------------------------------------------------------------------------------------------------------------------------------------------------
------------------------------------------------------------------------------------------------------------------------------------------------------
----------SSSSSSSSSSSSSSSSSSSS----------SSSSSSSSSS----------------------------------------SSSSSSSSSS------------------------------SSSSSSSS------------
----------------------------------------SSSSSSSS------------------------------------------------------------------------------------------------------
----------------------------------------SSSCSSSS---------------------R------------------------------oo------------------------------------------------
----------------------------------------SSSSSSSS----------------------------------------------------%%%---------------US--------------------SS--------
--------------------------------o----ooo------------------------------------------------------------||--o----R----------------------------------------
---------------------------------------------------------TT--------------------g--TT----------------||-%%%--------------------SSS---------------------
-----------------------------C-------------ggg-----TT----TT-----------------------TT----------------||--|-----------E---------------------------------
----------@QQQQ--------#-#------------%%SSSSSSSS---TT----XX------%%%---------S@S--TT----------------||--|----------TT---%--------------g##--SS--------
---------------------#-#-#-#-----------|SSSSSSSS---TT-------------|---------------TT-----T----------||-o|----------TT--t---------------###--------#-TT
-----------------g-#-#-#-#-#-----------|SSSSSSSS---TT-------------|-------------T-TT-----T----------||%%%%%--------TT--t-------------g####-------##-TT
---M------------g#-#-#-#-#-#-E-%%%%%%%-|SSSSSSSS---TT-------------|-------------T-TT---k-T------g-g-||-|||------g--TT--t---------r---#####------###-TT
XXXXXXXXXXXXXXXXXXXXXXXXXXXXXX--|||||--|XXXXXXXXXXXXXXXXXXXX%%%%%-|----XXXXXXXXXXXXXXXXXXXXXXXXXXXXX||-|||----XXXXXXXXXX----XXXXXXXXXXXXXX--XXXXXXX-XX
XXXXXXXXXXXXXXXXXXXXXXXXXXXXXX--|||||--|XXXXXXXXXXXXXXXXXXXX-|||--|----XXXXXXXXXXXXXXXXXXXXXXXXXXXXX||-|||----XXXXXXXXXX----XXXXXXXXXXXXXX--XXXXXXX-XX
