------------------------------------------------------------------------------------------------------------------------------------------------------
------------------------------------------------------------------------------------------------------------------------------------------------------
------------------------------------------------------------------------------------------------------------------------------------------------------
--------------------SSSSSSSSSS--------------------------------------------------SSSSSSSSSS------------------------------SSSSSSSSSSSSSSSSSSSS----U-----
------------------------------------------------------------------------------------------------------------------------------------------------------
------------------------------------------------------------------------------------------------------------------------------------------------------
------------------SC------------------------------------------------------SS---------------SSS!-------------------------------------------------------
----------------------------------------------------------------------------------------------------------------oooo------------------------------SS--
---------------------------------------------------------------------o--------------------------------------------------------------------------------
-----------------------------C-----------------------------------y---------------------S------------------------------------------------------SS------
--------------TT---2---#-#------QQQQ-----TT---SU---------tt------##---SS-----SS-SU------------C---------------T--------------------------------------#
--------------TT-----#-#-#-#---------K-B-TT--------------tt-----###-----------------TT---t------------TT------T-----------SS--------------TT--------##
--------------TT-----#-#-#-#-----------b-TT--------------tt----####-----------------TT---t------------TT----TTT-----------SS-------tt-----TT-------###
-M------------TT-----#-#-#-#-E---------b-TT------k---g-g-tt---#####----------------kTT--kt-----g-g----TT-k--TTT---y-------SS-------tt----kTT------####
XXXXXXXXXXXXXXXXXXXXXXXXXXXXXXXXXXXXXXXXXXXXXXXXXXXXXXXXXXXXXXXXXXX-------------XXXXXXXXXXXXXXXXXXXXXXXXXXXXXXXXXXXXXXXX--XX--XXXXXXXXXXXXXXXXXXX-XXXX
XXXXXXXXXXXXXXXXXXXXXXXXXXXXXXXXXXXXXXXXXXXXXXXXXXXXXXXXXXXXXXXXXXX-------------XXXXXXXXXXXXXXXXXXXXXXXXXXXXXXXXXXXXXXXX--XX--XXXXXXXXXXXXXXXXXXX-XXXX
