------------------------------------------------------------------------------------------------------------------------------------------------------
------------------------------------------------------------------------------------------------------------------------------------------------------
------------------------------------------------------------------------------------------------------------------------------------------------------
------------------------------SSSSSSSSSS--------------------------------------------------SSSSSSSSSS----------SSSSSSSSSS------------------------------
------------------------------------------------------------------------------------------------------------------------------------------------------
----------------------ooor-----------------------------oooo-----------------------------oo------------------------------------------------------------
---------------------%%%%%-----------------------------%%%%---------------------oo----------------------SSQSSS------------SSC-------------------------
----------------------|||-------------------------------||--------------------------------------------------------------------------------------------
----------------------|||--------------S----------------||--------------------------------------------------------------------------------------------
----------------------|||--------------S----------SSS---||-----------------------SS-----------------------K---------------SSS-------------------------
--------------------%%%%%%%------------S------tt--------||-------------------------------S--------------SSSSSST---------------------------------------
-----------------K--||||||-----#--------------tt------U-||--------------------------------t-------------------T------------------------------------#--
------------B-------||||||--o--#-#------------tt--------||--------------------------------t-------------------T----TT--------------------------K---#--
-M----------b-------||||||-%%%-#-#-------g----tt--------||--gg-------g--------------------t-------------------T--g-TT------------#k----------------#--
XXXXXXXXXXXXXXXXXXXX||||||--|-XXXXXXXXXXXXXXXXXXXX----%%%%%-XXXXXXXXXXX----XXXXX----------XXXXXXXXXXXXXXXXXXXXXXXXXXXXXXX----XXXXXXX---XXXXXXXXXX--XXX
XXXXXXXXXXXXXXXXXXXX||||||--|-XXXXXXXXXXXXXXXXXXXX-----|||--XXXXXXXXXXX----XXXXX----------XXXXXXXXXXXXXXXXXXXXXXXXXXXXXXX----XXXXXXX---XXXXXXXXXX--XXX
