------------------------------------------------------------------------------------------------------------------------------------------------------
------------------------------------------------------------------------------------------------------------------------------------------------------
------------------------------------------------------------------------------------------------------------------------------------------------------
S-----SSSS--------------------SSSSSSSSSSSSSSSSSSSS--------------------------------------------------SSSSSSSSSS----------------------------------------
S-----------------------------------------------------------------------------------------------------------------------------------------------------
S---------------------ooor-------------------------------------------R--------------------------------------------------------------------------------
S--------------------%%%%%---------------oooo----------------------------------------SSSS--SSS!----------------------------------------US----------SSS
S---------------------|||-----------------------------------------------------------------------------------------------------------------------------
S---------------------|||--------------S-SSSS-U----------TT--------------------g---------------------------------------------SSS----------------------
S---------------------|||--------------SoS--SoS----TT----TT--------------------------------------------------------------------------SS---------------
S---------------!---%%%%%%%------------SSS--SSS----TT----XX------%%%---------S@SQ-------------C------------TT---!-----S-r------------------S------#---
S-------------------||||||-----#-------------------TT-------------|-------------------------------------#--TT-----------%%%%%%--------------------#---
S-------------------||||||--o--#-#-----------------TT-------------|------------------------------------##--TT-----------|||||-----TT--------------#---
S-------------------||||||-%%%-#-#--------kk-------TT-------------|--------------ggg-----------g-g--kk-##--TT-----------|||||-----TT---------ggg--#---
XXXXXXXXXXXXXXXXXXXX||||||--|-XXXXXXXXXXXXXXXXXXXXXXXXXXXXXX%%%%%-|----XXXXXXXXXXXXXX----XXXXXXXXXXXXXXXX--XX-XXXXXXXXXX|||||-----XXXXXX-X-XXXXXXXXXXX
XXXXXXXXXXXXXXXXXXXX||||||--|-XXXXXXXXXXXXXXXXXXXXXXXXXXXXXX-|||--|----XXXXXXXXXXXXXX----XXXXXXXXXXXXXXXX--XX-XXXXXXXXXX|||||-----XXXXXX-X-XXXXXXXXXXX
