------------------------------------------------------------------------------------------------------------------------------------------------------
------------------------------------------------------------------------------------------------------------------------------------------------------
------------------------------------------------------------------------------------------------------------------------------------------------------
--------------------------------oo--------------------------------------------------------------------------------------------------------------------
---------------------------------------g-g------------------------------------------------------------------------------------------------------------
-----------------------------------%%%%%%%------------------------------------------------------------------------------------------------------------
--------------------S---------------|||||----------------------------------g---------------------------------R-----------------SSSSS--------SSS-------
---------------------------TT-------|||||----oo------------------------%%%%%%----------------------------r--------------------------------------------
---------------------------TT-------|||||-------------------------------||||------------------------%%%%%%%-------------------------------------------
---------------------------XX-%%%%%-|||||-----------------------1-------||||------o------------oooo-||||||----------------------K----------------SSSSS
-----------------------TT------|||--|||||--------------ooo--------------||||-----------TT-----------||||||---------------------SSSSS------------------
-----------------------TT------|||--|||||-------------------------------||||-----------TT-----------||||||------------------------K---#----B----------
-----------------------TT------|||--|||||-------------------------------||||-----------TT-----------||||||---------B-----TT-----------#----bSSS-------
----------k---ggg---k--TT------|||--|||||-------------------------------||||-----------TT-----------||||||--oo-----b-----TT-----------#----B-------r--
XXXXXXXXXXXXXXXXXXXXXXXXXXXXXX-|||--|||||----%%%%---XXXXXXXXXXXXXXXXX---||||----XXXXXXXXXX%%%%%%%-%%||||||--%%XXXXXXXXXXXXXXXXXXXXXXXXXXXXXX-----XXXXX
XXXXXXXXXXXXXXXXXXXXXXXXXXXXXX-|||--|||||-----||----XXXXXXXXXXXXXXXXX---||||----XXXXXXXXXX||||||---|||||||---|XXXXXXXXXXXXXXXXXXXXXXXXXXXXXX-----XXXXX
