------------------------------------------------------------------------------------------------------------------------------------------------------
------------------------------------------------------------------------------------------------------------------------------------------------------
------------------------------------------------------------------------------------------------------------------------------------------------------
------------------------------------------------------------------------------------------SSSSSSSSSS----------SS-------S------------------------------
-------------------------------------------------------------------------o----------------------------------------------------------------------------
----------------------------------------%%-------------oooo----------R--%%%---------------------------------------------------------------------------
--------------------USS-----------------|--------------%%%%--------------|--o------o--o--------------------------------SSS--------SS---------QQQQ-----
----------------------------------------|----oo---------||---------------|--SSSS--------------------oo------------------------------------------------
----------------------------------------|---------------||------------%--|-----------------------------------------SSS--------------------------------
----------------------------------------|---------SSS---||---------------|---------SSSS------------------------------------TT------------------y------
-----SSS--Q----------------------------T|---------------||-------%%%-----|-----------------------------------T---------S---TT-----SS--------Q?SSQQQ---
---------------------B-----------------T|-------------U-||--------|------|-----------------------------------T-##-------t--TT-----K---#----B----------
---------------------b-------B---------T|---------------||--------|------|-----%%%%--------------------------T-##-------t--TT---------#----b----------
-------------------#-B-------b--gg-----T|---------------||--------|------|------||--------------g-g-------y--T-##-------t--TT---------#----B----------
XXXXXXXXXXXXX--XXXXXXXXXXXXXXXXXXXXXXXXX|----%%%%-----%%%%%-%%%%%-|---%%%%%%----||--------XXXXXXXXXXXXXXXXXXXX-XX------XXXXXXXXXXXXXXXXXXXXXXX--XXXXXX
XXXXXXXXXXXXX--XXXXXXXXXXXXXXXXXXXXXXXXX|-----||-------|||---|||--|---|||||-----||--------XXXXXXXXXXXXXXXXXXXX-XX------XXXXXXXXXXXXXXXXXXXXXXX--XXXXXX
