------------------------------------------------------------------------------------------------------------------------------------------------------
------------------------------------------------------------------------------------------------------------------------------------------------------
------------------------------------------------------------------------------------------------------------------------------------------------------
------------------------------------------------------------------------------------------------------------------------SSS-----SSSSSSSSSSSS----U-----
------------------------------------------------------------------------------------------------------------------------------------------------------
----------------------ooor----------------------------------------------------------------------------------------------------------------------------
---------------------%%%%%------------------------------------------------SSCSS------SSSS-------------------------------US----------------------------
----------------------|||-------------------------------------------------------------------------oo----------------------------------------------SS--
----------------------|||--------------------------------B------------------------------------------------------------------SSS-----------------------
----------------------|||--------------------------------b------------------------------------------------------------------------------------SS------
-------------------%%%%%%%%------------T---------------SS#CS---------#--QQQQ--QQQ---------------------------------------SSS--------------------------#
--------------------||||||-------------T----------------------------##--------------------------#-----------g--#--------------------------TT--------##
--------------------||||||--o----------T-------------------KTT-----###--------------------------#-----------TT-#-------------------tt-----TT-------###
-M-----------%%%%---||||||-%%%--gg-----T----y-y-------------TT----####-----------ggg------------#-----------TT-#----ggg------------tt----kTT------####
XXXXXXXXXXX---||----||||||--|-XXXXXXXXXXXXXXXXXXXXXXXXXXXXXXXXXXXXXXXXXXXXXXXXXXXXXXX----XXXXXXXXXXX--XXXXXXXX-XXXXXXXXXXXX------XXXXXXXXXXXXXXXX-XXXX
XXXXXXXXXXX---||----||||||--|-XXXXXXXXXXXXXXXXXXXXXXXXXXXXXXXXXXXXXXXXXXXXXXXXXXXXXXX----XXXXXXXXXXX--XXXXXXXX-XXXXXXXXXXXX------XXXXXXXXXXXXXXXX-XXXX
