------------------------------------------------------------------------------------------------------------------------------------------------------
------------------------------------------------------------------------------------------------------------------------------------------------------
------------------------------------------------------------------------------------------------------------------------------------------------------
----------SSSSSSSSSS----------------------------------------------------------------------SSSSSSSSSS--------------------------------------------------
------------------------------------------------------------------------------------------------------------------------------------------------------
----------------------------------------------------------------------------------------------------oo------------------------------------------k-----
-------------------------------------------------------------------------------------SSSS-----------%%%----------------------------------------SQS--SQ
----------------------------------------------------------------------------------------------------||--o----R---SSS------------oo--------------------
----------------------------------------------------------------------o-----------------------------||-%%%---------------------------g#---------------
----------------------------------------------------------------------------------------------------||--|---------------------------g##---------------
---------Q------------------TT--QQQQ--------------------------------------------Q-------------------||--|--------------------TT-----###--------SQS--S?
----------------------------TT-------K-B------------K----------------T--------#---------------------||-o|--------------------TT----####---------------
----------------------------TT---------b---------------------B-------T-------##---------------------||%%%%%------------------TT---#####---------------
-M----------------------ggg-TT---------b----y-y------------g-b-------T-----------ggg------------g-g-||-|||---------------y---TT---#####------k------gg
XXXXXXXXXXX--XX--X--XXXXXXXXXXXXXXXXXXXXXXXXXXXXXXXXXXXXXXXXXXXXXX--XXXXXXXXXXXXXXXXX----XXXXXXXXXXX||-|||----%%%%----%%XXXXXXXXXXXXXXX--XXXXXXXXXXXXX
XXXXXXXXXXX--XX--X--XXXXXXXXXXXXXXXXXXXXXXXXXXXXXXXXXXXXXXXXXXXXXX--XXXXXXXXXXXXXXXXX----XXXXXXXXXXX||-|||----|||------|XXXXXXXXXXXXXXX--XXXXXXXXXXXXX
