------------------------------------------------------------------------------------------------------------------------------------------------------
------------------------------------------------------------------------------------------------------------------------------------------------------
------------------------------------------------------------------------------------------------------------------------------------------------------
--------------------------------oo----------------SSSSSSS-------------------------------------------SSSSSSSSSSSS-------S------------------------------
---------------------------------------g-------------------------------------------------------------------------------------------------------------o
-----------------------------------%%%%%--------------------------------------------------------------------------------------------------------------
--------------------S---------------||||----------QQ--------------------------------y----------------------------------S------------------------------
---------------------------TT-------||||------------------------------------------#SSS----------------------------------------------------------SSS---
---------------------------TT-------||||-------------------S---------------------##--------------------------------SSS----------------------oo--------
---------------------------XX-%%%%%-||||----------------------------------------###1------------------------------------------------------------------
-------------------%---TT------|||--||||----------QQ--QQQ-----------------------###--------------------------T---------S--------------------SS--------
-----------------------TT------|||--||||----------------------------------------###--SSS---------------TT----T-##-------------------------------------
-----------------------TT------|||--||||----------------------------------------###--------------B-----TT----T-##-------------------------------------
-M-----------%%%%---k--TT------|||--||||-------y-------------y--------gg--------###--------------b--g--TT----T-##---------kkk-----k-------------------
XXXXXXXXXXX---||----XXXXXXXXXX-|||--||||XXXXXXXXXXXXXXXXX---XXXXXXXXXXXXXXXXXXXXXXXXXX---XXXXXXXXXXXXXXXXXXXXX-XX------XXXXXXXXXXXXX---XXXXX----------
XXXXXXXXXXX---||----XXXXXXXXXX-|||--||||XXXXXXXXXXXXXXXXX---XXXXXXXXXXXXXXXXXXXXXXXXXX---XXXXXXXXXXXXXXXXXXXXX-XX------XXXXXXXXXXXXX---XXXXX----------
