------------------------------------------------------------------------------------------------------------------------------------------------------
------------------------------------------------------------------------------------------------------------------------------------------------------
------------------------------------------------------------------------------------------------------------------------------------------------------
--------------------------------oo----------------SSSSSSSSSS------------------------------------------------------------------------------------------
-------------------------------------g-g--------------SS--SS------------------------------------------------------------------------------------------
-----------------------------------%%%%%--------------SS--SS----------------------------oo------------------------------------------------------------
------------------------------------||||------------SS---------------------g----oo---------SSS!-----------------------US-----------------##-----------
------------------------------------||||------------SS-----------------%%%%%%-----------------------oo-----------------------------------##-----------
-----------------g------------------||||------------SS------------------||||--------------------------------------------------SSS------####-----------
-----------------#------------%%%%%-||||------------SS----oo------------||||-----SS---------------------------------E------------------####-----------
----------S-----##-------------|||--||||-TT---SU----SSSS--SS---------T--||||-------------S----C--------------T-----TT---%------------######-----------
---------------###-------------|||--||||-TT-----------SS-------------T--||||---------------------------------T-----TT--t-------------######-----------
--------------####-------------|||--||||-TT-----------SS-------------T--||||---------------------------------T-----TT--t-------------######--------F--
-M-----------#####-------ggg---|||--||||-TT------k------------ggg----T--||||-------------------g-g--------y--T--g--TT--t---------r---######--------#--
XXXXXXXXXXXXXXXXXXXXXXXXXXXXXX-|||--||||XXXXXXXXXXXXXXXXXXXXXXXXXXXXXX--||||--------------XXXXXXXXXXXXXXXXXXXXXXXXXXXXXX----XXXXXXXXXXXXXXXXXXXXXXXXXX
XXXXXXXXXXXXXXXXXXXXXXXXXXXXXX-|||--||||XXXXXXXXXXXXXXXXXXXXXXXXXXXXXX--||||--------------XXXXXXXXXXXXXXXXXXXXXXXXXXXXXX----XXXXXXXXXXXXXXXXXXXXXXXXXX
