------------------------------------------------------------------------------------------------------------------------------------------------------
------------------------------------------------------------------------------------------------------------------------------------------------------
------------------------------------------------------------------------------------------------------------------------------------------------------
----------SSSSSSSSSS----------------------------------------------------------------------------------------------------------------------------------
------------------------------------------------------------------------------------------------------------------------------------------------------
---------------------------------------------------------------------R--------------------------------------------------------------------------------
---------------------------------------------------------------------------g-------USS--------------------------------------------!S------------------
-----------------------------------------------------------------------%%%%%%-----------------------------------oooo----------------------------------
------------------------------------------------------------------------||||-------------------------------------------------SSS----------------------
------------------------------------------------------------------------||||----------------------oo--------------------------------------------------
----------------------------TT-----------TT---SU-----------------%%%----||||------#-------------------%%%%%%--T---------r---------S------#------------
----------------------------TT-----------TT---------K-------------|-----||||------#------------TT------||||---T---------%%%%%%----------##------------
----------------------------TT-----------TT-----------------------|-----||||------##-----------TT------||||---T---------|||||----------###---------F--
-M----------------------ggg-TT----k-k----TT------k---------g------|-----||||------##--gg----y--TT------||||---T---y-----|||||---------####---------#--
XXXXXXXXXXX--XX--X--XXXXXXXXXXXXXXXXXXX-XXXXXXXXXXXXXXXXXXXX%%%%%-|-----||||------XXXXXXXXXXXXXXXXXX%%-||||-%%XXXXXXXXXX|||||-----XXXXXXXXXXXXXXXXXXXX
XXXXXXXXXXX--XX--X--XXXXXXXXXXXXXXXXXXX-XXXXXXXXXXXXXXXXXXXX-|||--|-----||||------XXXXXXXXXXXXXXXXXX|--||||--|XXXXXXXXXX|||||-----XXXXXXXXXXXXXXXXXXXX
