------------------------------------------------------------------------------------------------------------------------------------------------------
------------------------------------------------------------------------------------------------------------------------------------------------------
------------------------------------------------------------------------------------------------------------------------------------------------------
----------SSSSSSSSSS------------oo------SSSSSSSSSS----------------------------------------------------------------------------------------------------
---------------------------------------g--------------------------------------------------------------------------------------------------------------
-----------------------------------%%%%%----------------------------------------------------oo--------------------------------------------------------
------------------------------------||||-oooo-----Q---------------SSoo----SS---------SSSS--------------------R--------------------%-------------------
------------------------------------||||-----------------------------------------------------------------r--------------------------------------------
------------------------------------||||-SSSS-U----------------------------------------------------%%%%%%%%-----------------------------SSS-----------
------------------------------%%%%%-||||oS--SoS-----------------------------------------------------||||||--------------------------------------------
--------SU----------SS---------|||--||||SS--SSS---Q---------%%%%%%----SS-----SS-Q---------SS--------||||||------------r-----------%%%%%---------------
---------------------K---TT----|||--||||---------------------||||-----------------------------------||||||--------%%%%%%-----------|||----------------
-------------------------TT----|||--||||---------------------||||----------------------------%%%%---||||||---------|||||-----------|||-------------F--
--M----------------------TT----|||--||||--kk---------gg----k-||||----------------ggg----------||----||||||--oo-----|||||--kkk------|||-------------#--
XXXXXXXXXXX--XX--X--XXXXXXXXXX-|||--||||XXXXXXXXXXXXXXXXXXXX-||||---------------XXXXX----X----||----||||||--%%-%%%-|||||XXXXXXXXXX%|||------XXXXXXXXXX
XXXXXXXXXXX--XX--X--XXXXXXXXXX-|||--||||XXXXXXXXXXXXXXXXXXXX-||||---------------XXXXX----X----||----||||||---|--|--|||||XXXXXXXXXX-|||------XXXXXXXXXX
