------------------------------------------------------------------------------------------------------------------------------------------------------
------------------------------------------------------------------------------------------------------------------------------------------------------
------------------------------------------------------------------------------------------------------------------------------------------------------
----------------------------------------SSSSSSSSSS----------------------------------------------------------------------------------------------------
----------------------------------------SSSSSSSS-------------------------o----------------------------------------------------------------------------
----------------------------------------SSSCSSSS------------------------%%%---------------------------------------------------------------------------
--------------------S-------------------SSSSSSSS-------------------------|--o------o--o-----------------SSQSSS------------oo---%%%-------##--------SSS
---------------------------TT--------------------------------------------|--SSSS---------------------------------SSS------SS----||-------##-----------
---------------------------TT-----------------------------------------%--|------------------------------------------------------||-----####-----------
---------------------------XX--------------ggg-----------o---------------|---------SSSS----o--------------K---------------------||-----####-----------
--------SUQ------------TT---------------SSSSSSSS-------------------------|-----------------------TT-----SSSSSS---------------SS-||---######-------#---
-----------------------TT--------------TSSSSSSSS-------------------------|-----------------------TT-----------------------------||---######-------#---
-----------------------TT--------------TSSSSSSSS-------------------------|-----%%%%--------------TT-----------------------------||---######-------#---
--M----------------#k--TT------------kkTSSSSSSSS----k-------gg-------g---|------||---------------TT-----------------------------||---######--ggg--#---
XXXXXXXXXXXXX--XXXXXXXXXXXXXXXXXXXXXXXXXXXXXXXXXXX-XXXXXXXXXXXXXXXXXXX%%%%%%----||--------XXXXXXXXXXXXXXXXXXXX%%%%----%%%%-----%%%XXXXXXXXXXXXXXXXXXXX
XXXXXXXXXXXXX--XXXXXXXXXXXXXXXXXXXXXXXXXXXXXXXXXXX-XXXXXXXXXXXXXXXXXXX|||||-----||--------XXXXXXXXXXXXXXXXXXXX|||------||-------||XXXXXXXXXXXXXXXXXXXX
