------------------------------------------------------------------------------------------------------------------------------------------------------
------------------------------------------------------------------------------------------------------------------------------------------------------
------------------------------------------------------------------------------------------------------------------------------------------------------
--------------------SSSSSSSSSS------------------------------------------------------------------------------------------------------------------------
--------------------SSSSSSSSSS-----------------------------------------------------------------------------------------------------------------------o
--------------------SSSSSSSSSS-------------------------oooo----------R--------------------------------------------------------------------------------
--------------------SSSSSSSSSS-------------------------%%%%------------------------USS--------------------------------------------!S------------------
--------------------------------------------------------||--------------------------------------------------------------------------------------SSS---
--------------------------------------------------------||-------------------------------------------------------------------SSS------------oo--------
--------------------------------------------------SSS---||--------------------------------------g-----------------------------------------------------
---------Q------------SSSSSS?-----------------tt--------||-------%%%--------------#-------------TT----------------------r---------S------#--SS--------
-----------------K----SSSSS-------------------tt------U-||--------|---------------#-------------TT----------------------%%%%%%----------##------------
------------B---------SSSSS-------------------tt--------||--------|---------------##------------TT--------*--------B----|||||----------###------------
-M----------b--------------ooo----k-k----g----tt--------||--------|---gg----------##--gg--------TT--gg----*--------b----|||||---------####------------
XXXXXXXXXXXXXXXXXXXX-XXXXXXXXXXXXXXXXXX-XXXXXXXXXX----%%%%%-%%%%%-|---XXXXXXXXXX--XXXXXXXXXXXXXXXXX-XXXXXXXXX-XXXXXXXXXX|||||-----XXXXXXXXXX----------
XXXXXXXXXXXXXXXXXXXX-XXXXXXXXXXXXXXXXXX-XXXXXXXXXX-----|||---|||--|---XXXXXXXXXX--XXXXXXXXXXXXXXXXX-XXXXXXXXX-XXXXXXXXXX|||||-----XXXXXXXXXX----------
