------------------------------------------------------------------------------------------------------------------------------------------------------
------------------------------------------------------------------------------------------------------------------------------------------------------
------------------------------------------------------------------------------------------------------------------------------------------------------
--------------------------------------------------------------------------------SSSSSSSSSLSSSSSSSSSS------------------------------SSSSSSSSSS----------
------------------------------------------------------------------------------------------------------------------------------------------------------
------------------------------------------------------------------------------------------------------------------------------------------------------
---------------------------------------------------------------------------1--------oooooo-------------------------------SSS----S!----------SSS-------
-------------------------------------------------------------o---o---o------------------------------oo-----------SSS----------------------------------
---------------------------------------------------------TT-%%%-%%%-%%--------------SSSSSS------------------------------------------------------------
------------Q--?-----------------------------------TT----TT--|---|---|-----ggg------SSSSSS-------------------------------------------------------SSSSS
-------------------SSS---------TT------------------TT----XX--|---|---|#########------------------------------T-------------------S--------------------
---------------------K---TT----TT------------------TT--------|---|---|--------#-----------t------------------T----------------------------TT----------
-------------------------TT----TT------------------TT--------|---|---|--------#-----------t------------------T---------------------tt-----TTSSS-------
-M----------------K------TT---gTT-----------y-y----TT--------|---|-r-|--------#-----------t---------------y--T--------------gg-g-g-tt----kTT-------r--
XXXXXXXXXXXXXXXXXXXXXXXXXXXXXXXXXXXXXX--XXXXXXXXXXXXXXXXXXXX%%%%%%%%%%--------X----XXXXXXXXXXXXXXXXXXXXXXXXXXX%%%%----%%XXXXXXXXXXXXXXXXXXXX-----XXXXX
XXXXXXXXXXXXXXXXXXXXXXXXXXXXXXXXXXXXXX--XXXXXXXXXXXXXXXXXXXX-|||||||||--------X----XXXXXXXXXXXXXXXXXXXXXXXXXXX|||------|XXXXXXXXXXXXXXXXXXXX-----XXXXX
