------------------------------------------------------------------------------------------------------------------------------------------------------
------------------------------------------------------------------------------------------------------------------------------------------------------
------------------------------------------------------------------------------------------------------------------------------------------------------
----------------------------------------------------------------------SSSSSSSSSSSSSSSSSSSSSSSSSSSSSS--------------------------------------------------
----------------------------------------------------------------------------SSSS----------------------------------------------------------------------
---------------------------------------------------------------------R---g--SSSS----------------------------------------------------------------------
---------------------LSSS-----------------------------------------------SS----------------------------------------------------------------------------
------------------------------------------------------------------------SS---------------------------------------SSS----------------------------------
---------------------------------------------------------B--------------SS----------------------------------------------------------------------------
------------Q--?-----------------------------------------b--------------SC--g-g--------S--------------------------------SS-?Q-------------------------
-------------------S-2-----#---TT----------------------SS#CS-----%%%----SS--SSSSSU--------------------------------------------------------------------
---------------------------#---TT---------------------------------|-----------------TT---tt-----------------g--------------------------------------#--
---------------------------##--TT--------------------------K------|-----------------TT---tt-----------------TT-----------------y---------------K---#--
---M--------------K---kk---##-gTT---------------------------------|----------------kTT--ktt-----------------TT-------------SSSSS-------------------#--
XXXXXXXXXXXXXXXXXXXXXXXXXXXXXXXXXXXXXX--X-XX-XX-XXXXXXXXXXXX%%%%%-|---XXXXXXXXXXXXXXXXXXXXXXXXXXXXXX--XXXXXXXX%%%%----%%-------XX-XXXXXXXXXXXXXXX--XXX
XXXXXXXXXXXXXXXXXXXXXXXXXXXXXXXXXXXXXX--X-XX-XX-XXXXXXXXXXXX-|||--|---XXXXXXXXXXXXXXXXXXXXXXXXXXXXXX--XXXXXXXX|||------|-------XX-XXXXXXXXXXXXXXX--XXX
