------------------------------------------------------------------------------------------------------------------------------------------------------
------------------------------------------------------------------------------------------------------------------------------------------------------
------------------------------------------------------------------------------------------------------------------------------------------------------
-----------------------oo-------oo----------------------------------------------SSSSSSSSSS--------------------SS-------S------------------------------
---------------------------------------g--------------------------------------------------------------------------------------------------------------
-----------------------------------%%%%%----------------------g-----------------------------oo--------------------------------------------------------
----------------------SSSS----------||||----------------------SSSSS--------g-------------------------------------------S--SSC------------##-----------
------------------------------------||||-------------------------------%%%%%%------------------------------------------------------------##-----------
------------------------------------||||--------------------------------||||-----------------------%---------------SSS-----------------####-----------
------------------------------%%%%%-||||--------------------------------||||-----------S----------------------------------SSS----------####-----------
----------Q---------------%%%%-|||--||||------tt------S-----------------||||----SU--------S----------------------------S-------------######-----------
---------------------------|||-|||--||||------tt--TT--------------------||||--------TT---t------------------g--##--------------------######-----------
---------------------------|||-|||--||||------tt--TT----------TT-----t--||||--------TT---t---%%%%-----------TT-##--------------------######--------F--
-------------------#-------|||-|||--||||-g----tt--TT------k---TT-----t--||||-------kTT--kt----||------------TT-##----------------#---######--------#--
XXXXXXXXXXXXX--XXXXX%%%----|||-|||--||||XXXXXXXXXXXXXXXXXXXXXXXXXXXXXX--||||----XXXXXXXXXX----||------XXXXXXXX-XX------XX----XXXXXXXXXXXXXXXXXXXXXXXXX
XXXXXXXXXXXXX--XXXXX||-----|||-|||--||||XXXXXXXXXXXXXXXXXXXXXXXXXXXXXX--||||----XXXXXXXXXX----||------XXXXXXXX-XX------XX----XXXXXXXXXXXXXXXXXXXXXXXXX
