------------------------------------------------------------------------------------------------------------------------------------------------------
------------------------------------------------------------------------------------------------------------------------------------------------------
------------------------------------------------------------------------------------------------------------------------------------------------------
--------------------SSSSSSSSSSSSSSSSSSSSSSSSSSSSSS------------------------------SSSSSSSSSS------------------------------SSSSSSSSSS--------------------
----------------------------------------SSSSSSSS--?---------------------------------------------------------------------------------------------------
----------------------------------------SSSCSSSS--------------------------------------------oo--------oo----------------------------------------------
------------------Q---------------------SSSSSSSS--------------------------SS-------------------------------------------------------------##--------SSS
--------------------------------------------------SS-------------------------------------------------------------------------------------##-----------
---------------------------------------S-----------------------------------------------------------%-----------------------------------####-----------
-----------------------------C---------S---ggg-----------------------------------------S-----------------------------------------------####-----------
--------SU--------?----#-#-------------SSSSSSSSS----------------------SS-----SS-SU--------S---------------------------r--------------######-------#---
--------------TT-----#-#-#-#---#--------SSSSSSSS-------SSS-----------T--------------TT---t------------------------%%%%%%--SS---------######-------#---
--------------TT-----#-#-#-#---#-#------SSSSSSSS-------------B-------T--------------TT---t---%%%%-----------tt-----|||||--SS---------######-------#---
--M-----------TT-----#-#-#-#-E-#-#------SSSSSSSS-------------b-------T-------------kTT--kt----||------ggg---tt-----|||||--SS---------######--ggg--#---
XXXXXXXXXXXXXXXXXXXXXXXXXXXXXXXXXXXXXXXXXXXXXXXXXX----------XXXXXX--XX----------XXXXXXXXXX----||----XXXXXXXXXX-%%%-|||||--XX--XXXXXXXXXXXXXXXXXXXXXXXX
XXXXXXXXXXXXXXXXXXXXXXXXXXXXXXXXXXXXXXXXXXXXXXXXXX----------XXXXXX--XX----------XXXXXXXXXX----||----XXXXXXXXXX--|--|||||--XX--XXXXXXXXXXXXXXXXXXXXXXXX
