------------------------------------------------------------------------------------------------------------------------------------------------------
------------------------------------------------------------------------------------------------------------------------------------------------------
------------------------------------------------------------------------------------------------------------------------------------------------------
--------------------SSSSSSSSSS------------------------------------------------------------------------------------------SSS-----SS--------------------
------------------------------------------------------------------------------------------------------------------------------------------------------
--------------------------------------------------------------g---------------------------------------------------------------------------------------
--------------------------------------------------------------SSSSS-------SS---------SSSS--SSS!-----------2-------------US----------------------------
--------------------------------o----ooo-------------------------------------------------------------------------SSS----------------------------------
---------------------------------------------------------B------------------------------------------------------------------SSS-----------------------
-----------------------------C---------------------------b------------------------------------------o-------------------------------------------------
----------------%%%%---#-#------------%%-TT---SU-------SS#CS----------SS-----SS-Q-------------C-----------2-------------SSS---------------------------
-----------------||--#-#-#-#-----------|-TT------------------------------------------------------------------------------------------TT---------------
-----------------||--#-#-#-#-----------|-TT----------------K--TT-----t---------------------------------------------------------------TT------------F--
-M---------------||--#-#-#-#-E-%%%%%%%-|-TT------k------------TT-----t-----------ggg-----------g-g------y--y-------------------------TT------------#--
XXXXXXXXXXX--%%%%||%XXXXXXXXXX--|||||--|XXXXXXXXXXXXXXXXXXXXXXXXXXXXXX----------XXXXX----XXXXXXXXXXXXXXXXXXXXX%%%%----%%XXX------XXXXXXXXXXXXXXXXXXXXX
XXXXXXXXXXX---||-||-XXXXXXXXXX--|||||--|XXXXXXXXXXXXXXXXXXXXXXXXXXXXXX----------XXXXX----XXXXXXXXXXXXXXXXXXXXX|||------|XXX------XXXXXXXXXXXXXXXXXXXXX
