------------------------------------------------------------------------------------------------------------------------------------------------------
------------------------------------------------------------------------------------------------------------------------------------------------------
------------------------------------------------------------------------------------------------------------------------------------------------------
------------------------------SSSSSSSSSSSSSSSSSSSS--------------------SSSSSSSSSSooo-----------------------------------------------SSSSSSSS------------
--------------------------------------------------?-----------------------------%%%-------------------------------------------------------------------
---------------------------------------------------------------------------------|------------------oo------------------------------------------------
----------------------!------------------oooo------------------------------------|--------SSS------%%%%-------------------------------------SS--------
--------------------------------------------------SS--------------------------TT-|------------------||--o----R----------------------------------------
---------------------------------------S-SSSS-U-------------------------------TT-|------------------||-%%%--------------------------------------------
------------Q--?-----------------------SoS--SoS-------------------------------TT-|---%%%%-----------||--|---------------SS-?Q-------------------------
---------Q---------SS@S!S--------------SSS--SSS-----------------------------SCTT-|----||----%%%-----||--|------------------------------g##--SS--------
-------------------------------#-----------------------SSS-----------T--TT----TT%%%%%%||-----|------||-o|------------------------------###--------#-TT
----------------------------tt-#-#---------------------------B-------T--TT----TT-||||-||-----|------||%%%%%--------B-----------y-----g####-------##-TT
------------------K--g------tt-#-#--------kk-----------------b-------T--TT---kTT-||||-||-----|------||-|||---------b-------SSSSS-----#####------###-TT
XXXXXXXXXXXXXXXXXXXXXXXXXXXXXXXXXXXXXXXXXXXXXXXXXX----------XXXXXX--XXXXXXXXXXXX-||||-||%%---|------||-|||----XXXXXXXXXX-------XX-XXXXXXXX--XXXXXXX-XX
XXXXXXXXXXXXXXXXXXXXXXXXXXXXXXXXXXXXXXXXXXXXXXXXXX----------XXXXXX--XXXXXXXXXXXX-||||-||-|---|------||-|||----XXXXXXXXXX-------XX-XXXXXXXX--XXXXXXX-XX
