------------------------------------------------------------------------------------------------------------------------------------------------------
------------------------------------------------------------------------------------------------------------------------------------------------------
------------------------------------------------------------------------------------------------------------------------------------------------------
------------------------------SSSSSSSSSS----------------------------------------------------------------------SSSSSSSSSS------------------------------
------------------------------SSSSSSSSSS--------------------------------------------------------------------------------------------------------------
----------------------ooor----SSSSSSSSSS---------------oooo---------------------K---------------------------------------------------------------------
---------------------%%%%%----SSSSSSSSSS---------------%%%%-------SSoo----SSCSS-SS----1----------------------@---------------------SSSS-----SS--------
----------------------|||-------------------------------||--------------------------------------------------------------------------------------------
----------------------|||-------------------------------||--------------------------------------------------------------------SSS---------------------
----------------------|||-------------------------SSS---||-----------------------------------------------------------------------------SSSS-----------
----------------!---%%%%%%%---SSSSSSSSSS----------------||--%%%%%%------QQQQ--QQSS---------------tt-SU----!--!T---------%-------------------SS--------
--------------------||||||----SSSSSSSSSS--------------U-||---||||---------------------TT--T------tt-----------T-----------------------------------#-TT
--------------------||||||--o-SSSSSSSSSS----------------||---||||---------------------TT--T------tt-----------T----TT----------------------------##-TT
-M------------------||||||-%%%SSSSSSSSSS-------ggg------||---||||---------------------TT--T------tt-------k---T--g-TT------------r--------------###-TT
XXXXXXXXXXXXXXXXXXXX||||||--|-XXXXXXXXXX-XXXXXXXXX----%%%%%--||||-----XXXXXXXXXXXXXXXXXXXXXXXXXXXXXXXXXXXXXXXXXXXXXXXXXX----XXXXXX---------XXXXXXXX-XX
XXXXXXXXXXXXXXXXXXXX||||||--|-XXXXXXXXXX-XXXXXXXXX-----|||---||||-----XXXXXXXXXXXXXXXXXXXXXXXXXXXXXXXXXXXXXXXXXXXXXXXXXX----XXXXXX---------XXXXXXXX-XX
