------------------------------------------------------------------------------------------------------------------------------------------------------
------------------------------------------------------------------------------------------------------------------------------------------------------
------------------------------------------------------------------------------------------------------------------------------------------------------
--------------------------------------------------SSSSSSS-----------------------SSSSSSSSSL------------------------------------------------------------
------------------------------------------------------------------------------------------------------------------------------------------------------
----------------------ooor------------oo------------------------------------------------------------oo------------------------------------------------
---------------------%%%%%---------SSSS-----------QQ--------------------------------oooooo----------%%%-------?SSS-----------------------##-----------
----------------------|||---------------------------------------------------------------------------||--o----R---------------------------##----y------
-----------------g----|||----------------------------------S------------------------SSSSSS----------||-%%%-----------------------------####--#SS--o---
-----------------#----|||---------------------------------------1--------1----------SSSSSS----------||--|---------------SS-?Q----------####-##--------
----------S-----##--%%%%%%%---%-------------------QQ--QQQ-------------T-----------------------------||--|-----SSSSS------------------######-##--SC----
---------------###--||||||--------------------------------------------T----TT-----------------------||-o|----------------------------######-##--------
--------------####--||||||--o-----------------------------------------T----TT--------------------B--||%%%%%--------------------y-----######-##---SSS--
---M---------#####--||||||-%%%-----------------ggg--------------------T---kTT--------------------b--||-|||------K----------SSSSS-----######-##--------
XXXXXXXXXXXXXXXXXXXX||||||--|---%%%%--%%-XXXXXXXXXXXXXXXX---XXXXXXXXX-XXXXXXXXXX---XXXXXXXXXXXXXXXXX||-|||----XXXXXXXXXX-------XX-XXXXXXXXXXXX------XX
XXXXXXXXXXXXXXXXXXXX||||||--|----||----|-XXXXXXXXXXXXXXXX---XXXXXXXXX-XXXXXXXXXX---XXXXXXXXXXXXXXXXX||-|||----XXXXXXXXXX-------XX-XXXXXXXXXXXX------XX
