------------------------------------------------------------------------------------------------------------------------------------------------------
------------------------------------------------------------------------------------------------------------------------------------------------------
------------------------------------------------------------------------------------------------------------------------------------------------------
--------------------------------------------------SSSSSSSSSS------------------------------------------------------------------------------------------
--------------------------------------------?---------SS--SS-----------------------------------------------------------------------------------------o
-----------------------SSS----------------------------SS--SS------------------------------------------------------------------------------------------
------------------Q---------------------------------SS------------------------------y-----------------------------------SSS-------%-------------------
---------------------g------------------------r-----SS----------------------------#SSS---------------------------SSS----------------------------SSS---
--------------------%%%-------------------%%%%%%----SS---------------------------##-----------------------------------------------------SSS-oo--------
--------------------||----SSS--------------||||-----SS----oo--------------------###1------------------------------------------------------------------
------------------?-||------------------%%-||||ooo--SSSS--SS---------T----------###-----------------------------------------------%%%%%-----SS--------
--------------TT----||----------------K-|--||||--r----SS-------------T----------###--SSS--------------TT---------------------------|||----------------
--------------TT----||--------TTTT------|%%%%%%%%%----SS-------------T----------###--------------B----TT----TT----------------TT---|||----------------
-M------------TT----||----oo--TTTT------|-||||||||------------ggg----Tgg--------###--------------b----TT-k--TT----------------TT---|||----------------
XXXXXXXXXXXXXXXXXXXX||---%%%--XXXXXXXXXX|-||||||||XXXXXXXXXXXXXXXXXXXXXXXXXXXXXXXXXXXX---XXXXXXXXXXXXXXXXXXXXX%%%%----%%----XXXXXX%|||----------------
XXXXXXXXXXXXXXXXXXXX||----|---XXXXXXXXXX|-||||||||XXXXXXXXXXXXXXXXXXXXXXXXXXXXXXXXXXXX---XXXXXXXXXXXXXXXXXXXXX|||------|----XXXXXX-|||----------------
