------------------------------------------------------------------------------------------------------------------------------------------------------
------------------------------------------------------------------------------------------------------------------------------------------------------
------------------------------------------------------------------------------------------------------------------------------------------------------
------------------------------------------------------------------------------------------------------------------------------------------------------
-----------------------------------------g-----------------------------------------------------------------------------------------------------------o
----------------------------------------%%--------------------g---------------------------------------oo----------------------------------------------
----------------------------------------|---------------------SSSSS--------g-------USS----SSS------%----------?SSS--------oo---%%%-------##-----------
----------------------------------------|----oo------------------------%%%%%%---------------------------------------------SS----||-------##-----SSS---
-----------------g----------------------|-------------------------------||||----------------------------------------------------||-----####-oo--------
-----------------#----------------------|-------------------------------||||----------------------------------------------------||-----####-----------
----------S-----##----------------------|-------------S-----------------||||------#---------%%%---------------SSSSS----------SS-||---######-SS--------
---------------###----------------------|---------TT--------------------||||------#----------|----------------------------------||---######-----------
--------------####----------------------|---------TT----------TT-----t--||||------##---------|--------------tt------------------||---######-----------
-M-----------#####----------------k-k---|---------TT------k---TT-----t--||||------##--gg-----|--------ggg---tt--K---------------||---######-----------
XXXXXXXXXXXXXXXXXXXXXXXXX--XXXXXXXXXXXX-|----%%%%-XXXXXXXXXXXXXXXXXXXX--||||------XXXXXXXX---|------XXXXXXXXXXXXXXXXXXXX%%-----%%%XXXXXXXXXX----------
XXXXXXXXXXXXXXXXXXXXXXXXX--XXXXXXXXXXXX-|-----||--XXXXXXXXXXXXXXXXXXXX--||||------XXXXXXXX---|------XXXXXXXXXXXXXXXXXXXX|-------||XXXXXXXXXX----------
