------------------------------------------------------------------------------------------------------------------------------------------------------
------------------------------------------------------------------------------------------------------------------------------------------------------
------------------------------------------------------------------------------------------------------------------------------------------------------
-----------------------oo---------------------------------------------------------------------------SSSSSSSSSS----------------------------------------
--------------------------------------------------?---------------------------------------------------------------------------------------------------
----------------------------------------------------------------------------------------oo-------------------------k----------------------------------
----------------------SSSS----------------------------------------SSoo--SSSSS---oo--------SSS------%----------S---SSSSSSSS--------SS------------------
--------------------------------------------------SS--------------------------------------------------------------------------------------------------
------------------------------------------------------------------------------------------------------------------------------------------------------
---------------------------------------------------------------------------------SS----------------------------------------TT-------------------------
-------------------%------%%%%------------------------------%%%%%%-----------2-----------S--%%%------------TT--------------TT-----SS----------#LSS----
---------------------------|||-------------------------SSS---||||----------TT----------------|----------#--TT-----------t--TT-----K---#----B--#-------
---------------------------|||-------------------------------||||-----t----TT--T-------------|---------##--TT-TT--------t--TT---------#----b--#-------
-M-----------%%%%----------|||----k-k----------ggg-----------||||-----t----TT--T-------------|------kk-##--TT-TT--------t--TT---------#----Bkk#-------
XXXXXXXXXXX---||----%%%----|||XXXXXXXXX--XXXXXXXXX-----------||||-----XXXXXXXXXX-------------|------XXXXX--XX-XXXXXXXX--XXXXXXXXXXXXXXXXXXXXXXXXXXX---
XXXXXXXXXXX---||----||-----|||XXXXXXXXX--XXXXXXXXX-----------||||-----XXXXXXXXXX-------------|------XXXXX--XX-XXXXXXXX--XXXXXXXXXXXXXXXXXXXXXXXXXXX---
