------------------------------------------------------------------------------------------------------------------------------------------------------
------------------------------------------------------------------------------------------------------------------------------------------------------
------------------------------------------------------------------------------------------------------------------------------------------------------
-----------------------oo-------oo------------------------------------------------------------------SSSSSSSSSS----------------------------------------
---------------------------------------g-g-------------------------------o----------------------------------------------------------------------------
-----------------------------------%%%%%%%---------------------------R--%%%---------------------------------------------------------------------k-----
----------------------SSSS----------|||||--------------------------------|--o--------SSSS---------------------------------SSC------SSSS--------SQS--SQ
------------------------------------|||||----oo--------------------------|--SSSS----------------------------------------------------------------------
------------------------------------|||||-----------------------------%--|----------------------------------------------------------------------------
------------------------------%%%%%-|||||--------------------------------|------------------------oo----------------------SSS----------SSSS-----------
---------Q------%%%%------%%%%-|||--|||||----------------tt------%%%-----|------Q--------------------------TT---!-----S------------------------SQS--S?
-----------------||--------|||-|||--|||||----------------tt-------|------|---------------------TT-------#--TT-----------------------------------------
-----------------||--------|||-|||--|||||----------------tt-------|------|-----%---------------TT------##--TT-----------------------------------------
-----------------||--------|||-|||--|||||------------g-g-tt-------|------|-------ggg--------y--TT---kk-##--TT--------------------#-----------k------gg
XXXXXXXXXXX--%%%%||%%%%----|||-|||--|||||----%%%%-XXXXXXXXXX%%%%%-|---%%%%%%----XXXXX----XXXXXXXXXXXXXXXX--XX-XXXXXXXXXXX----XXXXX---------XXXXXXXXXXX
XXXXXXXXXXX---||-||-||-----|||-|||--|||||-----||--XXXXXXXXXX-|||--|---|||||-----XXXXX----XXXXXXXXXXXXXXXX--XX-XXXXXXXXXXX----XXXXX---------XXXXXXXXXXX
