------------------------------------------------------------------------------------------------------------------------------------------------------
------------------------------------------------------------------------------------------------------------------------------------------------------
------------------------------------------------------------------------------------------------------------------------------------------------------
S-----SSSSSSSSSSSSSS--------------------SSSSSSSSSS----------------------------------------------------------------------------------------------------
S----------------------------------------------------------------------------------------------------------------------------------------------------o
S-----------------------------------------------------------------------------------------------------------------------------------------------------
S-------------------S--------------------oooo-----------------------------SSCSS------SSSS---------------SSQSSS-----oo-------------!S------------------
S--------------------------TT-------------------------------------------------------------------------------------------------------------------SSS---
S--------------------------TT------------SSSS-U---------------------------------------------------------------------------------------------oo--------
S--------------------------XX-----------oS--SoS-----------------------------------------------------------K-------------SS-?Q-------------------------
S----------------------TT-------QQQQ----SS--SSS--------ooo-----------T--QQQQ--QQQ---------------TT------SSSSSS-%%%%--%%%----------S------#--SS--------
S----------------------TT------------K-B-----------------------------T--------------------------TT--------------||----||----------------##------------
S----------------------TT--------------b-----------------------------T--------------------------TT--------------||----||-------y-------###------------
S-------------------k--TT--------------b--kk------------------ggg----T-----------ggg--------k---TT------------o-||----||---SSSSS------####------------
XXXXXXXXXXX--XX--X--XXXXXXXXXXXXXXXXXXXXXXXXXXXXXX--XXXXXXXXXXXXXXXXXXXXXXXXXXXXXXXXX----XXXXXXXXXXXXXXXXXXXXX%-||----||-------XX-XXXXXXXXXX----------
XXXXXXXXXXX--XX--X--XXXXXXXXXXXXXXXXXXXXXXXXXXXXXX--XXXXXXXXXXXXXXXXXXXXXXXXXXXXXXXXX----XXXXXXXXXXXXXXXXXXXXX--||----||-------XX-XXXXXXXXXX----------
