------------------------------------------------------------------------------------------------------------------------------------------------------
------------------------------------------------------------------------------------------------------------------------------------------------------
------------------------------------------------------------------------------------------------------------------------------------------------------
--------------------------------------------------------------------------------------------------------------SSSSSSSSSS------------------------------
------------------------------------------------------------------------------------------------------------------------------------------------------
--------------------------------------------------------------------------------------------oo--------------------------------------------------------
-----------------------------U--------------------Q-----------USSS-------------------SSSS-------------------------------SSS--------------##-----------
-----------------------------------------------------------------------------------------------------------------------------------------##----y------
----------------------------------------------------------------------o----------------------------%-----------------------------------####--#SS--o---
---------------------------------------------------------------------------------------------------------------------------------------####-##--------
----------------------------##----------------tt--Q----------S-----TT-----------Q---------SS------------------T----------------------######-##--SC----
-----------------K-----y-#####----------------tt-------------------TT---------#-----------------------TT------T----------------------######-##--------
------------B-------y-######------------------tt-------------------TT--------##--------------%%%%-----TT----TTT----TT---------TT-----######-##---SSS--
------------b-------######--------k-k----g----tt-----gg----k-ggg---TT------------ggg----------||------TT-k--TTT--g-TT---------TT-----######-##--------
XXXXXXXXXXXXXXXXXXXXXXXX------XXXXXXXXX-XXXXXXXXXXXXXXXXXXXXXXXXXXXXXXXXXXXXXXXXXXXXX----X----||----XXXXXXXXXXXXXXXXXXXX----XXXXXXXXXXXXXXXXXX------XX
XXXXXXXXXXXXXXXXXXXXXXXX------XXXXXXXXX-XXXXXXXXXXXXXXXXXXXXXXXXXXXXXXXXXXXXXXXXXXXXX----X----||----XXXXXXXXXXXXXXXXXXXX----XXXXXXXXXXXXXXXXXX------XX
