------------------------------------------------------------------------------------------------------------------------------------------------------
------------------------------------------------------------------------------------------------------------------------------------------------------
------------------------------------------------------------------------------------------------------------------------------------------------------
----------------------------------------------------------------------SSSSSSSSSS--------------------SSSSSSSSSS----------SSSSSSSSSS--------------------
----------------------------------------------------------------------------SSSS----------------------------------------------------------------------
-----------------------SSS--------------ooooo----------oooo--------------g--SSSS----------------------------------------------------------------k-----
-------------------------------------------------------%%%%-------------SS----------y----------------------------------------------------------SQS--SQ
---------------------g--------------------------SS------||--------------SS--------#SSS----------------------------------------------------------------
--------------------%%%------------------SSSS-----------||--------------SS-------##------------------------------------y------------------------------
--------------------||----SSS---------------------SSS---||--------------SC--g-g-###1-----------oooo--------------------X------------------------------
---------Q---------%||---------TT-----------------------||-----------#--SS--SSSS###------------------------TT---------XX-----------------------SQS--S?
--------------------||---------TT---------------------U-||----------##----------###--SSS----------------#--TT--------XXX--SS---------TT---------------
--------------------||---------TT-----------%%%%%-------||--TT-----###----------###--------------------##--TT-------XXXX--SS---------TT---------------
-------------%%%%---||----oo--gTT------------|||--------||--TT----####----------###-----------------kk-##--TT------XXXXX--SS---------TT------k------gg
XXXXXXXXXXX---||----||---%%%--XXXXXXXX--%%---|||------%%%%%-XXXXXXXXXXXXXXXXXXXXXXXXXX---X%%%%%%%-%%XXXXX--XX-XXXXXXXXXX--XX--XXXXXXXXXXXXXXXXXXXXXXXX
XXXXXXXXXXX---||----||----|---XXXXXXXX--|----|||-------|||--XXXXXXXXXXXXXXXXXXXXXXXXXX---X||||||---|XXXXX--XX-XXXXXXXXXX--XX--XXXXXXXXXXXXXXXXXXXXXXXX
