------------------------------------------------------------------------------------------------------------------------------------------------------
------------------------------------------------------------------------------------------------------------------------------------------------------
------------------------------------------------------------------------------------------------------------------------------------------------------
------------------------------SSSSSSSSSS----------------------------------------ooo-------------------------------------------------------------------
------------------------------SSSSSSSSSS----------------------------------------%%%-------------------------------------------------------------------
------------------------------SSSSSSSSSS-----------------------------------------|--------------------------------------------------------------k-----
------------------SCUSS-------SSSSSSSSSS----------Q------------------------------|--------SSS------%---------@----------SS-------------US------SQS--SQ
---------------------------------------------------------------------------------|--------------------------------------------------------------------
---------------------------------------------------------------------------------|--------------------------------------------------------------------
---------------------------------------------------------------------------------|---%%%%----------------------------------TT--------SS---------------
--------------TT---2----------SSSSSSSSSS------tt--Q------------------T-----------|----||----%%%-----SU----!--!-------------TT--------------S---SQS--S?
--------------TT-----B--------SSSSSSSSSS------tt---------------------T----------%%%%%%||-----|--------------------------t--TT-------------------------
--------------TT-----b-------BSSSSSSSSSS------tt---------------------T-----------||||-||-----|---------------------B----t--TT-----TT------------------
-M------------TT-----B-------bSSSSSSSSSS-g----tt-----gg----k--ggg----Tgg---------||||-||-----|------------k--------b----t--TT-----TT---------k------gg
XXXXXXXXXXXXXXXXXXXXXXXXXXXXXXXXXXXXXXXXXXXXXXXXXXXXXXXXXXXXXXXXXXXXXXXXXXXXXXXX-||||-||%%---|------XXXXXXXXXXXXXXXXXXXXXXXXXXXXXXXXXXXX-X-XXXXXXXXXXX
XXXXXXXXXXXXXXXXXXXXXXXXXXXXXXXXXXXXXXXXXXXXXXXXXXXXXXXXXXXXXXXXXXXXXXXXXXXXXXXX-||||-||-|---|------XXXXXXXXXXXXXXXXXXXXXXXXXXXXXXXXXXXX-X-XXXXXXXXXXX
