------------------------------------------------------------------------------------------------------------------------------------------------------
------------------------------------------------------------------------------------------------------------------------------------------------------
------------------------------------------------------------------------------------------------------------------------------------------------------
--------------------------------------------------SSSSSSS---------------------------------SSSSSSSSSS--------------------------------------------------
------------------------------------------------------------------------------------------------------------------------------------------------------
----------------------ooor--------------------------------------------------------------oo-------------------------k----------------------------------
------------------Q--%%%%%------------------------QQ----------------------SS----oo----------------------------S---SSSSSSSSS-------SS------------------
----------------------|||------------------------------------o---o---o--------------------------------------------------------------------------------
----------------------|||----------------------------------S%%%-%%%-%%--------------------------------------------------------------------------------
----------------------|||------------------------------------|---|---|-----------SS-------------------------------------------------------------------
-----SSS----------?-%%%%%%%-----------------------QQ--QQQ----|---|---|SS-----SS----------S------------%%%%%%----------------------SS------------------
--------------TT----||||||------------tt---------------------|---|---|---------------------------------||||-----------------------K---#----B----------
--------------TT----||||||--o---------tt---------------------|---|---|---------------------------------||||---TT--------------TT------#----b-------F--
--------------TT----||||||-%%%--------tt-------ggg-----------|---|-r-|--------------------------g-g----||||---TT--------------TT------#----B-------#--
XXXXXXXXXXXXXXXXXXXX||||||--|-XXXXXXXXXX-XXXXXXXXXXXXXXXX---%%%%%%%%%%--------------------XXXXXXXXXX%%-||||-%%XXXXXXXX------XXXXXXXXXXXXXXXXXXXXXXXXXX
XXXXXXXXXXXXXXXXXXXX||||||--|-XXXXXXXXXX-XXXXXXXXXXXXXXXX----|||||||||--------------------XXXXXXXXXX|--||||--|XXXXXXXX------XXXXXXXXXXXXXXXXXXXXXXXXXX
