------------------------------------------------------------------------------------------------------------------------------------------------------
------------------------------------------------------------------------------------------------------------------------------------------------------
------------------------------------------------------------------------------------------------------------------------------------------------------
----------SSSSSSSSSS-------------------------------oo-------------------------------------------------------------------------------------------------
--------------------------------------------------%%%%------------------------------------------------------------------------------------------------
----------------------------------------ooooo------||---------------------------------------oo------oo------------------------------------------k-----
-----------------------------U---------------------||------------------------------o--o-------------%%%----------------------------------------SQS--SQ
------------------------------------------------SS-||--SSS------------------------------------------||--o----R----------------------------------------
-----------------------------------------SSSS------||----------------------------------------------%||-%%%-------------y-------------g#---------------
---------------------------------------------------||--------------------1---------SSSS-------------||--|--------------XSS-?Q-------g##---------------
---------Q------------------##--QQQQ---------------||-----------------T-------------------S---------||--|-------------XX------------###--------SQS--S?
-----------------------y-#####-------K-B-----------||-----------------T----TT-----------------------||-o|------------XXX-----------####---------------
--------------------y-######-----------b----%%%%%-%||-----------------T----TT---%%%----------%%%%---||%%%%%---------XXXX-------y--#####---------------
-M------------------######-------------b-----|||---||--------y--------T---kTT---||------------||----||-|||---------XXXXX---SSSSS--#####------k------gg
XXXXXXXXXXX--XX--X--XXXX------XXXXXXXXXX%%---|||---||-------XXXXXXXXXXXXXXXXXXXX||------------||----||-|||----XXXXXXXXXX-------XX-XXXXX--XXXXXXXXXXXXX
XXXXXXXXXXX--XX--X--XXXX------XXXXXXXXXX|----|||---||-------XXXXXXXXXXXXXXXXXXXX||------------||----||-|||----XXXXXXXXXX-------XX-XXXXX--XXXXXXXXXXXXX
