------------------------------------------------------------------------------------------------------------------------------------------------------
------------------------------------------------------------------------------------------------------------------------------------------------------
------------------------------------------------------------------------------------------------------------------------------------------------------
------------------------------------------------------------SSSSSSSSSSSSSSSSSSSS--------------------SSSSSSSSSS----------SSS-----SS--------------------
------------------------------------------------------------SSSS--SSSS------SSSS----------------------------------------------------------------------
-----------------------SSS----------------------------------SSSS--SSSS---g--SSSS----------------------------------------------------------------------
--------------------------------------------------Q-----------SS---S----SS----------y-----------------------------------US---------SSSS---------------
---------------------g----------------------------------------SS---S----SS--------#SSS---------------------------------------------------------y------
--------------------%%%---------------------------------------SS---S----SS-------##-----------------------------------------SSS--------------#SS--o---
--------------------||----SSS-------------------------------ooSS---SoU--SC--g-g-###1---------------------------------------------------SSSS-##--------
--------------------||---------TT-----------------Q---------SSSS---SSS--SS--SSSS###-------------TT-----------T----------SSS-----------------##--SC----
--------------------||---------TT-------T-----TT--------------------------------###--SSS--------TT-----TT----T-#----------------------------##--------
--------------------||---------TT-------T-----TT--------------------------------###-------------TT-----TT----T-#----------------------------##---SSS--
-M------------k-ggg-||----oo--gTT-------T-----TT-----gg----kk--g-g--------------###---------k---TT--g--TT----T-#----ggg---------------------##--------
XXXXXXXXXXXXXXXXXXXX||---%%%--XXXXXXXX--XXXX--XXXXXXXXXXXXXXXXXXXXXXXXXXXXXXXXXXXXXXXX---XXXXXXXXXXXXXXXXXXXXX-XXXXXXXXXXXX------X---------XXX------XX
XXXXXXXXXXXXXXXXXXXX||----|---XXXXXXXX--XXXX--XXXXXXXXXXXXXXXXXXXXXXXXXXXXXXXXXXXXXXXX---XXXXXXXXXXXXXXXXXXXXX-XXXXXXXXXXXX------X---------XXX------XX
