------------------------------------------------------------------------------------------------------------------------------------------------------
------------------------------------------------------------------------------------------------------------------------------------------------------
------------------------------------------------------------------------------------------------------------------------------------------------------
S-----SSSS----------------------oo------SSSSSSSSSS----------------------------------------------------------------------------------------------------
S------------------------------------g-g--------------------------------------------------------------------------------------------------------------
S----------------------------------%%%%%------------------------------------------g-------------------------------------------------------------------
S---------------------!-------------||||-oooo------------------------------1----SSSSSSSS----------------SSQSSS--------US---------------------QQQQ-----
S-----------------------------------||||--------------------------------------------------------------------------------------------------------------
S-----------------------------------||||-SSSS-U----------TT----------o--------------------------------------------------------------------------------
S-----------------------------%%%%%-||||oS--SoS----TT----TT------y---------ggg----------------------------K---------E--------------------------y------
S-------------------S@S!S------|||--||||SS--SSS----TT----XX------##---#########-------------------------SSSSSS-----TT-----------------------Q?SSQQQ---
S------------------------------|||--||||-----------TT-----------###-----------#------------------------------------TT--t-------------TT---------------
S---------------------------tt-|||--||||-----------TT----------####-----------#------------------B-----------------TT--t-------------TT---------------
S--M----------k-ggg--g------tt-|||--||||--kk-------TT---------#####-----------#------------------b--------------g--TT--t--kkk--------TT---------------
XXXXXXXXXXXXXXXXXXXXXXXXXXXXXX-|||--||||XXXXXXXXXXXXXXXXXXXXXXXXXXX-----------X-XXXXXX---XXXXXXXXXXXXXXXXXXXXXXXXXXXXXXXXXXXXXXXXXXXXXXXXXXXXX--XXXXXX
XXXXXXXXXXXXXXXXXXXXXXXXXXXXXX-|||--||||XXXXXXXXXXXXXXXXXXXXXXXXXXX-----------X-XXXXXX---XXXXXXXXXXXXXXXXXXXXXXXXXXXXXXXXXXXXXXXXXXXXXXXXXXXXX--XXXXXX
