------------------------------------------------------------------------------------------------------------------------------------------------------
------------------------------------------------------------------------------------------------------------------------------------------------------
------------------------------------------------------------------------------------------------------------------------------------------------------
----------SSSSSSSSSS------------oo----------------SSSSSSS-------------------------------------------------------------------------SSSSSSSS------------
-------------------------------------g-g----?---------------------------------------------------------------------------------------------------------
-----------------------------------%%%%%-----------------------------R----------------------oo--------------------------------------------------k-----
------------------------------------||||----------QQ----------------------SS---------SSSS--------------------------------------SSS-------------SQS--SQ
------------------------------------||||------r-------------------------------------------------------------------------------------------------------
------------------------------------||||--%%%%%%-----------S---------------------------------------%--------------------------------------------------
------------------------------%%%%%-||||---||||---------------------------------------------------------------------------------K---------------------
----------------------------TT-|||--||||%%-||||oooQQ--QQQ--------%%%--SS-----SS-Q---------SS--------------------------r--------SSS-----g##-----SQS--S?
----------------------------TT-|||--|||||--||||--r----------------|-----------------------------------------g-----%%%%%%---------------###------------
----------------------------TT-|||--|||||%%%%%%%%%----------------|--------------------------%%%%-----------TT-----|||||-TT----------g####------------
-M----------------------ggg-TT-|||--|||||-||||||||----------------|--------------ggg----------||------------TT-----|||||-TT----------#####---k------gg
XXXXXXXXXXX--XX--X--XXXXXXXXXX-|||--|||||-||||||||XXXXXXX---%%%%%-|-------------XXXXX----X----||------XXXXXXXX-%%%-|||||XXXXXXXXXXXXXXXXXX--XXXXXXXXXX
XXXXXXXXXXX--XX--X--XXXXXXXXXX-|||--|||||-||||||||XXXXXXX----|||--|-------------XXXXX----X----||------XXXXXXXX--|--|||||XXXXXXXXXXXXXXXXXX--XXXXXXXXXX
