------------------------------------------------------------------------------------------------------------------------------------------------------
------------------------------------------------------------------------------------------------------------------------------------------------------
------------------------------------------------------------------------------------------------------------------------------------------------------
------------------------------------------------------------------------------------------------------------------------------------------------------
--------------------------------------------?---------------------------------------------------------------------------------------------------------
-----------------------SSS------------oo---------------------------------------------------------------------------k----------------------------------
-----------------------------------SSSS-----------------------------------SSCSS------SUS---------------------RS---SSSSSS--------------------SSS-------
---------------------g------------------------r----------------------------------------------------------r--------------------------------------------
--------------------%%%-------------------%%%%%%---------------------o------------------------------%%%%%%%-------------------------------------------
--------------------||----SSS--------------||||------------------y-----------------------------oooo-||||||--------------SS-?Q--------------------SSSSS
----------------!---||--------%---------%%-||||ooo----S----------##-----QQQQ--QQ----#####-----------||||||--------------------------------------------
--------------------||------------------|--||||--rTT------------###-----------------#---------------||||||--------------------------------------------
--------------------||------------------|%%%%%%%%%TT-----------####----------------K#---------------||||||----TT---------------y------------SSS-------
---M----------------||----oo------------|-||||||||TT------k---#####-----------------#---------------||||||--ooTT-----------SSSSS--k----------------r--
XXXXXXXXXXXXXXXXXXXX||---%%%----%%%%--%%|-||||||||XXXXXXXXXXXXXXXXX---XXXXXXXXXXXXXXXXX---%%%%%%%-%%||||||--%%XXXXXXXX---------XX-XX---XXXXX-----XXXXX
XXXXXXXXXXXXXXXXXXXX||----|------||----||-||||||||XXXXXXXXXXXXXXXXX---XXXXXXXXXXXXXXXXX---||||||---|||||||---|XXXXXXXX---------XX-XX---XXXXX-----XXXXX
