------------------------------------------------------------------------------------------------------------------------------------------------------
------------------------------------------------------------------------------------------------------------------------------------------------------
------------------------------------------------------------------------------------------------------------------------------------------------------
S-----SSSS-------------oo-------------------------SSSSSSS-------------------------------------------SSSSSSSSSS----------------------------------------
S-----------------------------------------------------------------------------------------------------------------------------------------------------
S-----------------------------------------------------------------------------------------------------------------------------------------------------
S-----------------SC--SSSS----S-------------------QQ--------------------------------y------------------------------oo--------------SSSS------------SSS
S---------------------------------------------------------------------------------#SSS----------------------------------------------------------------
S----------------------------------------------------------S-------------------g-##-------------------------------------------------------------------
S---------------------------------------------------------------1---------------###1-------o----------------------------SS-?Q----------SSSS-----------
S-------------TT---2------%%%%##--SSC-------------QQ--QQQ--------------------S@S###--------------TT--------TT--%%%%--%%%--------------------------#---
S-------------TT-----------|||--------------------------------------------------###--SSS---------TT-----#--TT---||----||--------------------------#---
S-------------TT-----------|||--------------------------------------------------###--------------TT----##--TT---||----||-------y------------------#---
S--M----------TT-----------|||--------------y-y---------------------------------###--------------TT-kk-##--TT-o-||----||---SSSSS-------------ggg--#---
XXXXXXXXXXXXXXXXXXXX%%%----|||XX--XXXXXXXXXXXXXXXXXXXXXXX---XXXXXXXXX--XXXXXXXXXXXXXXX---XXXXXXXXXXXXXXXX--XX-%-||----||-------XX----------XXXXXXXXXXX
XXXXXXXXXXXXXXXXXXXX||-----|||XX--XXXXXXXXXXXXXXXXXXXXXXX---XXXXXXXXX--XXXXXXXXXXXXXXX---XXXXXXXXXXXXXXXX--XX---||----||-------XX----------XXXXXXXXXXX
