------------------------------------------------------------------------------------------------------------------------------------------------------
------------------------------------------------------------------------------------------------------------------------------------------------------
------------------------------------------------------------------------------------------------------------------------------------------------------
----------SSSSSSSSSS----------SSSSSSSSSS--------------------------------------------------------------------------------------------------------------
------------------------------------------------------------------------------------------------------------------------------------------------------
-------------------------------------------------------oooo-----------------------------oo----------oo------------------------------------------------
----------------------!--------------------------------%%%%----------------g----oo------------------%%%-------?SSS----------------SS------------------
--------------------------------------------------------||-------------%%%%%%-----------------------||--o----R----------------------------------------
---------------------------------------S----------------||--------------||||------------------------||-%%%--------------------SSS---------------------
---------------------------------------S----------SSS---||--------------||||-----SSS----------------||--|---------------------------------------------
--------------------S@S!S--------------S----------------||-----------T--||||-------------S-------tt-||--|-----SSSSS-----%---------SS------------------
-------------------------------#--------T-----TT------U-||-----------T--||||--------------T------tt-||-o|-------------------------K---#----B-------#--
----------------------------tt-#-#------T-----TT--------||-----------T--||||--------------T------tt-||%%%%%---------------------------#----b---K---#--
---M-----------------g------tt-#-#------T-----TT--------||----ggg----T--||||--------------T------tt-||-|||------K----------------r----#----B-------#--
XXXXXXXXXXX--XX--X--XXXXXXXXXXXXXXXXXXXXXXXX--XXXX----%%%%%-XXXXXXXXXX--||||--------------XXXXXXXXXX||-|||----XXXXXXXXXX----XXXXXXXXXXXXXXXXXXXXX--XXX
XXXXXXXXXXX--XX--X--XXXXXXXXXXXXXXXXXXXXXXXX--XXXX-----|||--XXXXXXXXXX--||||--------------XXXXXXXXXX||-|||----XXXXXXXXXX----XXXXXXXXXXXXXXXXXXXXX--XXX
