------------------------------------------------------------------------------------------------------------------------------------------------------
------------------------------------------------------------------------------------------------------------------------------------------------------
------------------------------------------------------------------------------------------------------------------------------------------------------
------------------------------------------------------------------------------------------------------------------------SSS-----SS--------------------
-----------------------------------------------------------------------------------------------------------------------------------------------------o
----------------------------------------%%------------------------------------------------------------------------------------------------------------
---------------------LSSS---------------|---------Q-------------------------SSSS---o--o---------------------------------US---------SSSS---------------
----------------------------------------|----oo-------------------------------------------------------------------------------------------------SSS---
-----------------%%%--------------------|-----------------------------------------------------------------------------------SSS-------------oo--------
------------------||---------------oo---|------------------------------------K-----SSSS-----------oo-----------------------------------SSSS-----------
------------------||-2-----#------o--o--|---------Q------------------------SSSSS----------------------%%%%%%----------r-SSS-----------------SS--------
-------------%%%%%||-------#------------|----------------------------TT------------------------TT------||||-------%%%%%%------------------------------
--------------|||-||-------##-----------|--------------------B-------TT---------%%%------------TT------||||--------|||||------------------------------
-M------------|||-||--kk---##-----------|------------gg----k-b-------TT---------||----------y--TT------||||--------|||||------------------------------
XXXXXXXXXXX---|||-||XXXXXXXXXXXXXXXXXXXX|----%%%%-XXXXXXXXXXXXXXXX--XXXXXXXXXXXX||--------XXXXXXXXXX%%-||||-%%-%%%-|||||XXX------X---------X----------
XXXXXXXXXXX---|||-||XXXXXXXXXXXXXXXXXXXX|-----||--XXXXXXXXXXXXXXXX--XXXXXXXXXXXX||--------XXXXXXXXXX|--||||--|--|--|||||XXX------X---------X----------
