------------------------------------------------------------------------------------------------------------------------------------------------------
------------------------------------------------------------------------------------------------------------------------------------------------------
------------------------------------------------------------------------------------------------------------------------------------------------------
--------------------------------oo------------------------------------SSSSSSSSSS----------SSSSSSSSSS--------------------------------------------------
---------------------------------------g--------------------------------------------------------------------------------------------------------------
----------------------ooor---------%%%%%------------------------------------------------oo------------------------------------------------------------
---------------------%%%%%----------||||-----------------Q-Q------SSoo----------oo------------------------2--------oo------------------------------SSS
----------------------|||-----------||||--------------------------------------TT------------------------------------------------oo--------------------
----------------------|||-----------||||--------------------------------------TT----------------------------------------------------------------------
----------------------|||-----%%%%%-||||--------------------------------------TT-SSS----------------o-------------------------------------------------
--------SU---------%%%%%%%%----|||--||||-----------------Q-Q%%%%%%----------SCTT---------S----------------2----%%%%--%%%-----TT-------------------#---
--------------------||||||-----|||--||||---------------------||||-------TT----TT----------t---------------------||----||-----TT------TT-----------#---
--------------------||||||--o--|||--||||---------------------||||-------TT----TT----------t---------------------||----||-----TT------TT-----------#---
--M----------%%%%---||||||-%%%-|||--||||-------ggg-----------||||-------TT---kTT----------t-------------y--y--o-||----||-y---TT------TT------ggg--#---
XXXXXXXXXXX---||----||||||--|--|||--||||-XXXXXXXXXXXXXXXXXXX-||||-----XXXXXXXXXX----------XXXXXXXXXXXXXXXXXXXX%-||----||XXXXXXXXXXXXXXXXXXXXXXXXXXXXXX
XXXXXXXXXXX---||----||||||--|--|||--||||-XXXXXXXXXXXXXXXXXXX-||||-----XXXXXXXXXX----------XXXXXXXXXXXXXXXXXXXX--||----||XXXXXXXXXXXXXXXXXXXXXXXXXXXXXX
