------------------------------------------------------------------------------------------------------------------------------------------------------
------------------------------------------------------------------------------------------------------------------------------------------------------
------------------------------------------------------------------------------------------------------------------------------------------------------
S-----SSSS----------SSSSSSSSSS--oo--------------------------------------------------------------------------------------------------------------------
S-------------------SSSSSSSSSS-------g-g----------?--------------------------------------------------------------------------------------------------o
S-------------------SSSSSSSSSS-----%%%%%%%----------------------------------------------oo----------oo------------------------------------------------
S-------------------SSSSSSSSSS------|||||-----------------------------------SSSSoo------------------%%%---------------------------!S------------------
S-----------------------------------|||||----oo---SS------------------------------------------------||--o----R----------------------------------SSS---
S-----------------------------------|||||-----------------------------------------------------------||-%%%----------------------------------oo--------
S-----------------------------%%%%%-|||||------------------------------------K---SS------------oooo-||--|---------------------------------------------
S------------------%--SSSSSS?--|||--|||||----------------------------#-----SSSSS---------S----------||--|-------!-----S-----------S------#--SS--------
S---------------------SSSSS----|||--|||||--------------SSS----------##T-----------------------------||-o|-------------------------------##------------
S---------------------SSSSS----|||--|||||-------------------TT-----###T-----------------------------||%%%%%----------------------------###------------
S--M---------%%%%----------ooo-|||--|||||-------------------TT----####T-----------------------------||-|||----------------kkk---------####------------
XXXXXXXXXXX---||-----XXXXXXXXX-|||--|||||----%%%%-----------XXXXXXXXXXXXXXXXXXXX----------%%%%%%%-%%||-|||----XXXXXXXXXXXXXXXXXXXXXXXXXXXXXX----------
XXXXXXXXXXX---||-----XXXXXXXXX-|||--|||||-----||------------XXXXXXXXXXXXXXXXXXXX----------||||||---|||-|||----XXXXXXXXXXXXXXXXXXXXXXXXXXXXXX----------
