------------------------------------------------------------------------------------------------------------------------------------------------------
------------------------------------------------------------------------------------------------------------------------------------------------------
------------------------------------------------------------------------------------------------------------------------------------------------------
---------------------------------------------------oo---------------------------------------------------------SSSSSSSSSS------------------------------
--------------------------------------------------%%%%------------------------------------------------------------------------------------------------
---------------------------------------------------||---------g---------------------------------------------------------------------------------------
-----------------------------U---------------------||---------SSSSS-----SSSSS------USS------------------SSQSSS-------------------------------------SSS
---------------------------------------------------||--SSS--------------------------------------------------------------------------------------------
-----------------g---------------------------------||-------------------------------------------------------------------------SSS---------------------
-----------------#---------------------------------||------------------------------------------oooo-------K-------------------------------------------
----------S-----##----------##-TT------------------||------------------------2----#---------------------SSSSSST---------%-------------------------#---
---------------###-----y-#####-TT------------------||----------------------TT-----#---------------------------T----------------------TT-----------#---
--------------####--y-######---TT-----------------%||---------TT-----tt----TT--T--##--------------------------T----TT----------------TT-----------#---
-------------#####--######----gTT-----------y-y----||---------TT-----tt----TT--T--##--gg----------------------T--g-TT------------r---TT------ggg--#---
XXXXXXXXXXXXXXXXXXXXXXXX------XXXXXXXX--XXXXXXXXXX-||-------XXXXXXXXXXXXXXXXXXXX--XXXXXXXX%%%%%%%-%%XXXXXXXXXXXXXXXXXXXX----XXXXXXXXXXXXXXXXXXXXXXXXXX
XXXXXXXXXXXXXXXXXXXXXXXX------XXXXXXXX--XXXXXXXXXX-||-------XXXXXXXXXXXXXXXXXXXX--XXXXXXXX||||||---|XXXXXXXXXXXXXXXXXXXX----XXXXXXXXXXXXXXXXXXXXXXXXXX
