------------------------------------------------------------------------------------------------------------------------------------------------------
------------------------------------------------------------------------------------------------------------------------------------------------------
------------------------------------------------------------------------------------------------------------------------------------------------------
----------------------------------------------------------------------SSSSSSSSSS----------------------------------------------------------------------
------------------------------------------------------------------------------------------------------------------------------------------------------
-----------------------SSS--------------ooooo-------------------------------------g-------------------------------------------------------------------
------------------------------S-------------------------------------------------SSSSSSSS----------------------------------oo---%%%!S------------------
---------------------g--------------------------SS-----------o---o---o--------TT--------------------------------oooo------SS----||--------------------
--------------------%%%------------------SSSS---------------%%%-%%%-%%--------TT------------------------------------------------||--------------------
--------------------||----SSS--------------------------------|---|---|--------TT------------------------------------------------||--------------------
----------------%%%%||--------##--SSC------------------------|---|---|------SCTT------------------------------T--------------SS-||S------#------------
-----------------||-||------------------------------K--------|---|---|--TT----TT----------------------TT------T-----------------||------##------------
-----------------||-||----------------------%%%%%------------|---|---|--TT----TT----------------------TT----TTT-----------------||-----###---------F--
-M---------------||-||----oo-----------------|||-----------g-|---|-r-|--TT---kTT-------------------g--TT-k--TTT---y-------------||----####---------#--
XXXXXXXXXXX--%%%%||%||---%%%--XX--XXXXXX%%---|||--XXXXXXXXXX%%%%%%%%%%XXXXXXXXXXXXXXXX---X-XXXXXXXXXXXXXXXXXXXXXXXXXXXXX%%-----%%%XXXXXXXXXXXXXXXXXXXX
XXXXXXXXXXX---||-||-||----|---XX--XXXXXX|----|||--XXXXXXXXXX-|||||||||XXXXXXXXXXXXXXXX---X-XXXXXXXXXXXXXXXXXXXXXXXXXXXXX|-------||XXXXXXXXXXXXXXXXXXXX
