------------------------------------------------------------------------------------------------------------------------------------------------------
------------------------------------------------------------------------------------------------------------------------------------------------------
------------------------------------------------------------------------------------------------------------------------------------------------------
----------------------------------------------------------------------------------------------------------------------------------SSSSSSSSSS----------
------------------------------------------------------------------------------------------------------------------------------------------------------
-----------------------SSS-------------------------------------------R----------K---------------------------------------------------------------------
---------------------------------------------------------------------------1----SS----1----------------------------oo---SSS-----------------SSS-------
---------------------g--------------------------------------------------------------------------------------------------------------------------------
--------------------%%%-------------------------------------------------------------------------------------------------------------------------------
--------------------||----SSS----------------------------------------------ggg------------------g------------------------------------------------SSSSS
--------------------||---------TT----------------------ooo-------%%%--#########-SS--------------TT-------------%%%%--%%%------------------------------
-----------------K--||---------TT---------------------------------|-----------#-------TT--------TT----------g---||----||------------------TT----------
------------B-------||---------TT---------------------------------|-----------#-------TT--------TT----------TT--||----||------TT---tt-----TTSSS-------
-M----------b-------||----oo--gTT--------------ggg----------------|-----------#-------TT--------TT----------TTo-||----||------TT---tt----kTT-------r--
XXXXXXXXXXXXXXXXXXXX||---%%%--XXXXXXXX---XXXXXXXXX--XXXXXXXX%%%%%-|-----------X-XXXXXXXXXXXXXXXXXXX---XXXXXXXX%-||----||----XXXXXXXXXXXXXXXX-----XXXXX
XXXXXXXXXXXXXXXXXXXX||----|---XXXXXXXX---XXXXXXXXX--XXXXXXXX-|||--|-----------X-XXXXXXXXXXXXXXXXXXX---XXXXXXXX--||----||----XXXXXXXXXXXXXXXX-----XXXXX
