------------------------------------------------------------------------------------------------------------------------------------------------------
------------------------------------------------------------------------------------------------------------------------------------------------------
------------------------------------------------------------------------------------------------------------------------------------------------------
--------------------------------oo--------------------------------------------------------SSSSSSSSSS--------------------------------------------------
---------------------------------------g--------------------------------------------------------------------------------------------------------------
-----------------------------------%%%%%---------------oooo-------------------------------------------------------------------------------------------
------------------------------------||||---------------%%%%----------------g-------USS----------------------------------SSS-----------------SS--------
------------------------------------||||----------SSSS--||-------------%%%%%%-------------------------------------------------------------------------
------------------------------------||||----------------||-----------o--||||--------------------------------------------------------------------------
------------------------------%%%%%-||||----------------||-------y------||||--------------------------------------------------------------------------
----------------%%%%SS---------|||--||||----------------||-------##-----||||------#---------------------------------------------------------SS--------
-----------------||--K---TT----|||--||||-----K---B----U-||------###-----||||------#-------t-----------------g------------------------TT-----------#-TT
-----------------||------TT----|||--||||---------b------||-----####-----||||------##------t-----------------TT----------------TT-----TT----------##-TT
-M---------------||------TT----|||--||||---------B------||----#####-----||||------##--gg--t-----------------TT-k----kkk-------TT-----TT---------###-TT
XXXXXXXXXXX--%%%%||%XXXXXXXXXX-|||--||||XXXXXXXXXX----%%%%%-XXXXXXX-----||||------XXXXXXXXXXXXXXXXXX--XXXXXXXXXXXXXXXXXX----XXXXXXXXXXXXXXXXXXXXXXX-XX
XXXXXXXXXXX---||-||-XXXXXXXXXX-|||--||||XXXXXXXXXX-----|||--XXXXXXX-----||||------XXXXXXXXXXXXXXXXXX--XXXXXXXXXXXXXXXXXX----XXXXXXXXXXXXXXXXXXXXXXX-XX
