------------------------------------------------------------------------------------------------------------------------------------------------------
------------------------------------------------------------------------------------------------------------------------------------------------------
------------------------------------------------------------------------------------------------------------------------------------------------------
------------------------------------------------------------------------------------------------------------------------SSSSSSSSSS--------------------
------------------------------------------------------------------------------------------------------------------------------------------------------
----------------------ooor------------oo------------------------------------------------oo--oo--------------------------------------------------------
---------------------%%%%%---------SSSS------------------Q-Q--------------SSCSS-oo--------------------------------------------------------------------
----------------------|||---------------------------------------------------------------------------------TT----oooo--------------oo------------------
----------------------|||--------------------------------------------------------------------------%------TT------------------------------------------
----------------------|||---------------------------------------1----------------SS-----------------------TT------------------------------------------
--------------------%%%%%%%---%--------------------------Q-Q------------QQQQ--QQ---------SS--------------SXXS-T----------------------------Q----------
-----------------K--||||||------------------------------------------------------------------------------------T-----------SS--------------------------
------------B-------||||||--o----------------------------------------------------------------%%%%---TT--------T-----------SS-----------------------F--
-M----------b-------||||||-%%%-----------------y----------------------------------------------||----TT--------T---y-------SS-----------------------#--
XXXXXXXXXXXXXXXXXXXX||||||--|---%%%%--%%XXXXXXXXXXXXXXXXXXXXXXXXXXXXX-XXXXXXXXXX--------------||----XXXXXXXXXXXXXXXXXXXX--XX--XXXXXXXXXXXXXXXXXXXXXXXX
XXXXXXXXXXXXXXXXXXXX||||||--|----||----|XXXXXXXXXXXXXXXXXXXXXXXXXXXXX-XXXXXXXXXX--------------||----XXXXXXXXXXXXXXXXXXXX--XX--XXXXXXXXXXXXXXXXXXXXXXXX
