------------------------------------------------------------------------------------------------------------------------------------------------------
------------------------------------------------------------------------------------------------------------------------------------------------------
------------------------------------------------------------------------------------------------------------------------------------------------------
------------------------------------------------------------------------------------------SSSSSSSSSS----------SSSSSSSSSS------------------------------
-----------------------------------------g------------------------------------------------------------------------------------------------------------
----------------------------------------%%------------------------------------------------------------------------------------------------------------
----------------------------------------|----------------Q-Q--USSS---------g-------USS---------------------------------------------------##--------SSS
--------------------------------o----ooo|----oo------------------------%%%%%%------------------------------------------------------------##-----------
-----------------%%%--------------------|-------------------------------||||-----------------------------------------------------------####-----------
------------------||--------------------|-------------------------------||||--------------------------------------------SS-?Q----------####-----------
------------------||--------TT--------%%|----------------Q-Q-S-----TT---||||------#-------------------%%%%%%--T----------------------######-------#---
-------------%%%%%||--------TT---------||--------------------------TT---||||------#--------------------||||---T----------------------######-------#---
--------------|||-||--------TT---------||--------------------------TT---||||------##-------------------||||---T----TT----------y-----######-------#---
-M------------|||-||----ggg-TT-%%%%%%%-||--------------------ggg---TT---||||------##--gg--------g-g----||||---T--g-TT------SSSSS-----######--ggg--#---
XXXXXXXXXXX---|||-||XXXXXXXXXX--|||||--||----%%%%-XXXXXXXXXXXXXXXXXXXX--||||------XXXXXXXXXXXXXXXXXX%%-||||-%%XXXXXXXXXX-------XX-XXXXXXXXXXXXXXXXXXXX
XXXXXXXXXXX---|||-||XXXXXXXXXX--|||||--||-----||--XXXXXXXXXXXXXXXXXXXX--||||------XXXXXXXXXXXXXXXXXX|--||||--|XXXXXXXXXX-------XX-XXXXXXXXXXXXXXXXXXXX
