------------------------------------------------------------------------------------------------------------------------------------------------------
------------------------------------------------------------------------------------------------------------------------------------------------------
------------------------------------------------------------------------------------------------------------------------------------------------------
----------SSSSSSSSSS------------------------------SSSSSSS---------------------------------------------------------------------------------------------
-------------------------------------------------------------------------o----------------------------------------------------------------------------
-----------------------SSS--------------%%--------------------g---------%%%-------------oo------------------------------------------------------------
----------------------------------------|---------QQ----------SSSSS------|--o---oo---------SSS!------------------------------------SSSS------------SSS
---------------------g----------o----ooo|----oo--------------------------|--SSSS---------------------------------SSS----------------------------------
--------------------%%%-----------------|------------------S----------%--|---------------------------------------------------SSS----------------------
--------------------||----SSS-----------|--------------------------------|-------SSS---------------------------------------------------SSSS-----------
--------------------||----------------%%|---------QQ--QQQ----------------|---------------S----C-------%%%%%%------------r-------------------------#---
--------------------||-----------------||--------------------------------|-----------------------------||||-------------%%%%%%--------------------#---
--------------------||-----------------||---------------------TT-----t---|-----%-----------------------||||-------------|||||---------------------#---
---M----------------||----oo---%%%%%%%-||---------------------TT-----t---|---------------------g-g-----||||-------------|||||----------------ggg--#---
XXXXXXXXXXX--XX--X--||---%%%----|||||--||----%%%%-XXXXXXX---XXXXXXXXXX%%%%%%--------------XXXXXXXXXX%%-||||-%%%%%%----%%|||||--------------XXXXXXXXXXX
XXXXXXXXXXX--XX--X--||----|-----|||||--||-----||--XXXXXXX---XXXXXXXXXX|||||---------------XXXXXXXXXX|--||||--||||------||||||--------------XXXXXXXXXXX
