------------------------------------------------------------------------------------------------------------------------------------------------------
------------------------------------------------------------------------------------------------------------------------------------------------------
------------------------------------------------------------------------------------------------------------------------------------------------------
S-----SSSS--------------------------------------------------SSSSSSSSSS--------------------------------------------------------------------------------
S-----------------------------------------------------------SSSS--SSSS--------------------------------------------------------------------------------
S---------------------------------------%%------------------SSSS--SSSS--------------------------------------------------------------------------------
S---------------------------------------|----------------Q-Q--SS---S------SSCSS-----------------------------------------SSS------------US-------------
S---------------------------------------|----oo---------------SS---S----------------------------------------------------------------------------------
S---------------------------------------|---------------------SS---S----------------------------------------------------------------------------------
S---------------------------------------|-------------------ooSS---SoU------------o--------------------------------------------------SS---------------
S---------------------------------------|----------------Q-QSSSS---SSS--QQQQ--QQ-------TT--------tt-------------------r--------------------S----------
S---------------------------------------|----------------------------------------------TT-T------tt---TT----------%%%%%%------------------------------
S---------------------------------------|----------------------------------------------TT-T------tt---TT----TT-----|||||------TT--TT---------------F--
S-------------k-ggg---------------k-k---|-------------------k--g-g---------------------TT-T------tt---TT-k--TT-----|||||------TT--TT---------------#--
XXXXXXXXXXXXXXXXXXXXXXXXX--XXXXXXXXXXXX-|----%%%%-XXXXXXXXXXXXXXXXXXXXXXXXXXXXXXXXXXXXXXXXXXXXXXXXXXXXXXXXXXXX-%%%-|||||----XXXXXXXXXXXX-X-XXXXXXXXXXX
XXXXXXXXXXXXXXXXXXXXXXXXX--XXXXXXXXXXXX-|-----||--XXXXXXXXXXXXXXXXXXXXXXXXXXXXXXXXXXXXXXXXXXXXXXXXXXXXXXXXXXXX--|--|||||----XXXXXXXXXXXX-X-XXXXXXXXXXX
