------------------------------------------------------------------------------------------------------------------------------------------------------
------------------------------------------------------------------------------------------------------------------------------------------------------
------------------------------------------------------------------------------------------------------------------------------------------------------
----------------------------------------------------------------------------------------------------------------------------------SSSSSSSSSS----------
------------------------------------------------------------------------------------------------------------------------------------------------------
--------------------------------------------------------------g---------------------------------------------------------------------------------------
--------------------USS---------------------------------------SSSSS--------1---------1----------------------------------SSS---------------------------
--------------------------------------------------------------------------------------------------oooo-----------------------------------------y------
---------------------------------------------------------TT----------------------------------------------------------------------------------#SS--o---
------------Q--?-----------------------------------TT----TT----------------ggg--------------------------------------------------------------##--------
-------------------S------------QQQQ-----TT---SU---TT----XX-----------#########----QQQQ----------------------T------------------------------##--SC----
---------------------B---------------K-B-TT--------TT-------------------------#-----------------#------------T----------------------------TT##--------
---------------------b-------B---------b-TT--------TT---------TT-----t--------#-----------------#------------T-----B----------TT---tt-----TT##---SSS--
-M----------------K--B-------b---------b-TT------k-TT---------TT-----t--------#-----yy----------#---------y--T-----b----------TT---tt----kTT##--------
XXXXXXXXXXXXXXXXXXXXXXXXXXXXXXXXXXXXXXXXXXXXXXXXXXXXXXXXXXXXXXXXXXXXXX--------X-XXXXXXXXXXXXXXXXXXXXXXXXXXXXXXXXXXXXXXXX----XXXXXXXXXXXXXXXXXX------XX
XXXXXXXXXXXXXXXXXXXXXXXXXXXXXXXXXXXXXXXXXXXXXXXXXXXXXXXXXXXXXXXXXXXXXX--------X-XXXXXXXXXXXXXXXXXXXXXXXXXXXXXXXXXXXXXXXX----XXXXXXXXXXXXXXXXXX------XX
