------------------------------------------------------------------------------------------------------------------------------------------------------
------------------------------------------------------------------------------------------------------------------------------------------------------
------------------------------------------------------------------------------------------------------------------------------------------------------
----------------------------------------SSSSSSSSSS-oo-------------------------------------------------------------------------------------------------
----------------------------------------SSSSSSSS--%%%%------------------------------------------------------------------------------------------------
----------------------ooor--------------SSSCSSSS---||---------g---------------------------------------------------------------------------------------
------------------SC-%%%%%--------------SSSSSSSS---||---------SSSSS--------g---------1---------------------------------------------------##-----------
----------------------|||-------o----ooo-----------||--SSS-------------%%%%%%---------------------------------------------------oo-------##-----------
----------------------|||--------------------------||-------------------||||-----------------------------------------------------------####-----------
----------------------|||------------------ggg-----||-------------------||||-----------------------------------------------------------####-----------
---------Q----TT---2%%%%%%%-----------%%SSSSSSSS---||-------------------||||-------QQQQ----------tt--------------------------TT------######-#---------
--------------TT----||||||-------------|SSSSSSSS---||-------------------||||--------------T------tt---TT---------------------TT------######-##--------
--------------TT----||||||--o----------|SSSSSSSS--%||---------TT-----t--||||--------------T------tt---TT----TT-----B---------TT------######-###------#
-M------------TT----||||||-%%%-%%%%%%%-|SSSSSSSS---||---------TT-----t--||||--------yy----T------tt---TT-k--TT-----b-----y---TT------######-####----##
XXXXXXXXXXXXXXXXXXXX||||||--|---|||||--|XXXXXXXXXX-||-------XXXXXXXXXX--||||----XXXXXXXXXXXXXXXXXXXXXXXXXXXXXXXXXXXXXXXXXXXXXXXXXXXXXXXXXXXXXXXXXXXXXX
XXXXXXXXXXXXXXXXXXXX||||||--|---|||||--|XXXXXXXXXX-||-------XXXXXXXXXX--||||----XXXXXXXXXXXXXXXXXXXXXXXXXXXXXXXXXXXXXXXXXXXXXXXXXXXXXXXXXXXXXXXXXXXXXX
