------------------------------------------------------------------------------------------------------------------------------------------------------
------------------------------------------------------------------------------------------------------------------------------------------------------
------------------------------------------------------------------------------------------------------------------------------------------------------
------------------------------------------------------------------------------------------------------------------------------------------------------
------------------------------------------------------------------------------------------------------------------------------------------------------
------------------------------------------------------------------------------------------------------------------------------------------------k-----
--------------------USS--------------------------------------------------------------SSSS--------------------R-----------SSS----S!-------------SQS--SQ
---------------------------------------------------------------------------------------------------------r--------------------------------------------
----------------------------------------------------------------------o-----------------------------%%%%%%%-------------------------------------------
---------------------------------------------------------o---------------------------------o--------||||||--------------------------------------------
---------------------------------------T----------------------------------------Q----------------TT-||||||-----------------------S---------#---SQS--S?
-----------------K---B-----------------TT-----TT------------------------------#------------------TT-||||||--------------------------------##----------
------------B--------b-------B---------TT-----TT-----------------------------##------------------TT-||||||-------------------------------###----------
-M----------b--------B-------b--gg-----TT-----TT----k--------y-------------------ggg-------------TT-||||||--oo-k----kkk-----gg-g-g---y--####-k------gg
XXXXXXXXXXXXXXXXXXXXXXXXXXXXXXXXXXXXXXXXXXXX--XXXX-XXXXXXXXXXXXXXXXXXXXXXXXXXXXXXXXXX----XXXXXXXXXXX||||||--%%XXXXXXXXXXXXXXXXXXXXXXXXXXXXXXXXXXXXXXXX
XXXXXXXXXXXXXXXXXXXXXXXXXXXXXXXXXXXXXXXXXXXX--XXXX-XXXXXXXXXXXXXXXXXXXXXXXXXXXXXXXXXX----XXXXXXXXXXX||||||---|XXXXXXXXXXXXXXXXXXXXXXXXXXXXXXXXXXXXXXXX
