------------------------------------------------------------------------------------------------------------------------------------------------------
------------------------------------------------------------------------------------------------------------------------------------------------------
------------------------------------------------------------------------------------------------------------------------------------------------------
------------------------------SSSSSSSSSS--------------------------------------------------------------------------------SSSSSSSSSS--------------------
------------------------------------------------------------------------------------------------------------------------------------------------------
----------------------------------------------------------------------------------------------------oo------------------------------------------------
---------------------------------------------------------Q-Q------SSoo-----g-------USS--------------%%%----------------------------------##-----------
-----------------------------------------------------------------------%%%%%%-----------------------||--o----R---------------------------##-----------
---------------------------------------S--------------------------------||||------------------------||-%%%-----------------------------####-----------
---------------------------------------S--------------------------------||||----------------------oo||--|------------------------------####-----------
----------Q----------------------------S-----------------Q-Q%%%%%%------||||------#-----------------||--|-------------r--------------######-----------
-------------------------------#--------T-----TT-------------||||-------||||------#------------TT---||-o|---------%%%%%%--SS---------######-----------
-------------------------------#-#------T-----TT-------------||||-------||||------##-----------TT---||%%%%%--------|||||--SS---------######--------F--
-M-----------------#-----------#-#------T-----TT-------------||||-------||||------##--gg----y--TT---||-|||---------|||||--SS---------######--------#--
XXXXXXXXXXXXX--XXXXXXXXXX--XXXXXXXXXXXXXXXXX--XXXXXXXXXXXXXX-||||-------||||------XXXXXXXXXXXXXXXXXX||-|||-----%%%-|||||--XX--XXXXXXXXXXXXXXXXXXXXXXXX
XXXXXXXXXXXXX--XXXXXXXXXX--XXXXXXXXXXXXXXXXX--XXXXXXXXXXXXXX-||||-------||||------XXXXXXXXXXXXXXXXXX||-|||------|--|||||--XX--XXXXXXXXXXXXXXXXXXXXXXXX
