------------------------------------------------------------------------------------------------------------------------------------------------------
------------------------------------------------------------------------------------------------------------------------------------------------------
------------------------------------------------------------------------------------------------------------------------------------------------------
S-----SSSS-------------oo-----SSSSSSSSSS----------------------------------------SSSSSSSSSSSSSSSSSSSS----------SS-------S------------------------------
S-----------------------------SSSSSSSSSS--------------------------------------------------------------------------------------------------------------
S-----------------------------SSSSSSSSSS--------------------------------------------------------------------------------------------------------------
S---------------------SSSS----SSSSSSSSSS----------Q----------------------------------------------------------@---------S-----------SSSS------------SSS
S-----------------------------------------------------------------------------------------------------------------------------------------------------
S------------------------------------------------------------------------------------------------------------------SSS--------------------------------
S--------------------------------------------------------------------------------------S-----------------------------------------------SSSS-----------
S------------------%------%%%%SSSSSSSSSS----------Q-----------------------------SU------------------SU----!--!---------S--------------------------#---
S--------------------------|||SSSSSSSSSS--------------------------------------------TT---tt--------------------##---------------------------------#---
S--------------------------|||SSSSSSSSSS--------------------------------------------TT---tt--------------------##---------------------------------#---
S--M---------%%%%----------|||SSSSSSSSSS-------------gg----k-y--------gg-----------kTT--ktt---------------k----##--------k----ggg------------ggg--#---
XXXXXXXXXXX---||----%%%----|||XXXXXXXXXXX-XX-XX-XXXXXXXXXXXXXXXXXXXXXXXXXXXXXXXXXXXXXXXXXXXXXXXXXXXXXXXXXXXXXX-XX------XXXXXXXXXXX---------XXXXXXXXXXX
XXXXXXXXXXX---||----||-----|||XXXXXXXXXXX-XX-XX-XXXXXXXXXXXXXXXXXXXXXXXXXXXXXXXXXXXXXXXXXXXXXXXXXXXXXXXXXXXXXX-XX------XXXXXXXXXXX---------XXXXXXXXXXX
