------------------------------------------------------------------------------------------------------------------------------------------------------
------------------------------------------------------------------------------------------------------------------------------------------------------
------------------------------------------------------------------------------------------------------------------------------------------------------
----------SSSSSSSSSS----------------------------------------------------------------------------------------------------SSSSSSSSSSSSSSSSSS------------
------------------------------------------------------------------------------------------------------------------------------------------------------
---------------------------------------------------------------------R--------------------------------------------------------------------------------
---------------------------------------------------------------------------g---------------------------------@----------------------------------------
-----------------------------------------------------------------------%%%%%%-------------------------------------------------------------------------
------------------------------------------------------------------------||||------TT------------------------------------------------------------------
------------------------------------------------------------------------||||------TT-----------oooo---------------------------------------------------
---------------------------------------------------------tt------%%%----||||------TT----------------SU----!--!--------r----------------g##--#---------
--------------------------------------K------K---B-------tt-------|-----||||------TT-----T------------------------%%%%%%--SS-----------###--##--------
------------------------------TTTT---------------b-------tt-------|-----||||----T-TT-----T-------------------------|||||--SS---------g####--###------#
-M-----------------------ggg--TTTT---------------B---g-g-tt-------|-----||||----T-TT---k-T----------------k--------|||||--SS---------#####--####----##
XXXXXXXXXXX--XX--X--XXXXXXXXXXXXXXXXXXXXXXXXXXXXXXXXXXXXXXXX%%%%%-|-----||||----XXXXXXXXXX%%%%%%%-%%XXXXXXXXXX-%%%-|||||--XX--XXXXXXXXXXXX--XXXXXXXXXX
XXXXXXXXXXX--XX--X--XXXXXXXXXXXXXXXXXXXXXXXXXXXXXXXXXXXXXXXX-|||--|-----||||----XXXXXXXXXX||||||---|XXXXXXXXXX--|--|||||--XX--XXXXXXXXXXXX--XXXXXXXXXX
