------------------------------------------------------------------------------------------------------------------------------------------------------
------------------------------------------------------------------------------------------------------------------------------------------------------
------------------------------------------------------------------------------------------------------------------------------------------------------
----------------------------------------------------------------------SSSSSSSSSS--------------------SSSSSSSSSS--------------------SSSSSSSS--SSSSSSSSSS
-----------------------------------------g----------------------------------SSSS----------------------------------------------------------------------
----------------------------------------%%-------------------------------g--SSSS--------oo--oo--------------------------------------------------------
------------------------------S---------|-------------------------------SS------oo----------------------------?SSS-------SSS----S!--------------------
----------------------------------------|----oo--------------o---o---o--SS----------------------------------------------------------------------------
----------------------------------------|-------------------%%%-%%%-%%--SS-------------------------%--------------------------------------------------
----------------------------------------|----------------o---|---|---|--SC--g-g--SS-------------------------------------------------------------------
--------SU--------------------##--SSC---|--------------------|---|---|--SS--SSSS---------SSS---------------TT-SSSSS--------------S-----g##----TT------
----------------------------------------|--------------------|---|---|----------------------------------#--TT--------------------------###----TT------
----------------------------------------|--------------------|---|---|-----------------------%%%%------##--TT------------------------g####----TT------
--M-----------k-ggg---------------------|-----------k--------|---|-r-|------------------------||----kk-##--TT---K-----------gg-g-g---#####----TT------
XXXXXXXXXXXXXXXXXXXXXXXXX--XXXXX--XXXXXX|----%%%%--XXXXXXXXX%%%%%%%%%%XXXXXXXXXX--------------||----XXXXX--XX-XXXXXXXXXXXXXXXXXXXXXXXXXXXX--XXXX--XXXX
XXXXXXXXXXXXXXXXXXXXXXXXX--XXXXX--XXXXXX|-----||---XXXXXXXXX-|||||||||XXXXXXXXXX--------------||----XXXXX--XX-XXXXXXXXXXXXXXXXXXXXXXXXXXXX--XXXX--XXXX
