------------------------------------------------------------------------------------------------------------------------------------------------------
------------------------------------------------------------------------------------------------------------------------------------------------------
------------------------------------------------------------------------------------------------------------------------------------------------------
------------------------------------------------------------------------------------------SSSSSSSSSS--------------------------------------------------
------------------------------------------------------------------------------------------------------------------------------------------------------
-----------------------SSS--------------%%----------------------------------------------oo------------------------------------------------------------
----------------------------------------|---------Q-----------------------------oo----------------------SSQSSS--------US------------------------------
---------------------g------------------|----oo-------------------------------------------------------------------------------------------------------
--------------------%%%-----------------|--------------------------------------------------------------------------------------------g#---------------
--------------------||----SSS-----------|----------------------------------------SS-----------------------K---------E---------------g##---------------
-----SSS--------%%%%||------------------|---------Q--------------------------------------S--------------SSSSSS-----TT---------------###---------------
-----------------||-||-----------------T|-------------------------------------------------t------------------------TT--t-----------####---------------
-----------------||-||-----------------T|-------------------------------------------------t------------------------TT--t----------#####------------F--
-----------------||-||----oo---------kkT|------------gg----kgg-------ggg------------------t---------------------g--TT--t--kkk-----#####------------#--
XXXXXXXXXXX--%%%%||%||---%%%--XXXXXXXXXX|----%%%%-XXXXXXXXXXXXXXXXXXXXXXXXXXXXXX----------XXXXXXXXXXXXXXXXXXXXXXXXXXXXXXXXXXXXXXXXXXXXX--XXXXXXXXXXXXX
XXXXXXXXXXX---||-||-||----|---XXXXXXXXXX|-----||--XXXXXXXXXXXXXXXXXXXXXXXXXXXXXX----------XXXXXXXXXXXXXXXXXXXXXXXXXXXXXXXXXXXXXXXXXXXXX--XXXXXXXXXXXXX
