------------------------------------------------------------------------------------------------------------------------------------------------------
------------------------------------------------------------------------------------------------------------------------------------------------------
------------------------------------------------------------------------------------------------------------------------------------------------------
----------------------------------------------------------------------------------------------------------------------------------SSSSSSSS------------
-----------------------------------------------------------------------------------------------------------------------------------------------------o
-----------------------SSS------------------------------------g---------------------------------------------------------------------------------------
--------------------------------------------------------------SSSSS------------------1--------------------2---------------oo---%%%--------------------
---------------------g----------o----ooo----------------------------------------------------------------------------------SS----||--------------SSS---
--------------------%%%---------------------------------------------------------------------------------------------------------||----------oo--------
--------------------||----SSS----------------------------o----------------------------------------ooo---------------------------||--------------------
----------Q---------||----------------%%-------------------------------------------QQQQ-------------------2------------------SS-||-----g##--SS--------
--------------------||-----------------|T-----TT-----------------------------------------------TT--------------#----------------||-----###------------
--------------------||-----------------|T-----TT--------------TT-----t-------------------------TT--------------#----------------||---g####------------
---M---------------#||----oo---%%%%%%%-|T-----TT----k---------TT-----t--------------yy------y--TT-------y--y---#----ggg---------||---#####------------
XXXXXXXXXXXXX--XXXXX||---%%%----|||||--|XXXX--XXXX-XXXXXXXXXXXXXXXXXXXX----XXXXXXXXXXXXXXXXXXXXXXXXXXXXXXXXXXX-XXXXXXXXX%%-----%%%XXXXXXXX------------
XXXXXXXXXXXXX--XXXXX||----|-----|||||--|XXXX--XXXX-XXXXXXXXXXXXXXXXXXXX----XXXXXXXXXXXXXXXXXXXXXXXXXXXXXXXXXXX-XXXXXXXXX|-------||XXXXXXXX------------
