------------------------------------------------------------------------------------------------------------------------------------------------------
------------------------------------------------------------------------------------------------------------------------------------------------------
------------------------------------------------------------------------------------------------------------------------------------------------------
---------------------------------------------------oo-------------------------------------------------------------------------------------------------
--------------------------------------------?-----%%%%------------------------------------------------------------------------------------------------
---------------------------------------------------||----------------R---------------------------------------------k----------------------------------
---------------------------------------------------||---------------------SSCSS------------------------------RS---SSSSSSSSS---------------------------
----------------------------------------------r----||--SSS-------------------------------------------r------------------------------------------------
------------------------------------------%%%%%%---||-----------------------------------------------%%%%%%%-------------------------------------------
-------------------------------------------||||----||-----------------------------o--------o--------||||||--------------------------------------------
-------------------%--------------------%%-||||ooo-||------------%%%----QQQQ--QQ-------TT--------TT-||||||------------------------------------#LSS----
---------------------------------------T|--||||--r-||-------------|--------------------TT--------TT-||||||------------------------------------#-------
---------------------------------------T|%%%%%%%%%%||-------------|--------------------TT--------TT-||||||----TT--------------TT--------------#-------
---M---------%%%%--------------------kkT|-||||||||-||-------------|--------------------TT--------TT-||||||--ooTT--------------TT--k---------kk#-------
XXXXXXXXXXX---||----XXXXX--XXXXXXXXXXXXX|-||||||||-||-------%%%%%-|---XXXXXXXXXXXXXXXXXXXXXXXXXXXXXX||||||--%%XXXXXXXX------XXXXXXXX---XXXXXXXXXXXX---
XXXXXXXXXXX---||----XXXXX--XXXXXXXXXXXXX|-||||||||-||--------|||--|---XXXXXXXXXXXXXXXXXXXXXXXXXXXXXX||||||---|XXXXXXXX------XXXXXXXX---XXXXXXXXXXXX---
