------------------------------------------------------------------------------------------------------------------------------------------------------
------------------------------------------------------------------------------------------------------------------------------------------------------
------------------------------------------------------------------------------------------------------------------------------------------------------
----------SSSSSSSSSS------------------------------------------------------------SSSSSSSSSS------------------------------------------------------------
--------------------------------------------------?---------------------------------------------------------------------------------------------------
----------------------ooor----------------------------------------------------------------------------------------------------------------------------
---------------------%%%%%------------------------------------------------SS------------------------------------------------------!S------------------
----------------------|||-------o----ooo----------SS------------------------------------------------------TT--------------------oo-------------y------
----------------------|||--------------------------------------------o------------------------------------TT---------------------------------#SS--o---
----------------------|||----------------------------------------y---------------------S------------------TT--------------------------------##--------
--------SU@QQQQ-----%%%%%%%-----------%%-TT---SU-----------------##---SS-----SS-SU-----------------------SXXS---------r------TT---S------#--##--SC----
--------------------||||||-------------|-TT------------SSS------###-----------------TT---t------------------------%%%%%%-----TT---------##--##--------
-----------------g-#||||||--o----------|-TT--------------------####-----------------TT---t----------TT-------------|||||-----TT--------###--##---SSS--
--M-------------g#-#||||||-%%%-%%%%%%%-|-TT------k------------#####----------------kTT--kt---------gTT-------------|||||-y---TT-------####--##--------
XXXXXXXXXXXXXXXXXXXX||||||--|---|||||--|XXXXXXXXXX----------XXXXXXX-------------XXXXXXXXXX-XXXXXXXXXXXXXXXXXXX-%%%-|||||XXXXXXXXXXXXXXXXXXXXXX------XX
XXXXXXXXXXXXXXXXXXXX||||||--|---|||||--|XXXXXXXXXX----------XXXXXXX-------------XXXXXXXXXX-XXXXXXXXXXXXXXXXXXX--|--|||||XXXXXXXXXXXXXXXXXXXXXX------XX
