------------------------------------------------------------------------------------------------------------------------------------------------------
------------------------------------------------------------------------------------------------------------------------------------------------------
------------------------------------------------------------------------------------------------------------------------------------------------------
--------------------------------------------------------------------------------ooo-----------------SSSSSSSSSS----------------------------------------
--------------------------------------------------------------------------------%%%-------------------------------------------------------------------
---------------------------------------------------------------------------------|--------------------------------------------------------------------
------------------Q----------U--------------------------------------------SSCSS--|------------------------------------US-SSS----S!--------------------
-------------------------------------------------------------o---o---o-----------|--------------------------------------------------------------------
------------------------------------------------------------%%%-%%%-%%-----------|--------------------------------------------------------------------
-------------------------------------------------------------|---|---|-----------|---%%%%---------oo----------------E---------------------------------
------------------?---------##--QQQQ-----TT---SU---------tt--|---|---|--QQQQ--QQ-|----||---------------------T-----TT------------S------------#LSS----
--------------TT-------y-#####-------K-B-TT--------------tt--|---|---|----------%%%%%%||-------TT------TT----T-----TT--t----------------------#-------
--------------TT----y-######-----------b-TT--------------tt--|---|---|-----------||||-||-------TT------TT----T-----TT--t----------------------#-------
-M------------TT----######-------------b-TT------k---g-g-tt--|---|-r-|-----------||||-||----y--TT---g--TT----T--g--TT--t----gg-g-g----------kk#-------
XXXXXXXXXXXXXXXXXXXXXXXX------XXXXXXXXXXXXXXXXXXXXXXXXXXXXXX%%%%%%%%%%XXXXXXXXXX-||||-||%%XXXXXXXXXXXXXXXXXXXXXXXXXXXXXXXXXXXXXXXXXXXXXXXXXXXXXXXXX---
XXXXXXXXXXXXXXXXXXXXXXXX------XXXXXXXXXXXXXXXXXXXXXXXXXXXXXX-|||||||||XXXXXXXXXX-||||-||-|XXXXXXXXXXXXXXXXXXXXXXXXXXXXXXXXXXXXXXXXXXXXXXXXXXXXXXXXX---
