------------------------------------------------------------------------------------------------------------------------------------------------------
------------------------------------------------------------------------------------------------------------------------------------------------------
------------------------------------------------------------------------------------------------------------------------------------------------------
S-----SSSS--------------------SSSSSSSSSS------------------------------------------------------------SSSSSSSSSS--------------------SSSSSSSS------------
S-----------------------------SSSSSSSSSS--------------------------------------------------------------------------------------------------------------
S-----------------------------SSSSSSSSSS--------------------------------------------------------------------------------------------------------------
S-----------------------------SSSSSSSSSS----------------------------------SSCSS-----y--------------------------------------------------------------SSS
S---------------------------------------------------------------------------------#SSS----------------------------------------------------------------
S--------------------------------------------------------------------------------##-------------------------------------------------------------------
S-------------------------------------------------------------------------------###1------------g-----------------------------------------------------
S-------------------SS--------SSSSSSSSSS--------------S--------------#--QQQQ--QQ###-------------TT-----------T-------------------------g##--------#---
S--------------------K---TT---SSSSSSSSSS-----K---BTT----------------##----------###--SSS--------TT-----TT----T-------------------------###--------#---
S------------------------TT---SSSSSSSSSS---------bTT--------TT-----###----------###-------------TT-----TT----T-----------------------g####--------#---
S-------------k-ggg------TT---SSSSSSSSSS---------BTT------k-TT----####----------###-------------TT--g--TT----T-k----kkk--k----ggg----#####---ggg--#---
XXXXXXXXXXXXXXXXXXXXXXXXXXXXXXXXXXXXXXXXXXXXXXXXXXXXXXXXXXXXXXXXXXXXXXXXXXXXXXXXXXXXXX---XXXXXXXXXX-XXXXXXXXXXXXXXXXXXXXXXXXXXXXXXXXXXXXXX--XXXXXXXXXX
XXXXXXXXXXXXXXXXXXXXXXXXXXXXXXXXXXXXXXXXXXXXXXXXXXXXXXXXXXXXXXXXXXXXXXXXXXXXXXXXXXXXXX---XXXXXXXXXX-XXXXXXXXXXXXXXXXXXXXXXXXXXXXXXXXXXXXXX--XXXXXXXXXX
