------------------------------------------------------------------------------------------------------------------------------------------------------
------------------------------------------------------------------------------------------------------------------------------------------------------
------------------------------------------------------------------------------------------------------------------------------------------------------
------------------------------SSSSSSSSSS----------------------------------------SSSSSSSSSL------------------------------------------------------------
------------------------------------------------------------------------------------------------------------------------------------------------------
-----------------------SSS------------------------------------g-----------------------------oo--------------------------------------------------------
--------------------------------------------------Q-----------SSSSS-----------------oooooo--------------SSQSSS?SSS----------------%-------------------
---------------------g--------------------------------------------------------------------------------------------------------------------------------
--------------------%%%----------------S--------------------------------------------SSSSSS---------%------------------------------------SSS-----------
------------Q--?----||----SSS----------S---------------------------------1----------SSSSSS----------------K--------------------SSS--------------------
-------------------S||-----------------S----------Q-------------------T-------------------S-------------SSSSSSSSSSS-----%---------%%%%%-------#LSS----
--------------------||---------#--------------------------------------T----TT------------------------------------------------------|||--------#-------
--------------------||---------#-#----------------------------TT-----tT----TT----------------%%%%----------------------------------|||--------#-------
-M----------------K-||----oo---#-#-------------------gg----k--TT-----tT---kTT-----------------||----------------K----------------r-|||------kk#-------
XXXXXXXXXXXXXXXXXXXX||---%%%--XXXXXXXXXXX-XX-XX-XXXXXXXXXXXXXXXXXXXXXXXXXXXXXXXX---XXXXXXX----||----XXXXXXXXXXXXXXXXXXXX----XXXXXX%|||------XXXXXXX---
XXXXXXXXXXXXXXXXXXXX||----|---XXXXXXXXXXX-XX-XX-XXXXXXXXXXXXXXXXXXXXXXXXXXXXXXXX---XXXXXXX----||----XXXXXXXXXXXXXXXXXXXX----XXXXXX-|||------XXXXXXX---
