------------------------------------------------------------------------------------------------------------------------------------------------------
------------------------------------------------------------------------------------------------------------------------------------------------------
------------------------------------------------------------------------------------------------------------------------------------------------------
------------------------------SSSSSSSSSS----------------------------------------SSSSSSSSSS------------------------------------------------------------
------------------------------------------------------------------------------------------------------------------------------------------------------
----------------------------------------%%---------------------------R--------------------------------------------------------------------------------
----------------------!-----------------|---------------------------------SSCSS------------SSS!--------------R------------oo---%%%-------##--QQQQ-----
----------------------------------------|----oo----------------------------------------------------------r----------------SS----||-------##-----------
---------------------------------------S|-----------------------------------------------------------%%%%%%%---------------------||-----####-----------
---------------------------------------S|----------------------------------------------S------------||||||----------------------||-----####----y------
----------------!---S@S!S--------------S|----------------tt------%%%----QQQQ--QQSU------------C-----||||||-------------------SS-||---######-Q?SSQQQ---
-------------------------------#--------|----------------tt-------|-----------------TT---t----------||||||----------------------||---######-----------
----------------------------tt-#-#------|----------------tt-------|-----------------TT---t----------||||||---------B------------||---######-----------
-M-------------------g------tt-#-#------|------------g-g-tt-------|----------------kTT--kt-----g-g--||||||--oo-----b------------||---######-----------
XXXXXXXXXXXXXXXXXXXXXXXXXXXXXXXXXXXXXXXX|----%%%%-XXXXXXXXXX%%%%%-|---XXXXXXXXXXXXXXXXXXXXXXXXXXXXXX||||||--%%XXXXXXXXXX%%-----%%%XXXXXXXXXXXX--XXXXXX
XXXXXXXXXXXXXXXXXXXXXXXXXXXXXXXXXXXXXXXX|-----||--XXXXXXXXXX-|||--|---XXXXXXXXXXXXXXXXXXXXXXXXXXXXXX||||||---|XXXXXXXXXX|-------||XXXXXXXXXXXX--XXXXXX
