------------------------------------------------------------------------------------------------------------------------------------------------------
------------------------------------------------------------------------------------------------------------------------------------------------------
------------------------------------------------------------------------------------------------------------------------------------------------------
--------------------------------------------------------------------------------SSSSSSSSSL------------------------------------------------------------
--------------------------------------------?---------------------------------------------------------------------------------------------------------
--------------------------------------------------------------------------------------------oo--------oo----------------------------------------------
--------------------S---------------------------------------------------SSSSS-------oooooo--------------------?SSS------------------------------------
---------------------------TT-----------------r-----------------------------------------------------------------------------------oo------------------
---------------------------TT-------------%%%%%%---------B--------------------------SSSSSS---------%--------------------------------------------------
---------------------------XX--------------||||----------b--------------------------SSSSSS------------------------------SS-?Q-------------------------
-----------------------TT--------------T%%-||||ooo-----SS#CS-----------------2------------SS------------------SSSSS------------------------Q----------
-----------------------TT--------------T|--||||--r-------------------T-----TT-------------------------------------------------------------------------
-----------------------TT--------------T|%%%%%%%%%---------K-B-------Tt----TT--T-------------%%%%-----------tt-----------------y-------------------F--
-M--------k---ggg---k--TT-------gg-----T|-||||||||-----------b-------Tt----TT--T--------------||------ggg---tt--K----------SSSSS-------------------#--
XXXXXXXXXXXXXXXXXXXXXXXXXXXXXXXXXXXXXXXX|-||||||||XXXXXXXXXXXXXXXX--XXXXXXXXXXXX---XXXXXXX----||----XXXXXXXXXXXXXXXXXXXX-------XX-XXXXXXXXXXXXXXXXXXXX
XXXXXXXXXXXXXXXXXXXXXXXXXXXXXXXXXXXXXXXX|-||||||||XXXXXXXXXXXXXXXX--XXXXXXXXXXXX---XXXXXXX----||----XXXXXXXXXXXXXXXXXXXX-------XX-XXXXXXXXXXXXXXXXXXXX
