------------------------------------------------------------------------------------------------------------------------------------------------------
------------------------------------------------------------------------------------------------------------------------------------------------------
------------------------------------------------------------------------------------------------------------------------------------------------------
--------------------SSSSSSSSSS----------------------------------------SSSSSSSSSS--------------------SSSSSSSSSS----------------------------------------
--------------------SSSSSSSSSS------------------------------------------------------------------------------------------------------------------------
--------------------SSSSSSSSSS----------%%-------------------------------------------------------------------------k----------------------------------
--------------------SSSSSSSSSS----------|--------------------------------------------SUS----------------------S---SSSSSSSS----------------------------
----------------------------------------|----oo-------------------------------TT----------------------------------------------------------------------
-----------------g----------------------|----------------TT-------------------TT----------------------------------------------------------------------
-----------------#----------------------|----------TT----TT-------------------TT---------------oooo------------------------TT-------------------------
----------S-----##----SSSSSS?-----------|----------TT----XX-----------------SCTT----#####------------------TT--------------TT-------------------------
---------------###----SSSSS------------T|----------TT-------------------TT----TT----#-------------------#--TT-----------t--TT--------TT---------------
--------------####----SSSSS------------T|----------TT-------------------TT----TT---K#------------------##--TT-TT--------t--TT--------TT------------F--
-M-----------#####---------ooo-------kkT|----------TT--------y----------TT---kTT----#---------------kk-##--TT-TT--------t--TT--------TT------------#--
XXXXXXXXXXXXXXXXXXXX-XXXXXXXXXXXXXXXXXXX|----%%%%-XXXXXXXXXXXXXXXXXXXXXXXXXXXXXXXXXXXXX---%%%%%%%-%%XXXXX--XX-XXXXXXXX--XXXXXXXXXXXXXXXXXXXXXXXXXXXXXX
XXXXXXXXXXXXXXXXXXXX-XXXXXXXXXXXXXXXXXXX|-----||--XXXXXXXXXXXXXXXXXXXXXXXXXXXXXXXXXXXXX---||||||---|XXXXX--XX-XXXXXXXX--XXXXXXXXXXXXXXXXXXXXXXXXXXXXXX
