------------------------------------------------------------------------------------------------------------------------------------------------------
------------------------------------------------------------------------------------------------------------------------------------------------------
------------------------------------------------------------------------------------------------------------------------------------------------------
--------------------------------oo--------------------------------------------------------------------------------------SSS-----SSSSSSSSSS------------
---------------------------------------g--------------------------------------------------------------------------------------------------------------
----------------------ooor---------%%%%%ooooo-----------------g-------------------------oo-------------------------k----------------------------------
---------------------%%%%%----------||||----------------------SSSSS-------------oo--------SSS------%---------RS---SSSSSSUS----------------------------
----------------------|||-----------||||--------SS---------------------------------------------------r------------------------------------------------
-----------------%%%--|||-----------||||-SSSS------------B---------------------g--------------------%%%%%%%-----------------SSS-----------------------
------------------||--|||-----%%%%%-||||-----------------b-----------------------SSS----------------||||||--------------------------------------------
------------------||%%%%%%%----|||--||||---------------SS#CS-----------------S@S---------S--%%%-----||||||--------------SSS------------g##------------
-------------%%%%%||||||||-----|||--||||-----------------------------------------------------|------||||||-----------------------------###------------
--------------|||-||||||||--o--|||--||||----%%%%%----------K--TT-----t-----------------------|------||||||----TT---------------------g####---------F--
-M------------|||-||||||||-%%%-|||--||||-----|||--------------TT-----t-----------------------|------||||||--ooTT---------------------#####---------#--
XXXXXXXXXXX---|||-||||||||--|--|||--||||%%---|||--XXXXXXXXXXXXXXXXXXXX-XXXXXXXXX-------------|------||||||--%%XXXXXXXX--XXX------XXXXXXXXX--XXXXXXXXXX
XXXXXXXXXXX---|||-||||||||--|--|||--|||||----|||--XXXXXXXXXXXXXXXXXXXX-XXXXXXXXX-------------|------||||||---|XXXXXXXX--XXX------XXXXXXXXX--XXXXXXXXXX
