------------------------------------------------------------------------------------------------------------------------------------------------------
------------------------------------------------------------------------------------------------------------------------------------------------------
------------------------------------------------------------------------------------------------------------------------------------------------------
--------------------------------------------------------------------------------------------------------------SS-------S------------------------------
--------------------------------------------------?---------------------------------------------------------------------------------------------------
------------------------------------------------------------------------------------------------------------------------------------------------------
-----------------------------U------------------------------------------------------------SSS------%----SSQSSS---------S-----------------##-----------
--------------------------------------------------SS-------------------------------------------------------------------------------------##-----------
-------------------------------------------------------------------------------------------------------------------SSS-------SSS-------####-----------
------------Q--?-------------------oo------------------------------------1--------o-----------------------K----------------------------####-----------
-------------------S--------##----o--o--------------------------------T----------------TT---%%%---------SSSSSS---------Sr------------######-----------
-----------------------y-#####-------------------------SSS------------T----TT----------TT----|-----------------##-------%%%%%%-------######-----------
--------------------y-######------------------------------------------T----TT----------TT----|-----------------##-------|||||--------######--------F--
-M----------------K-######------------------y-y--------------y--------T---kTT----------TT----|-----------------##-------|||||--------######--------#--
XXXXXXXXXXXXXXXXXXXXXXXX------XXXXXXXXXXXXXXXXXXXX----------XXXXXXXXXXXXXXXXXXXXXXXXXXXXXX---|------XXXXXXXXXX-XX------X|||||-----XXXXXXXXXXXXXXXXXXXX
XXXXXXXXXXXXXXXXXXXXXXXX------XXXXXXXXXXXXXXXXXXXX----------XXXXXXXXXXXXXXXXXXXXXXXXXXXXXX---|------XXXXXXXXXX-XX------X|||||-----XXXXXXXXXXXXXXXXXXXX
