------------------------------------------------------------------------------------------------------------------------------------------------------
------------------------------------------------------------------------------------------------------------------------------------------------------
------------------------------------------------------------------------------------------------------------------------------------------------------
----------------------------------------------------------------------------------------------------SSSSSSSSSSSS-------SSSS-----SS--------------------
------------------------------------------------------------------------------------------------------------------------------------------------------
----------------------------------------ooooo---------------------------------------------------------------------------------------------------------
---------------------LSSS---------------------------------------------------SSSS-----SUS-------------------------------SUS--------SS------------------
------------------------------------------------SS----------------------------------------------------------------------------------------------------
-----------------------------------------SSSS----------------------------------------------------------------------SSS------SSS-----------------------
-----------------------------------oo----------------------------------------K------------------g-----------------------------------------------------
---------------------2-----#------o--o-----------------ooo-----------------SSSSS----#####-------TT-----------T---------SSSS-------SS--------#---------
---------------------------#------------------------------------------T-------------#-----------TT-----TT----T-##-----------------K---#----B##--------
---------------------------##---------------%%%%%---------------------T------------K#-----------TT-----TT----T-##---------------------#----b###------#
--------------k-ggg---kk---##----------------|||-------------y--------T-------------#-----------TT--g--TT----T-##---------------------#----B####----##
XXXXXXXXXXXXXXXXXXXXXXXXXXXXXXXXXXXXXXXX%%---|||----XXXXXXXXXXXXXXXXXXXXXXXXXXXXXXXXXXX---XXXXXXXXX-XXXXXXXXXX-XX------XXXX------XXXXXXXXXXXXXXXXXXXXX
XXXXXXXXXXXXXXXXXXXXXXXXXXXXXXXXXXXXXXXX|----|||----XXXXXXXXXXXXXXXXXXXXXXXXXXXXXXXXXXX---XXXXXXXXX-XXXXXXXXXX-XX------XXXX------XXXXXXXXXXXXXXXXXXXXX
