------------------------------------------------------------------------------------------------------------------------------------------------------
------------------------------------------------------------------------------------------------------------------------------------------------------
------------------------------------------------------------------------------------------------------------------------------------------------------
------------------------------------------------------------SSSSSSSSSS--------------------------------------------------------------------------------
------------------------------------------------------------SSSS--SSSS--------------------------------------------------------------------------------
------------------------------------------------------------SSSS--SSSS--------------------------------------------------------------------------------
---------------------LSSS-------------------------------------SS---S--------SSSS--------------------------2----------------------------US----QQQQ-----
--------------------------------------------------------------SS---S----------------------------------------------------------------------------------
--------------------------------------------------------------SS---S--------------TT------------------------------------------SSS---------------------
------------------------------------------------------------ooSS---SoU-------K----TT----------------o--------------------------------SS--------y------
----------------%%%%-2-----#-----------T---------------ooo--SSSS---SSS-----SSSSS--TT----------------------2-------------%------------------SQ?SSQQQ---
-----------------||--------#-----------TT-----TT----------------------T-----------TT-----T------------------------------------------------------------
-----------------||--------##----------TT-----TT----------------------T---------T-TT-----T-------B-----------------B--------------TT------------------
-----------------||---kk---##---gg-----TT-----TT------------k--g-g----T---------T-TT---k-T-------b------y--y-------b-------------rTT------------------
XXXXXXXXXXX--%%%%||%XXXXXXXXXXXXXXXXXXXXXXXX--XXXX--XXXXXXXXXXXXXXXXXXXXXXXXXXXXXXXXXXXXXXXXXXXXXXXXXXXXXXXXXXXXXXXXXXXX----XXXXXXXXXXXX-X-XXX--XXXXXX
XXXXXXXXXXX---||-||-XXXXXXXXXXXXXXXXXXXXXXXX--XXXX--XXXXXXXXXXXXXXXXXXXXXXXXXXXXXXXXXXXXXXXXXXXXXXXXXXXXXXXXXXXXXXXXXXXX----XXXXXXXXXXXX-X-XXX--XXXXXX
