------------------------------------------------------------------------------------------------------------------------------------------------------
------------------------------------------------------------------------------------------------------------------------------------------------------
------------------------------------------------------------------------------------------------------------------------------------------------------
------------------------------------------------------------------------------------------------------------------------------------------------------
--------------------------------------------?---------------------------------------------------------------------------------------------------------
--------------------------------------------------------------g----------------------------------------------------k----------------------------------
------------------SC------------------------------------------SSSSS--------g---------SSSS-----------------2---S---SSSSSSSS---------SSSS-----SS--------
----------------------------------------------r------------------------%%%%%%-------------------------------------------------------------------------
------------------------------------------%%%%%%------------------------||||--------------------------------------------------------------------------
-------------------------------------------||||-------------------------||||------------------------o----------------------TT----------SSSS-----------
--------------TT---2------------QQQQ----%%-||||ooo-------tt-------------||||----Q----------------tt-------2----------------TT---------------SS--------
--------------TT---------------------K-B|--||||--r-------tt-------------||||--------------T------tt---------------------t--TT---------------------#-TT
--------------TT-----------------------b|%%%%%%%%%-------tt---TT-----t--||||--------------T------tt-----------TT--------t--TT--------------------##-TT
-M------------TT-----------------------b|-||||||||---g-g-tt---TT-----t--||||-----ggg------T------tt-----y--y--TT--------t--TT-------------------###-TT
XXXXXXXXXXXXXXXXXXXXXXXXX--XXXXXXXXXXXXX|-||||||||XXXXXXXXXXXXXXXXXXXX--||||----XXXXX----XXXXXXXXXXXXXXXXXXXXXXXXXXXXX--XXXXXXXXXX---------XXXXXXXX-XX
XXXXXXXXXXXXXXXXXXXXXXXXX--XXXXXXXXXXXXX|-||||||||XXXXXXXXXXXXXXXXXXXX--||||----XXXXX----XXXXXXXXXXXXXXXXXXXXXXXXXXXXX--XXXXXXXXXX---------XXXXXXXX-XX
