------------------------------------------------------------------------------------------------------------------------------------------------------
------------------------------------------------------------------------------------------------------------------------------------------------------
------------------------------------------------------------------------------------------------------------------------------------------------------
--------------------SSSSSSSSSS------------------------------------------------------------SSSSSSSSSS--------------------------------------------------
--------------------SSSSSSSSSS------------------------------------------------------------------------------------------------------------------------
--------------------SSSSSSSSSS-------------------------oooo----------R--------------------------------------------------------------------------------
--------------------SSSSSSSSSS-------------------------%%%%----------------1-------USS--------------------------------------------%-------------------
--------------------------------------------------------||-------------------------------------------------------SSS----------------------------------
-----------------%%%------------------------------------||------------------------------------------------------------------------------SSS-----------
------------------||------------------------------SSS---||-----------------ggg------------------------------------------SS-?Q-------------------------
------------------||--SSSSSS?--TT-----------------------||-------%%%--#########---#-----------------------------------------------%%%%%---------------
-------------%%%%%||--SSSSS----TT---------------------U-||--------|-----------#---#-------t-----------------g----------------------|||----------------
--------------|||-||--SSSSS----TT-----------------------||--------|-----------#---##------t-----------------TT-----------------y---|||-------------F--
-M------------|||-||-------ooogTT-----------y-y---------||--------|-----------#---##--gg--t-----------------TT-------------SSSSS---|||-------------#--
XXXXXXXXXXX---|||-||-XXXXXXXXXXXXXXXXX--XXXXXXXXXX----%%%%%-%%%%%-|-----------X---XXXXXXXXXXXXXXXXXX--XXXXXXXX%%%%----%%-------XX-%|||------XXXXXXXXXX
XXXXXXXXXXX---|||-||-XXXXXXXXXXXXXXXXX--XXXXXXXXXX-----|||---|||--|-----------X---XXXXXXXXXXXXXXXXXX--XXXXXXXX|||------|-------XX--|||------XXXXXXXXXX
