------------------------------------------------------------------------------------------------------------------------------------------------------
------------------------------------------------------------------------------------------------------------------------------------------------------
------------------------------------------------------------------------------------------------------------------------------------------------------
-----------------------oo---------------SSSSSSSSSS----------------------------------------------------------------------------------------------------
------------------------------------------------------------------------------------------------------------------------------------------------------
---------------------------------------------------------------------R--------------------------------------------------------------------------------
----------------------SSSS---------------oooo---------------------------------------y-----SSS------%------------------------------!S------------------
----------------------------------------------------------------------------------#SSS--------------------TT----oooo----------------------------------
-----------------------------------------SSSS-U----------B------------o----------##-----------------------TT------------------SSS---------------------
----------------------------------------oS--SoS----------b----------------------###1----------------------TT------------------------------------------
--------------------------%%%%---------TSS--SSS--------SS#CS-----%%%------------###---------%%%----------SXXS-T---------%---------S------#----#LSS----
---------------------------|||---------T--------------------------|-----------#-###--SSS-----|----------------T-------------------------##----#-------
---------------------------|||---------T-------------------K------|----------##-###----------|------TT--------T------------------------###----#-------
-M--------k---ggg----------|||--gg-----T--kk----------------------|-------------###----------|------TT--------T---y--------------r----####--kk#-------
XXXXXXXXXXXXXXXXXXXX%%%----|||XXXXXXXXXXXXXXXXXXXXXXXXXXXXXX%%%%%-|---XXXXXXXXXXXXXXXX---X---|------XXXXXXXXXXXXXXXXXXXX----XXXXXXXXXXXXXXXXXXXXXXX---
XXXXXXXXXXXXXXXXXXXX||-----|||XXXXXXXXXXXXXXXXXXXXXXXXXXXXXX-|||--|---XXXXXXXXXXXXXXXX---X---|------XXXXXXXXXXXXXXXXXXXX----XXXXXXXXXXXXXXXXXXXXXXX---
