------------------------------------------------------------------------------------------------------------------------------------------------------
------------------------------------------------------------------------------------------------------------------------------------------------------
------------------------------------------------------------------------------------------------------------------------------------------------------
--------------------SSSSSSSSSS--------------------------------------------------SSSSSSSSSS------------------------------SSS-----SS--------------------
--------------------SSSSSSSSSS------------------------------------------------------------------------------------------------------------------------
--------------------SSSSSSSSSS----------%%-------------oooo-------------------------------------------------------------------------------------------
--------------------SSSSSSSSSS----------|--------------%%%%-----------------------------------------------------------USUS--------SS------------------
----------------------------------------|----oo---------||--------------------------------------------------------------------------------------------
----------------------------------------|---------------||------------------------------------------------------------------SSS-----------------------
----------------------------------------|---------SSS---||---------------1-------------S----------------------------E---------------------------------
----------------------SSSSSS?----------T|---------------||------------T---------SU---------------------------------TT---SSS-------SS----------#LSS----
-----------------K----SSSSS------------T|-------------U-||------------T----TT-------TT---t------------------g------TT--t----------K---#----B--#-------
------------B---------SSSSS------------T|---------------||------------T----TT-------TT---t-------B----------TT-----TT--t--------------#----b--#-------
-M----------b--------------ooo--gg-----T|---------------||---y--------T---kTT------kTT--kt-------b----------TT--g--TT--t--------------#----Bkk#-------
XXXXXXXXXXXXXXXXXXXX-XXXXXXXXXXXXXXXXXXX|----%%%%-----%%%%%-XXXXXXXXXXXXXXXXXXXXXXXXXXXXXXXXXXXXXXXX--XXXXXXXXXXXXXXXXXXXXX------XXXXXXXXXXXXXXXXXX---
XXXXXXXXXXXXXXXXXXXX-XXXXXXXXXXXXXXXXXXX|-----||-------|||--XXXXXXXXXXXXXXXXXXXXXXXXXXXXXXXXXXXXXXXX--XXXXXXXXXXXXXXXXXXXXX------XXXXXXXXXXXXXXXXXX---
