------------------------------------------------------------------------------------------------------------------------------------------------------
------------------------------------------------------------------------------------------------------------------------------------------------------
------------------------------------------------------------------------------------------------------------------------------------------------------
S-----SSSS--------------------SSSSSSSSSS----------------------------------------SSSSSSSSSS--------------------------------------------------SSSSSSSSSS
S-----------------------------SSSSSSSSSS--------------------------------------------------------------------------------------------------------------
S---------------------ooor----SSSSSSSSSSooooo---------------------------------------------------------------------------------------------------------
S--------------------%%%%%----SSSSSSSSSS--------------------------SSoo---------------------------------------R-----oo----SSS----S!-----US-------------
S---------------------|||-----------------------SS---------------------------------------------------r------------------------------------------------
S---------------------|||----------------SSSS------------TT-----------o-----------------------------%%%%%%%-------------------------------------------
S---------------------|||--------------------------TT----TT----------------------------S------------||||||---------------------------SS---------------
S---------------!---%%%%%%%---SSSSSSSSSS-----------TT----XX-%%%%%%--------------SU---------------tt-||||||-----%%%%--%%%---------S---------S--TT------
S-------------------||||||----SSSSSSSSSS-----------TT--------||||-------------#-----TT---tT------tt-||||||------||----||----------------------TT------
S-------------------||||||--o-SSSSSSSSSS----%%%%%--TT--------||||------------##-----TT---tT------tt-||||||------||----||----------TT----------TT------
S-------------------||||||-%%%SSSSSSSSSS-----|||---TT--------||||------------------kTT--ktT------tt-||||||--ooo-||----||----gg-g-gTT----------TT------
XXXXXXXXXXXXXXXXXXXX||||||--|-XXXXXXXXXX%%---|||--XXXXXXXXXX-||||-----XXXXXXXXXXXXXXXXXXXXXXXXXXXXXX||||||--%%%-||----||XXXXXXXXXXXXXXXX-X-XXXXX--XXXX
XXXXXXXXXXXXXXXXXXXX||||||--|-XXXXXXXXXX|----|||--XXXXXXXXXX-||||-----XXXXXXXXXXXXXXXXXXXXXXXXXXXXXX||||||---|--||----||XXXXXXXXXXXXXXXX-X-XXXXX--XXXX
