------------------------------------------------------------------------------------------------------------------------------------------------------
------------------------------------------------------------------------------------------------------------------------------------------------------
------------------------------------------------------------------------------------------------------------------------------------------------------
------------------------------SSSSSSSSSS--------------------SSSSSSSSSS----------------------------------------SSSSSSSSSSSSS-----SS--------------------
------------------------------SSSSSSSSSS--------------------SSSS--SSSS---o----------------------------------------------------------------------------
------------------------------SSSSSSSSSSooooo---------------SSSS--SSSS--%%%---------------------------------------------------------------------k-----
-----------------------------USSSSSSSSSS----------------------SS---S-----|--o--------SSSS-SSS------%--------------------US---------------##----SQS--SQ
------------------------------------------------SS------------SS---S-----|--SSSS--------------------------TT-----------------------------##-----------
-----------------------------------------SSSS-----------------SS---S--%--|--------------------------------TT----------------SSS--------####-----------
------------------------------------------------------------ooSS---SoU---|--------------------------------TT---------------------------####-----------
-------------------%--------##SSSSSSSSSS---------------ooo--SSSS---SSS---|------Q-----------%%%----------SXXS-T---------SSS----------######----SQS--S?
-----------------------y-#####SSSSSSSSSS---------------------------------|-------------------|----------------T----------------------######-----------
--------------------y-######--SSSSSSSSSS----%%%%%------------------------|-----%-------------|------TT--------T----TT----------------######-----------
-M-----------%%%%---######----SSSSSSSSSS-----|||------------k--g-g-------|-------ggg---------|------TT--------T--g-TT----------------######--k------gg
XXXXXXXXXXX---||----XXXX------XXXXXXXXXX%%---|||----XXXXXXXXXXXXXXXXXX%%%%%%----XXXXX----X---|------XXXXXXXXXXXXXXXXXXXXXXX------XXXXXXXXXXXXXXXXXXXXX
XXXXXXXXXXX---||----XXXX------XXXXXXXXXX|----|||----XXXXXXXXXXXXXXXXXX|||||-----XXXXX----X---|------XXXXXXXXXXXXXXXXXXXXXXX------XXXXXXXXXXXXXXXXXXXXX
