------------------------------------------------------------------------------------------------------------------------------------------------------
------------------------------------------------------------------------------------------------------------------------------------------------------
------------------------------------------------------------------------------------------------------------------------------------------------------
S-----SSSS----------------------------------------------------------------------------------------------------SS-------S------------------------------
S-----------------------------------------------------------------------------------------------------------------------------------------------------
S----------------------SSS--------------------------------------------------------------------------oo------------------------------------------------
S-----------------SC------------------------------------------USSS----------------------------------%%%----------------S--SSC-----!S------------------
S--------------------g----------o----ooo------------------------------------------------------------||--o----R----------------------------------------
S-------------------%%%-----------------------------------------------o-----------TT----------------||-%%%---------SSS--------------------------------
S-------------------||----SSS-----------------------------------------------------TT--------------oo||--|-----------------SSS-------------------------
S-------------TT---2||----------------%%-TT---SU-------------S-----TT-------------TT----------------||--|--------------S----------S------#------------
S-------------TT----||-----------------|-TT---------K--------------TT---------#---TT-----T-----TT---||-o|------##-----------------------##---------#--
S-------------TT----||-----------------|-TT------------------------TT--------##-T-TT-----T-----TT---||%%%%%----##----------------------###-----K---#--
S--M----------TT----||----oo---%%%%%%%-|-TT------k---------g-ggg---TT-----------T-TT---k-T--y--TT---||-|||-----##----------------#----####---------#--
XXXXXXXXXXXXXXXXXXXX||---%%%----|||||--|XXXXXXXXXXXXXXXXXXXXXXXXXXXXXXXXXXXXXXXXXXXXXXXXXXXXXXXXXXXX||-|||-----XX------XX----XXXXXXXXXXXXXXXXXXXX--XXX
XXXXXXXXXXXXXXXXXXXX||----|-----|||||--|XXXXXXXXXXXXXXXXXXXXXXXXXXXXXXXXXXXXXXXXXXXXXXXXXXXXXXXXXXXX||-|||-----XX------XX----XXXXXXXXXXXXXXXXXXXX--XXX
