------------------------------------------------------------------------------------------------------------------------------------------------------
------------------------------------------------------------------------------------------------------------------------------------------------------
------------------------------------------------------------------------------------------------------------------------------------------------------
S-----SSSS----------------------------------------SSSSSSS---SSSSSSSSSS----------SSSSSSSSSLSSSSSSSSSS--------------------------------------------------
S-----------------------------------------------------------SSSS--SSSS--------------------------------------------------------------------------------
S---------------------ooor--------------%%------------------SSSS--SSSS--------------------------------------------------------------------------------
S-----------------SC-%%%%%--------------|---------QQ----------SS---S-------g--------oooooo------------------------------SS------------------SS--------
S---------------------|||---------------|----oo---------------SS---S---%%%%%%-------------------------------------------------------------------------
S---------------------|||---------------|------------------S--SS---S----||||--------SSSSSS-------------------------------------------g#---------------
S---------------------|||---------------|-------------------ooSS---SoU--||||--------SSSSSS---------------------------------TT-------g##---------------
S-------------TT---2%%%%%%%-------------|---------QQ--QQQ---SSSS---SSS--||||--------------------------%%%%%%---------------TT-------###-----SS--------
S-------------TT----||||||------------tt|-------------------------------||||---------------------------||||----#--------t--TT------####-----------#-TT
S-------------TT----||||||--o---------tt|-------------------------------||||---------------------------||||----#--------t--TT-----#####----------##-TT
S--M----------TT----||||||-%%%--------tt|-------------------k--g-g------||||--------------------g-g----||||----#----ggg-t--TT-----#####---------###-TT
XXXXXXXXXXXXXXXXXXXX||||||--|-XXXXXXXXXX|----%%%%-XXXXXXX---XXXXXXXXXX--||||-------XXXXXXXXXXXXXXXXX%%-||||-%%-XXXXXXXXXXXXXXXXXXXXXXXX--XXXXXXXXXX-XX
XXXXXXXXXXXXXXXXXXXX||||||--|-XXXXXXXXXX|-----||--XXXXXXX---XXXXXXXXXX--||||-------XXXXXXXXXXXXXXXXX|--||||--|-XXXXXXXXXXXXXXXXXXXXXXXX--XXXXXXXXXX-XX
