------------------------------------------------------------------------------------------------------------------------------------------------------
------------------------------------------------------------------------------------------------------------------------------------------------------
------------------------------------------------------------------------------------------------------------------------------------------------------
--------------------------------------------------------------------------------------------------------------SSSSSSSSSS----------SSSSSSSSSS----------
------------------------------------------------------------------------------------------------------------------------------------------------------
----------------------------------------%%------------------------------------------------------------------------------------------------------------
------------------SC-LSSS---------------|--------------------------------------------SSSS---------------SSQSSS------------SSC----------------QQQQ-----
----------------------------------------|----oo--------------o---o---o--------------------------------------------------------------------------------
----------------------------------------|-------------------%%%-%%%-%%o-------------------------------------------------------------------------------
----------------------------------------|--------------------|---|---|--------------------------g---------K---------------SSS------------------y------
--------------TT---2-2-----#------------|----------------tt--|---|---|----------Q---------------TT------SSSSSST-----------------------------Q?SSQQQ---
--------------TT-----------#------------|----------------tt--|---|---|--------#-----------------TT------------T---------------------------TT----------
--------------TT-----------##-----------|----------------tt--|---|---|-------##-----------------TT------------T----TT--------------tt-----TT----------
-M------------TT------kk---##-----k-k---|------------g-g-tt--|---|-r-|-----------ggg------------TT------------T--g-TT------------#-tt----kTT----------
XXXXXXXXXXXXXXXXXXXXXXXXXXXXXXXXXXXXXXX-|----%%%%-XXXXXXXXXX%%%%%%%%%%XXXXXXXXXXXXXXX----XXXXXXXXXX-XXXXXXXXXXXXXXXXXXXXX----XXXXXXXXXXXXXXXXX--XXXXXX
XXXXXXXXXXXXXXXXXXXXXXXXXXXXXXXXXXXXXXX-|-----||--XXXXXXXXXX-|||||||||XXXXXXXXXXXXXXX----XXXXXXXXXX-XXXXXXXXXXXXXXXXXXXXX----XXXXXXXXXXXXXXXXX--XXXXXX
