------------------------------------------------------------------------------------------------------------------------------------------------------
------------------------------------------------------------------------------------------------------------------------------------------------------
------------------------------------------------------------------------------------------------------------------------------------------------------
---------------------------------------------------oo---------------------------SSSSSSSSSL------------------------------------------------------------
--------------------------------------------------%%%%------------------------------------------------------------------------------------------------
----------------------------------------%%---------||---------------------------------------oo--------------------------------------------------------
----------------------------------------|----------||-------------------------------oooooo-------------------------------SSS----S!!S---------QQQQ-----
----------------------------------------|----oo----||--SSS--------------------------------------------------------------------------------------------
----------------------------------------|----------||-------------------------------SSSSSS---------%--------------------------------------------------
----------------------------------------|----------||-----------1-------------------SSSSSS-----------------------------------------------------y------
-------------------%SS------------------|----------||-------------------------------------S--------------------------------------SS------#--Q?SSQQQ---
---------------------K---TT-----------tt|----------||-----------------------------------------------------------------------------------##------------
-------------------------TT-----------tt|---------%||----------------------------------------%%%%---------*--------B-------------------###------------
-M-----------%%%%--------TT-----------tt|----------||-----------------------------------------||----gg----*--------b--------gg-g-g----####------------
XXXXXXXXXXX---||----XXXXXXXXXXXXXXXXXXXX|----%%%%--||-------XXXXXXXXX-X----XXXXX---XXXXXXX----||----XXXXXXXXX-XXXXXXXXXXXXXXXXXXXXXXXXXXXXXXXX--XXXXXX
XXXXXXXXXXX---||----XXXXXXXXXXXXXXXXXXXX|-----||---||-------XXXXXXXXX-X----XXXXX---XXXXXXX----||----XXXXXXXXX-XXXXXXXXXXXXXXXXXXXXXXXXXXXXXXXX--XXXXXX
