------------------------------------------------------------------------------------------------------------------------------------------------------
------------------------------------------------------------------------------------------------------------------------------------------------------
------------------------------------------------------------------------------------------------------------------------------------------------------
--------------------------------------------------SSSSSSS---------------------------------------------------------------------------------------------
-----------------------------------------g------------------------------------------------------------------------------------------------------------
----------------------ooor--------------%%---------------------------R------------g-------------------------------------------------------------------
---------------------%%%%%--------------|---------QQ----------------------------SSSSSSSS---------------------R-----oo---------------------------------
----------------------|||---------------|----oo------------------------------------------------------r------------------------------------------------
----------------------|||---------------|------------------S----------------------------------------%%%%%%%-------------------------------------------
----------------------|||---------------|-----------------------------------------------------------||||||--------------SS-?Q-------------------------
----------------%%%%%%%%%%%-----QQQQ----|---------QQ--QQQ--------%%%--------------------------------||||||-----%%%%--%%%------------------------------
-----------------||-||||||-----------K-B|-------------------------|---------------------------------||||||------||----||------------------------------
-----------------||-||||||--o----------b|-------------------------|---------------------------------||||||------||----||-------y-------------------F--
-M---------------||-||||||-%%%---------b|-------------------------|--------------------------------g||||||--ooo-||----||---SSSSS--k----------------#--
XXXXXXXXXXX--%%%%||%||||||--|-XXXXXXXXXX|----%%%%-XXXXXXX---%%%%%-|---X----XXXXXXXXXXX---X-XXXXXXXXX||||||--%%%-||----||-------XX-XX---XXXXXXXXXXXXXXX
XXXXXXXXXXX---||-||-||||||--|-XXXXXXXXXX|-----||--XXXXXXX----|||--|---X----XXXXXXXXXXX---X-XXXXXXXXX||||||---|--||----||-------XX-XX---XXXXXXXXXXXXXXX
