------------------------------------------------------------------------------------------------------------------------------------------------------
------------------------------------------------------------------------------------------------------------------------------------------------------
------------------------------------------------------------------------------------------------------------------------------------------------------
--------------------SSSSSSSSSS--------------------SSSSSSSSSS--------------------ooo-------------------------------------------------------------------
--------------------SSSSSSSSSS-----------g------------SS--SS--------------------%%%-------------------------------------------------------------------
--------------------SSSSSSSSSS----------%%------------SS--SS---------------------|--------------------------------------------------------------------
--------------------SSSSSSSSSS----------|-----------SS------------SSoo----SS-----|-----------------------------------------------------US-------------
--------------------------------o----ooo|----oo-----SS---------------------------|-------------------------------SSS------------oo--------------------
----------------------------------------|-----------SS---------------------------|--------------------------------------------------------------------
----------------------------------------|-----------SS----oo---------------------|---%%%%--o-----------------------------------------SS---------------
-----SSS-----------%--SSSSSS?---------%%|-----------SSSS--SS%%%%%%----SS-----SS--|----||---------TT--------------------------TT------------S----------
----------------------SSSSS------------||-------------SS-----||||---------------%%%%%%||---------TT--------------------------TT-----------------------
----------------------SSSSS------------||-------------SS-----||||----------------||||-||---------TT-------*------------------TT---TT---------------F--
-------------%%%%----------ooo-%%%%%%%-||--------------------||||----------------||||-||---------TT-gg----*--------------y---TT---TT---------------#--
XXXXXXXXXXX---||-----XXXXXXXXX--|||||--||----%%%%-XXXXXXXXXX-||||----------------||||-||%%XXXXXXXXXXXXXXXXXXX-%%%%----%%XXXXXXXXXXXXXXXX-X-XXXXXXXXXXX
XXXXXXXXXXX---||-----XXXXXXXXX--|||||--||-----||--XXXXXXXXXX-||||----------------||||-||-|XXXXXXXXXXXXXXXXXXX-|||------|XXXXXXXXXXXXXXXX-X-XXXXXXXXXXX
