------------------------------------------------------------------------------------------------------------------------------------------------------
------------------------------------------------------------------------------------------------------------------------------------------------------
------------------------------------------------------------------------------------------------------------------------------------------------------
----------SSSSSSSSSS----------------------------------------------------------------------------------------------------SSSSSSSSSS--------------U-----
------------------------------------------------------------------------------------------------------------------------------------------------------
--------------------------------------------------------------------------------------------oo--------------------------------------------------------
--------------------USS-----------------------QQQQ-------Q-Q--------------SSCSS-----------------------------------------------------------------------
-------------------------------------------------------------o---o---o------------------------------------------------------------oo--------------SS--
------------------------------------------------------------%%%-%%%-%%-----------------------------%--------------------------------------------------
------------------------------------------------k------------|---|---|------------o-----------------------------------------------------------SS------
----------@QQQQ-------------------------T-----?QQQ-------Q-Q-|---|---|--QQQQ--QQ-------TT-SS-----------------------------------------------Q---------#
---------------------B----------------ttT--------------------|---|---|-----------------TT---------------------------------SS------------------------##
-----------------g-#-b-------B--------ttT--------------------|---|---|-----------------TT----%%%%---------*---------------SS-----------------------###
---M------------g#-#-B-------b--------ttT--------------------|---|-r-|-----------------TT-----||----gg----*----k----kkk---SS----------------------####
XXXXXXXXXXXXXXXXXXXXXXXXXXXXXXXXXXXXXXXXXXXXXXXXXXXXXXXXXXXX%%%%%%%%%%XXXXXXXXXXXXXXXXXXXX----||----XXXXXXXXX-XXXXXXXXXX--XX--XXXXXXXXXXXXXXXXXXX-XXXX
XXXXXXXXXXXXXXXXXXXXXXXXXXXXXXXXXXXXXXXXXXXXXXXXXXXXXXXXXXXX-|||||||||XXXXXXXXXXXXXXXXXXXX----||----XXXXXXXXX-XXXXXXXXXX--XX--XXXXXXXXXXXXXXXXXXX-XXXX
