------------------------------------------------------------------------------------------------------------------------------------------------------
------------------------------------------------------------------------------------------------------------------------------------------------------
------------------------------------------------------------------------------------------------------------------------------------------------------
----------SSSSSSSSSS---oo-------oo--------------------------------------------------------------------------------------------------------------------
---------------------------------------g--------------------------------------------------------------------------------------------------------------
-----------------------------------%%%%%--------------------------------------------------------------------------------------------------------------
----------------------SSSS----------||||----------------------------------SS--------y------------------------@------------------------------SSS-------
------------------------------------||||------------------------------------------#SSS---------------------------SSS----------------------------------
------------------------------------||||-----------------TT----------o-----------##--------------------------------------------------g#---------------
------------------------------%%%%%-||||-----------TT----TT------y--------------###1------------------------------------------------g##----------SSSSS
----------@QQQQ-----------%%%%-|||--||||------tt---TT----XX------##---SS-----SS-###-----------------SU----!--!----------------------###---------------
---------------------------|||-|||--||||------tt---TT-----------###-------------###--SSS-------------------------------------------####---------------
-----------------g-#-------|||-|||--||||------tt---TT----------####-------------###-----------------------------------------------#####-----SSS-------
---M------------g#-#-------|||-|||--||||-g----tt---TT---------#####-------------###----------------g------k--------------k----ggg-#####------------r--
XXXXXXXXXXXXXXXXXXXX%%%----|||-|||--||||XXXXXXXXXXXXXXXXXXXXXXXXXXX-------------XXXXXX---X-XXXXXXXXXXXXXXXXXXX%%%%----%%XXXXXXXXXXXXXXX--XXX-----XXXXX
XXXXXXXXXXXXXXXXXXXX||-----|||-|||--||||XXXXXXXXXXXXXXXXXXXXXXXXXXX-------------XXXXXX---X-XXXXXXXXXXXXXXXXXXX|||------|XXXXXXXXXXXXXXX--XXX-----XXXXX
