------------------------------------------------------------------------------------------------------------------------------------------------------
------------------------------------------------------------------------------------------------------------------------------------------------------
------------------------------------------------------------------------------------------------------------------------------------------------------
----------SSSSSSSSSS----------------------------------------SSSSSSSSSS--------------------------------------------------------------------------------
------------------------------------------------------------SSSS--SSSS--------------------------------------------------------------------------------
------------------------------------------------------------SSSS--SSSS--------------------------------------------------------------------------------
---------------------------------------------------------Q-Q--SS---S-----------------------------------------------oo------------------US-------------
--------------------------------------------------------------SS---S----------------------------------------------------------------------------------
--------------------------------------------------------------SS---S---------------------------------------------------------SSS----------------------
------------------------------------------------------------ooSS---SoU------------o------------oooo----------------------------------SS---------------
---------------------------------------------------------Q-QSSSS---SSS-----------------TT-------------%%%%%%---%%%%--%%%r------------------S----------
---------------------------------------------------------------------------------------TT--------------||||-----||----||%%%%%%---------------------#--
---------------------------------------------------------------------------------------TT--------------||||-----||----|||||||-----TT-----------K---#--
-M-----------------------ggg------k-k-------y-y-------------k--g-g---------------------TT--------------||||---o-||----|||||||-----TT---------------#--
XXXXXXXXXXX--XX--X--XXXXXXXXXXXXXXXXXXX-XXXXXXXXXXXXXXXXXXXXXXXXXXXXXXX----XXXXXXXXXXXXXXX%%%%%%%-%%%%-||||-%%%-||----|||||||-----XXXXXX-X-XXXXXX--XXX
XXXXXXXXXXX--XX--X--XXXXXXXXXXXXXXXXXXX-XXXXXXXXXXXXXXXXXXXXXXXXXXXXXXX----XXXXXXXXXXXXXXX||||||---||--||||--|--||----|||||||-----XXXXXX-X-XXXXXX--XXX
