------------------------------------------------------------------------------------------------------------------------------------------------------
------------------------------------------------------------------------------------------------------------------------------------------------------
------------------------------------------------------------------------------------------------------------------------------------------------------
----------SSSSSSSSSS------------oo--------------------------SSSSSSSSSSSSSSSSSSSSSSSSSSSSSS----------SSSSSSSSSS----------------------------------------
---------------------------------------g----------?---------SSSS--SSSS------SSSS----------------------------------------------------------------------
-----------------------------------%%%%%--------------------SSSS--SSSS---g--SSSS----------------------------------------------------------------------
--------------------USS-------------||||----------------------SS---S----SS--------------------------------------------------------!S------------------
------------------------------------||||----------SS----------SS---S----SS----------------------------------------------------------------------------
------------------------------------||||----------------------SS---S----SS----------------------------------------------------------------------------
------------------------------%%%%%-||||--------------------ooSS---SoU--SC--g-g--------S--------------------------------------------------------------
----------@QQQQ----------------|||--||||--------------------SSSS---SSS--SS--SSSSSU---------------------------T--------------------S------#----#LSS----
---------------------B---------|||--||||-----K---B-----SSS--------------------------TT---t-------------TT----T--------------------------##----#-------
-----------------g-#-b-------B-|||--||||---------b----------------------------------TT---t-------------TT----T-------------------------###----#-------
-M--------------g#-#-B-------b-|||--||||---------B----------k--g-g-----------------kTT--kt---------gg--TT----T-k----kkk--k----ggg-----####--kk#-------
XXXXXXXXXXXXXXXXXXXXXXXXXXXXXX-|||--||||XXXXXXXXXX----------XXXXXXXXXXXXXXXXXXXXXXXXXXXXXX-XXXXXXXXXXXXXXXXXXXXXXXXXXXXXXXXXXXXXXXXXXXXXXXXXXXXXXXX---
XXXXXXXXXXXXXXXXXXXXXXXXXXXXXX-|||--||||XXXXXXXXXX----------XXXXXXXXXXXXXXXXXXXXXXXXXXXXXX-XXXXXXXXXXXXXXXXXXXXXXXXXXXXXXXXXXXXXXXXXXXXXXXXXXXXXXXX---
