------------------------------------------------------------------------------------------------------------------------------------------------------
------------------------------------------------------------------------------------------------------------------------------------------------------
------------------------------------------------------------------------------------------------------------------------------------------------------
S-----SSSS----------------------------------------------------------------------ooo-------------------------------------------------------------------
S-------------------------------------------------------------------------------%%%-------------------------------------------------------------------
S---------------------------------------ooooo------------------------------------|--------------------------------------------------------------k-----
S-----------------------------------------------------------------SSoo------SSSS-|---------------------------------oo---SSS--------SSSS--------SQS--SQ
S-----------------------------------------------SS-------------------------------|--------------------------------------------------------------------
S----------------%%%---------------------SSSS------------------------------------|--------------------------------------------------------------------
S-----------------||---------------------------------------------------------K---|---%%%%----------------------------------------------SSSS-----------
S-----------------||SS-----------------T-----------------tt-%%%%%%---------SSSSS-|----||--------TT-------------%%%%--%%%-----------------------SQS--S?
S------------%%%%%||-K---TT------------T-----------------tt--||||-----T---------%%%%%%||--------TT--------------||----||------------------------------
S-------------|||-||-----TT------------T----%%%%%--------tt--||||-----T----------||||-||--------TT--------*-----||----||------TT----------------------
S-------------|||-||-----TT-----gg-----T-----|||-----g-g-tt--||||-----T----------||||-||----k---TT--gg----*---o-||----||------TT-------------k------gg
XXXXXXXXXXX---|||-||XXXXXXXXXXXXXXXXXXXX%%---|||--XXXXXXXXXX-||||-----XXXXXXXXXX-||||-||%%XXXXXXXXXXXXXXXXXXX-%-||----||----XXXXXX---------XXXXXXXXXXX
XXXXXXXXXXX---|||-||XXXXXXXXXXXXXXXXXXXX|----|||--XXXXXXXXXX-||||-----XXXXXXXXXX-||||-||-|XXXXXXXXXXXXXXXXXXX---||----||----XXXXXX---------XXXXXXXXXXX
