------------------------------------------------------------------------------------------------------------------------------------------------------
------------------------------------------------------------------------------------------------------------------------------------------------------
------------------------------------------------------------------------------------------------------------------------------------------------------
--------------------------------------------------SSSSSSSSSS------------------------------------------------------------SSS-----SS--------------------
------------------------------------------------------SS--SS-------------o----------------------------------------------------------------------------
-----------------------SSS----------------------------SS--SS------------%%%---------------------------------------------------------------------k-----
----------------------------------------------------SS-------------------|--o-----------------------------2--------oo---US---------------------SQS--SQ
---------------------g------------------------------SS-------------------|--SSSS----------------------------------------------------------------------
--------------------%%%-----------------------------SS----------------%--|--------TT----------------------------------------SSS------g#---------------
--------------------||----SSS-----------------------SS----oo-------------|--------TT------------g---o-------------------------------g##---------------
-------------------%||---------TT-------------------SSSS--SS-------------|--------TT------------TT--------2----%%%%--%%%SSS---------###--------SQS--S?
--------------------||---------TT------------K---B----SS-------------T---|--------TT-----T------TT--------------||----||-----------####---------------
--------------------||---------TT----------------b----SS-----B-------T---|-----%T-TT-----T------TT--------------||----||----------#####---------------
-M-----------%%%%---||----oo--gTT----------------B-----------b-------T---|------T-TT---k-T------TT------y--y--o-||----||----------#####------k------gg
XXXXXXXXXXX---||----||---%%%--XXXXXXXX--XXXXXXXXXXXXXXXXXXXXXXXXXX--XX%%%%%%----XXXXXXXXXXXXXXXXXXX-XXXXXXXXXX%-||----||XXX------XXXXXX--XXXXXXXXXXXXX
XXXXXXXXXXX---||----||----|---XXXXXXXX--XXXXXXXXXXXXXXXXXXXXXXXXXX--XX|||||-----XXXXXXXXXXXXXXXXXXX-XXXXXXXXXX--||----||XXX------XXXXXX--XXXXXXXXXXXXX
