------------------------------------------------------------------------------------------------------------------------------------------------------
------------------------------------------------------------------------------------------------------------------------------------------------------
------------------------------------------------------------------------------------------------------------------------------------------------------
--------------------SSSSSSSSSS------------------------------------------------------------SSSSSSSSSSSSSSSSSSSS----------------------------------U-----
--------------------SSSSSSSSSS------------------------------------------------------------------------------------------------------------------------
--------------------SSSSSSSSSS------------------------------------------------------------------------------------------------------------------------
------------------Q-SSSSSSSSSS------------------------------------------------------y-------------------------------------SSC-----SS------------------
----------------------------------------------------------------------------------#SSS---------------------------SSS------------------------------SS--
-------------------------------------------------------------------------------g-##-------------------------------------------------------------------
----------------------------------------------------------------1---------------###1--------------------------------------SSS-----------------SS------
------------------?---SSSSSS?--TT--------------------------------------------S@S###--------------------------T--------------------SS-----------------#
--------------TT------SSSSS----TT-------------------K---------------------------###--SSS---------------TT----T--------------------K---#----B--------##
--------------TT------SSSSS----TT-----------------------------------------------###--------------------TT----T------------------------#----b-------###
-M------------TT-----------ooogTT--------------y-----------g--------------------###-------------g-g-g--TT----T-------------------#----#----B------####
XXXXXXXXXXXXXXXXXXXX-XXXXXXXXXXXXXXXXX--XXXXXXXXXXXXXXXXXXXXXXXXXXXXX--XXXXXXXXXXXXXXX---XXXXXXXXXXXXXXXXXXXXX%%%%----%%X----XXXXXXXXXXXXXXXXXXXX-XXXX
XXXXXXXXXXXXXXXXXXXX-XXXXXXXXXXXXXXXXX--XXXXXXXXXXXXXXXXXXXXXXXXXXXXX--XXXXXXXXXXXXXXX---XXXXXXXXXXXXXXXXXXXXX|||------|X----XXXXXXXXXXXXXXXXXXXX-XXXX
