------------------------------------------------------------------------------------------------------------------------------------------------------
------------------------------------------------------------------------------------------------------------------------------------------------------
------------------------------------------------------------------------------------------------------------------------------------------------------
------------------------------------------------------------------------------------------------------------------------------------------------------
--------------------------------------------?---------------------------------------------------------------------------------------------------------
----------------------ooor------------oo--------------------------------------------------------------------------------------------------------------
------------------SC-%%%%%---------SSSS------------------------------------1---------1------------------------?SSS-----------------SSSS---------------
----------------------|||---------------------r-----------------------------------------------------------TT------------------------------------------
----------------------|||-----------------%%%%%%----------------------------------------------------------TT-----------------SSS----------------------
----------------------|||------------------||||----------------------------ggg-------------o--------------TT---------------------------SSSS-----------
--------SU----TT---2%%%%%%%---%---------%%-||||ooo-------tt-----------#########----QQQQ----------TT------SXXS-SSSSS-----r-----------------------------
--------------TT----||||||--------------|--||||--r-------tt----------T--------#------------------TT---------------------%%%%%%------------------------
--------------TT----||||||--o-----------|%%%%%%%%%-------tt--B-------T--------#------------------TT-TT------------------|||||----------------------F--
--M-----------TT----||||||-%%%----------|-||||||||---g-g-tt--b-------T--------#-----yy-----------TT-TT----------K-------|||||----------------------#--
XXXXXXXXXXXXXXXXXXXX||||||--|---%%%%--%%|-||||||||XXXXXXXXXXXXXXXX--XX--------X-XXXXXXXXXXXXXXXXXXXXXXXXXXXXXXXXXXXXXXXX|||||--------------XXXXXXXXXXX
XXXXXXXXXXXXXXXXXXXX||||||--|----||----||-||||||||XXXXXXXXXXXXXXXX--XX--------X-XXXXXXXXXXXXXXXXXXXXXXXXXXXXXXXXXXXXXXXX|||||--------------XXXXXXXXXXX
