------------------------------------------------------------------------------------------------------------------------------------------------------
------------------------------------------------------------------------------------------------------------------------------------------------------
------------------------------------------------------------------------------------------------------------------------------------------------------
--------------------------------------------------SSSSSSS----------SSS--------------------------------------------------SSSSSSSSSS--------------------
-------------------------------------------------------------------------o----------------------------------------------------------------------------
----------------------------------------%%------------------------------%%%-----K---------------------------------------------------------------------
----------------------------------------|---------QQ------------CSS------|--o---SS----1--------------------------------------------SSSS---------------
--------------------------------o----ooo|----oo--------------------------|--SSSS------------------oo------------oooo----------------------------------
----------------------------------------|------------------SSS--2-----%--|----------------------------------------------------------------------------
----------------------------------------|----------------------2-2-------|-------------------------------------------------------------SSSS-----------
--------------------------------------%%|---------QQ--QQQ---------2------|------SS----------------------------T-------------------------------#LSS----
---------------------------------------||--------------------------------|------------TT--------#-----------g-T-----------SS------------------#-------
---------------------------------------||--------------------------------|-----%------TT--------#-----------TTT-----------SS------------------#-------
-M--------k---ggg--------------%%%%%%%-||--------------------------------|------------TT--------#-----------TTT---y-------SS----------------kk#-------
XXXXXXXXXXXXXXXXXXXXXXXXX--XXX--|||||--||----%%%%-XXXXXXX------XXXXXXX%%%%%%----XXXXXXXXXXXXXXXXXXXX--XXXXXXXXXXXXXXXXXX--XX--XXXX---------XXXXXXXX---
XXXXXXXXXXXXXXXXXXXXXXXXX--XXX--|||||--||-----||--XXXXXXX------XXXXXXX|||||-----XXXXXXXXXXXXXXXXXXXX--XXXXXXXXXXXXXXXXXX--XX--XXXX---------XXXXXXXX---
