------------------------------------------------------------------------------------------------------------------------------------------------------
------------------------------------------------------------------------------------------------------------------------------------------------------
------------------------------------------------------------------------------------------------------------------------------------------------------
S-----SSSS--------------------SSSSSSSSSSSSSSSSSSSS------------------------------------------------------------------------------------------SSSSSSSSSS
S---------------------------------------SSSSSSSS-------------------------o----------------------------------------------------------------------------
S---------------------ooor--------------SSSCSSSS------------------------%%%---------------------------------------------------------------------------
S--------------------%%%%%--------------SSSSSSSS--Q----------------------|--o--------------SSS!--------------------oo---SSS-------%-------------------
S---------------------|||------------------------------------o---o---o---|--SSSS----------------------------------------------------------------------
S---------------------|||--------------S--------------------%%%-%%%-%%%--|--------------------------------------------------------------SSS-----------
S---------------------|||--------------S---ggg---------------|---|---|---|--------o-------------------------------------------------------------------
S-------------------%%%%%%%------------SSSSSSSSS--Q----------|---|---|---|-------------TT-----C----------------%%%%--%%%----------%%%%%-------TT------
S----------------K--||||||-----#--------SSSSSSSS-------------|---|---|---|-------------TT-----------------------||----||-----------|||--------TT------
S-----------B-------||||||--o--#-#------SSSSSSSS-------------|---|---|---|-----%-------TT-----------------*-----||----||------TT---|||--------TT------
S--M--------b-------||||||-%%%-#-#------SSSSSSSS-----gg----k-|---|-r-|---|-------------TT------g-g--gg----*---o-||----||------TT---|||--------TT------
XXXXXXXXXXXXXXXXXXXX||||||--|-XXXXXXXXXXXXXXXXXXXXXXXXXXXXXX%%%%%%%%%%%%%%%%----XXXXXXXXXXXXXXXXXXXXXXXXXXXXX-%-||----||----XXXXXX%|||------XXXX--XXXX
XXXXXXXXXXXXXXXXXXXX||||||--|-XXXXXXXXXXXXXXXXXXXXXXXXXXXXXX-||||||||||||||-----XXXXXXXXXXXXXXXXXXXXXXXXXXXXX---||----||----XXXXXX-|||------XXXX--XXXX
