------------------------------------------------------------------------------------------------------------------------------------------------------
------------------------------------------------------------------------------------------------------------------------------------------------------
------------------------------------------------------------------------------------------------------------------------------------------------------
----------SSSSSSSSSS----------------------------------------------------------------------------------------------------------------------------------
------------------------------------------------------------------------------------------------------------------------------------------------------
-----------------------SSS-----------------------------oooo-------------------------------------------------------------------------------------------
-------------------------------------------------------%%%%----------------g-------o--o----------------------R-----oo-----oo---%%%%-------------------
---------------------g----------o----ooo----------------||-------------%%%%%%----------------------------r----------------SS----||--------------------
--------------------%%%---------------------------------||--------------||||------------------------%%%%%%%---------------------||------SSS-----------
--------------------||----SSS---------------------SSS---||--------------||||-------SSSS-------------||||||----------------------||--------------------
--------------------||----------------%%------tt--------||-----------#--||||---------------------tt-||||||-----%%%%--%%%-----SS-||%%%%%---------------
--------------------||-----------------|------tt------U-||----------##--||||--------------T------tt-||||||------||----||--------||-|||----------------
--------------------||-----------------|------tt--------||--TT-----###--||||----%%%-------T------tt-||||||------||----||--------||-|||-------------F--
-M------------------||----oo---%%%%%%%-|-g----tt--------||--TT----####--||||----||--------T------tt-||||||--ooo-||----||--------||-|||-------------#--
XXXXXXXXXXX--XX--X--||---%%%----|||||--|XXXXXXXXXX----%%%%%-XXXXXXXXXX--||||----||--------XXXXXXXXXX||||||--%%%-||----||%%-----%%%%|||------XXXXXXXXXX
XXXXXXXXXXX--XX--X--||----|-----|||||--|XXXXXXXXXX-----|||--XXXXXXXXXX--||||----||--------XXXXXXXXXX||||||---|--||----|||-------||-|||------XXXXXXXXXX
