------------------------------------------------------------------------------------------------------------------------------------------------------
------------------------------------------------------------------------------------------------------------------------------------------------------
------------------------------------------------------------------------------------------------------------------------------------------------------
----------SSSSSSSSSS----------------------------------------------------------------------------------------------------------------------------------
------------------------------------------------------------------------------------------------------------------------------------------------------
-----------------------SSS----------------------------------------------------------------------------------------------------------------------------
----------------------------------------------QQQQ---------------------------------USS----SSS------%---------R----------------------------------------
---------------------g-------------------------------------------------------------------------------r--------------------------oooo------------------
--------------------%%%----------------------------------B------------------------------------------%%%%%%%------------y------------------------------
--------------------||----SSS------oo-----------k--------b------------------------------------------||||||-------------X------------------------------
--------SU----------||------------o--o--T-----?QQQ-----SS#CS----------------------#---------%%%-----||||||------------XX-----TT------------Q----------
--------------------||------------------T-----------------------------------------#----------|------||||||-----------XXX-----TT-----------------------
--------------------||------------------T------------------K----------------------##---------|------||||||----------XXXX-----TT--------------------F--
--M-----------------||----oo------------T--------------------y--------gg----------##--gg-----|------||||||--oo-----XXXXX-y---TT--------------------#--
XXXXXXXXXXX--XX--X--||---%%%--XXXXXXXXXXXXXXXXXXXXXXXXXXXXXXXXXXXXXXXXXXXXXXXXXX--XXXXXXXX---|------||||||--%%XXXXXXXXXXXXXXXXXXXXXXXXXXXXXXXXXXXXXXXX
XXXXXXXXXXX--XX--X--||----|---XXXXXXXXXXXXXXXXXXXXXXXXXXXXXXXXXXXXXXXXXXXXXXXXXX--XXXXXXXX---|------||||||---|XXXXXXXXXXXXXXXXXXXXXXXXXXXXXXXXXXXXXXXX
