------------------------------------------------------------------------------------------------------------------------------------------------------
------------------------------------------------------------------------------------------------------------------------------------------------------
------------------------------------------------------------------------------------------------------------------------------------------------------
------------------------------------------------------------------------------------------SSSSSSSSSS--------------------------------------------------
------------------------------------------------------------------------------------------------------------------------------------------------------
----------------------ooor--------------------------------------------------------------oo------------------------------------------------------------
---------------------%%%%%------------------------------------USSS--------------oo----------------------SSQSSS--------------------SS---------QQQQ-----
----------------------|||-----------------------------------------------------------------------------------------------------------------------------
----------------------|||-----------------------------------------------------------------------------------------------------------------------------
----------------------|||--------------------------------------------------------SSS----------------------K--------------------SSS-------------y------
---------Q----------%%%%%%%----TT---------------------S------S-----TT--------------------S--------------SSSSSS--!-----S-%---------SS--------Q?SSQQQ---
--------------------||||||-----TT------------K---BTT---------------TT---------------------t---------------------------------------K---#----B----------
--------------------||||||--o--TT----------------bTT---------------TT---------------------t-------------------------------------------#----b----------
----------k---ggg---||||||-%%%gTT----------------BTT------k--ggg---TT---------------------t--------------------------------------r----#----B----------
XXXXXXXXXXXXXXXXXXXX||||||--|-XXXXXXXX--XXXXXXXXXXXXXXXXXXXXXXXXXXXXXXX----XXXXX----------XXXXXXXXXXXXXXXXXXXXXXXXXXXXXX----XXXXXXXXXXXXXXXXXX--XXXXXX
XXXXXXXXXXXXXXXXXXXX||||||--|-XXXXXXXX--XXXXXXXXXXXXXXXXXXXXXXXXXXXXXXX----XXXXX----------XXXXXXXXXXXXXXXXXXXXXXXXXXXXXX----XXXXXXXXXXXXXXXXXX--XXXXXX
