------------------------------------------------------------------------------------------------------------------------------------------------------
------------------------------------------------------------------------------------------------------------------------------------------------------
------------------------------------------------------------------------------------------------------------------------------------------------------
S-----SSSS--------------------------------------------------------------------------------------------------------------------------------------U-----
S-----------------------------------------------------------------------------------------------------------------------------------------------------
S--------------------------------------------------------------------R------------------oo------------------------------------------------------------
S---------------------------------------------------------------------------SSSSoo---------------------------@?SSS-------------SSS-SSSS---------------
S-------------------------------------------------------------------------------------------------------------------------------------------------SS--
S--------------------------------------------------------TT-------------------------------------------------------------------------------------------
S--------------------------------------------------TT----TT------------------K---SS-------------g-------------------------------K------SSSS---SS------
S---------------!-----------TT--QQQQ---------------TT----XX------%%%-------SSSSS---------S------TT--SU----!--!SSSSS------------SSS-------------------#
S---------------------------TT-------K-B-----------TT-------------|---T-------------------------TT--------------------------------------------------##
S---------------------------TT---------b-----------TT-------------|---T-------------------------TT-----------------------TT------------------------###
S-----------------------ggg-TT---------b-------y---TT-------------|---T-------------------------TT--------k-----K--------TT-----------------------####
XXXXXXXXXXXXXXXXXXXXXXXXXXXXXXXXXXXXXXXXXXXXXXXXXXXXXXXXXXXX%%%%%-|---XXXXXXXXXX----------XXXXXXXXX-XXXXXXXXXXXXXXXXXXXXXXXXXXXXXX---------XXXXXX-XXXX
XXXXXXXXXXXXXXXXXXXXXXXXXXXXXXXXXXXXXXXXXXXXXXXXXXXXXXXXXXXX-|||--|---XXXXXXXXXX----------XXXXXXXXX-XXXXXXXXXXXXXXXXXXXXXXXXXXXXXX---------XXXXXX-XXXX
