------------------------------------------------------------------------------------------------------------------------------------------------------
------------------------------------------------------------------------------------------------------------------------------------------------------
------------------------------------------------------------------------------------------------------------------------------------------------------
S-----SSSSSSSSSSSSSS---oo---------------------------------------------------------------------------SSSSSSSSSS----------SSSSSSSSSS--------------------
S-----------------------------------------------------------------------------------------------------------------------------------------------------
S-------------------------------------------------------------g---------------------------------------------------------------------------------------
S---------------------SSSS----S---------------QQQQ------------SSSSS--------1--------y-----SSS------%--------------------------------------------------
S---------------------------------------------------------------------------------#SSS----------------------------------------------------------------
S--------------------------------------------------------------------------------##-------------------------------------------------------------------
S-----------------------------------------------k--------------------------ggg--###1------------------------------------------------------------------
S---------@QQQQ-----------%%%%##--SSC---T-----?QQQ----S---------------#########-###---------%%%--------------T----------------------------------------
S--------------------------|||----------T---------TT--------------------------#-###--SSS-----|---------TT----T------------SS---------TT---------------
S----------------g-#-------|||----------T---------TT----------TT-----t--------#-###----------|---------TT----T-----B------SS---------TT------------F--
S---------------g#-#-------|||----------T---------TT------k---TT-----t--------#-###----------|------g--TT----T-----b------SS---------TT------------#--
XXXXXXXXXXXXXXXXXXXX%%%----|||XX--XXXXXXXXXXXXXXXXXXXXXXXXXXXXXXXXXXXX--------X-XXXXXX---X---|------XXXXXXXXXXXXXXXXXXXX--XX--XXXXXXXXXXXXXXXXXXXXXXXX
XXXXXXXXXXXXXXXXXXXX||-----|||XX--XXXXXXXXXXXXXXXXXXXXXXXXXXXXXXXXXXXX--------X-XXXXXX---X---|------XXXXXXXXXXXXXXXXXXXX--XX--XXXXXXXXXXXXXXXXXXXXXXXX
