------------------------------------------------------------------------------------------------------------------------------------------------------
------------------------------------------------------------------------------------------------------------------------------------------------------
------------------------------------------------------------------------------------------------------------------------------------------------------
----------SSSSSSSSSS----------------------------------------SSSSSSSSSS--------------------------------------------------------------------------U-----
------------------------------------------------------------SSSS--SSSS--------------------------------------------------------------------------------
--------------------------------------oo--------------------SSSS--SSSS----------------------oo--------oo----------------------------------------------
--------------------S--------------SSSS-----------------------SS---S------------------------------------------?SSS------------------------------------
---------------------------TT---------------------------------SS---S------------------------------------------------------------------------------SS--
---------------------------TT---------------------------------SS---S-----------g--TT---------------%--------------------------SSS---------------------
---------------------------XX----------------------------o--ooSS---SoU------------TT----------------------------------------------------------SS------
-----SSS--@QQQQ--------TT-----%---------------tt------------SSSS---SSS-------S@S--TT------SS------------------SSSSS-----%----------------------------#
-----------------------TT---------------------tt----------------------------------TT-----T----------------------------------------------------------##
-----------------g-#---TT---------------------tt--------------------------------T-TT-----T---%%%%-----------tt-------------------------------------###
----------------g#-#k--TT----------------g----tt----k-------k--g-g--------------T-TT---k-T----||------ggg---tt--K----------------rk---------------####
XXXXXXXXXXXXXXXXXXXXXXXXXXXXXX--%%%%--%%XXXXXXXXXX-XXXXXXXXXXXXXXXXXXX-XXXXXXXXXXXXXXXXXXX----||----XXXXXXXXXXXXXXXXXXXX----XXXXXXXX---XXXXXXXXXX-XXXX
XXXXXXXXXXXXXXXXXXXXXXXXXXXXXX---||----|XXXXXXXXXX-XXXXXXXXXXXXXXXXXXX-XXXXXXXXXXXXXXXXXXX----||----XXXXXXXXXXXXXXXXXXXX----XXXXXXXX---XXXXXXXXXX-XXXX
