------------------------------------------------------------------------------------------------------------------------------------------------------
------------------------------------------------------------------------------------------------------------------------------------------------------
------------------------------------------------------------------------------------------------------------------------------------------------------
-------------------------------------------------------------------SSS--------------------------------------------------------------------------------
------------------------------------------------------------------------------------------------------------------------------------------------------
------------------------------------------------------------------------------------------------------------------------------------------------------
---------------------LSSS---------------------------------------CSS------------------1----------------------------------SS---------------##--QQQQ-----
----------------------------------------------------------------------------------------------------------------oooo---------------------##-----------
------------------------------------------------------------SS--2--------------g-------------------------------------------------------####-----------
---------------------------------------------------------------2-2-------------------------o-------------------------------TT----------####----y------
----------Q----------2-----#--------------------------S-----------2----------S@S---QQQQ----------TT-----------T------------TT--------######-Q?SSQQQ---
---------------------------#-----------T----------TT---------------------------------------------TT-----------T---------t--TT--------######-----------
---------------------------##----------T----------TT---------------------------------------------TT-------*---T---------t--TT--------######-----------
-M-----------------#--kk---##--------kkT-------gggTT------k-------------------------yy-----------TT-gg----*---T---y-----t--TT--------######-----------
XXXXXXXXXXXXX--XXXXXXXXXXXXXXXXXXXXXXXXX-XXXXXXXXXXXXXXXXXXX---XXXXXXX-XXXXXXXXXXXXXXXXXXXXXXXXXXXXXXXXXXXXXX-XXXXXXXXXXXXXXXXXXXXXXXXXXXXXXXX--XXXXXX
XXXXXXXXXXXXX--XXXXXXXXXXXXXXXXXXXXXXXXX-XXXXXXXXXXXXXXXXXXX---XXXXXXX-XXXXXXXXXXXXXXXXXXXXXXXXXXXXXXXXXXXXXX-XXXXXXXXXXXXXXXXXXXXXXXXXXXXXXXX--XXXXXX
