------------------------------------------------------------------------------------------------------------------------------------------------------
------------------------------------------------------------------------------------------------------------------------------------------------------
------------------------------------------------------------------------------------------------------------------------------------------------------
----------------------------------------------------------------------------------------------------SSSSSSSSSS----------------------------------------
------------------------------------------------------------------------------------------------------------------------------------------------------
--------------------------------------------------------------------------------------------oo--------------------------------------------------------
----------------------!-------S-------------------------------------------SS--------y-----------------------------------------------------------------
----------------------------------------------------------------------------------#SSS----------------------------------------------------------------
---------------------------------------------------------------------o-----------##----------------%-------------------y-----SSS----------------------
-----------------------------------------------------------------y--------------###1-----------------------------------X------------------------------
---------Q----------S@S!S-----##--SSC-----------------S----------##---SS-----SS-###-------S----------------TT---------XXr---------------------#LSS----
--------------------------------------------------TT------------###-------------###--SSS----------------#--TT--------XXX%%%%%%-------TT-------#-------
----------------------------tt--------------------TT-----------####-------------###----------%%%%------##--TT-------XXXX|||||--------TT-------#-------
-M--------k---ggg----g------tt--------------------TT------k---#####-------------###-----------||----kk-##--TT------XXXXX|||||--------TT-----kk#-------
XXXXXXXXXXXXXXXXXXXXXXXXXXXXXXXX--XXXXXXX-XX-XX-XXXXXXXXXXXXXXXXXXX-------------XXXXXX---X----||----XXXXX--XX-XXXXXXXXXX|||||-----XXXXXXXXXXXXXXXXX---
XXXXXXXXXXXXXXXXXXXXXXXXXXXXXXXX--XXXXXXX-XX-XX-XXXXXXXXXXXXXXXXXXX-------------XXXXXX---X----||----XXXXX--XX-XXXXXXXXXX|||||-----XXXXXXXXXXXXXXXXX---
