------------------------------------------------------------------------------------------------------------------------------------------------------
------------------------------------------------------------------------------------------------------------------------------------------------------
------------------------------------------------------------------------------------------------------------------------------------------------------
-----------------------oo-------oo------SSSSSSSSSS----------------------------------------SSSSSSSSSS------------------------------SSSSSSSSSS----------
---------------------------------------gSSSSSSSS------------------------------------------------------------------------------------------------------
-----------------------------------%%%%%SSSCSSSS-------oooo--------------------------------------------------------k----------------------------------
----------------------SSSS----------||||SSSSSSSS-------%%%%-------------SSSSS---------------------------------S---SSSSSS--------------------SSS-------
------------------------------------||||----------SSSS--||------------------------------------------oo------------------------------------------------
------------------------------------||||----------------||--------------------------------------------------------------------------------------------
------------------------------%%%%%-||||---ggg----------||------------------------o--------------------------------------------------------------SSSSS
--------------------------%%%%-|||--||||SSSSSSSS--------||-----------T-------2---------TT--------------------T----------------------------------------
---------------------------|||-|||--||||SSSSSSSS------U-||-----------T-----TT----------TT--------------------T----------------------------TT----------
---------------------------|||-|||--||||SSSSSSSS--------||-----------Tt----TT--T-------TT--------------------TTT-------------------tt-----TTSSS-------
--------------k-ggg--------|||-|||--||||SSSSSSSS--------||----ggg----Tt----TT--T-------TT-------g-g-------y--TTT---------k----ggg--tt----kTT-------r--
XXXXXXXXXXXXXXXXXXXX%%%----|||-|||--||||XXXXXXXXXX----%%%%%-XXXXXXXXXXXXXXXXXXXXXXXXXXXXXXXXXXXXXXXXXXXXXXXXXXXXXXXXXX--XXXXXXXXXXXXXXXXXXXX-----XXXXX
XXXXXXXXXXXXXXXXXXXX||-----|||-|||--||||XXXXXXXXXX-----|||--XXXXXXXXXXXXXXXXXXXXXXXXXXXXXXXXXXXXXXXXXXXXXXXXXXXXXXXXXX--XXXXXXXXXXXXXXXXXXXX-----XXXXX
