------------------------------------------------------------------------------------------------------------------------------------------------------
------------------------------------------------------------------------------------------------------------------------------------------------------
------------------------------------------------------------------------------------------------------------------------------------------------------
--------------------SSSSSSSSSS--oo----------------------------------------------SSSSSSSSSS------------------------------------------------------------
--------------------SSSSSSSSSS-------g-g--------------------------------------------------------------------------------------------------------------
--------------------SSSSSSSSSS-----%%%%%ooooo---------------------------------------------------------------------------------------------------------
--------------------SSSSSSSSSS------||||----------Q------------------------1------------------------------------------------------SS------------------
------------------------------------||||--------SS--------------------------------------------------------------oooo----------------------------------
------------------------------------||||-SSSS---------------------------------------------------------------------------------------------------------
------------------------------%%%%%-||||-----------------------------------ggg---------S---------------------------------------SSS--------------------
--------SU------------SSSSSS?--|||--||||----------Q------------------##########-SU--------------------%%%%%%--T---------%---------SS--------#---------
-----------------K----SSSSS----|||--||||----------------------------##--------#-----TT---t-------------||||---T-------------------K---#----B##--------
------------B---------SSSSS----|||--||||----%%%%%-----------TT-----###--------#-----TT---t-------B-----||||---T-----------------------#----b###------#
--M---------b--------------ooo-|||--||||-----|||-----gg----kTT----####--------#----kTT--kt-------b-----||||---T---y--------------r----#----B####----##
XXXXXXXXXXXXXXXXXXXX-XXXXXXXXX-|||--||||%%---|||--XXXXXXXXXXXXXXXXXXXX--------X-XXXXXXXXXXXXXXXXXXXX%%-||||-%%XXXXXXXXXX----XXXXXXXXXXXXXXXXXXXXXXXXXX
XXXXXXXXXXXXXXXXXXXX-XXXXXXXXX-|||--|||||----|||--XXXXXXXXXXXXXXXXXXXX--------X-XXXXXXXXXXXXXXXXXXXX|--||||--|XXXXXXXXXX----XXXXXXXXXXXXXXXXXXXXXXXXXX
