------------------------------------------------------------------------------------------------------------------------------------------------------
------------------------------------------------------------------------------------------------------------------------------------------------------
------------------------------------------------------------------------------------------------------------------------------------------------------
--------------------------------oo------SSSSSSSSSS------------------------------------------------------------SS-------SSSSSSSSSSS--------------------
-------------------------------------g-g----------?---------------------------------------------------------------------------------------------------
-----------------------------------%%%%%----------------------g---------------------------------------------------------------------------------------
------------------------------------||||-oooo-----------------SSSSS----------------------------------------------------S----------%---------SS--------
------------------------------------||||----------SS--------------------------------------------------------------------------------------------------
------------------------------------||||-SSSS-U-----------------------------------TT-------------------------------SSS------------------SSS-----------
------------Q--?--------------%%%%%-||||oS--SoS-----------------------------------TT------------------------------------------------------------------
-------------------S--------TT-|||--||||SS--SSS-----------------------------------TT------------TT---------------------S----------%%%%%-----SS--------
----------------------------TT-|||--||||---------------SSS------------------------TT-----T------TT----------g--##---------SS-------|||------------#-TT
----------------------------TT-|||--||||----------------------TT-----t----------T-TT-----T------TT----------TT-##---------SS-------|||-----------##-TT
-M----------------K-----ggg-TT-|||--||||--kk------------------TT-----t----------T-TT---k-T--k---TT----------TT-##---------SS-------|||----------###-TT
XXXXXXXXXXXXXXXXXXXXXXXXXXXXXX-|||--||||XXXXXXXXXX----------XXXXXXXXXXX----XXXXXXXXXXXXXXXXXXXXXXXXX--XXXXXXXX-XX------X--XX--XXXX%|||------XXXXXXX-XX
XXXXXXXXXXXXXXXXXXXXXXXXXXXXXX-|||--||||XXXXXXXXXX----------XXXXXXXXXXX----XXXXXXXXXXXXXXXXXXXXXXXXX--XXXXXXXX-XX------X--XX--XXXX-|||------XXXXXXX-XX
