------------------------------------------------------------------------------------------------------------------------------------------------------
------------------------------------------------------------------------------------------------------------------------------------------------------
------------------------------------------------------------------------------------------------------------------------------------------------------
--------------------SSSSSSSSSS------------------------------------------------------------------------------------------------------------------------
--------------------SSSSSSSSSS------------------------------------------------------------------------------------------------------------------------
--------------------SSSSSSSSSS---------------------------------------R----------------------oo--------------------------------------------------k-----
--------------------SSSSSSSSSS-----------------------------------------------------------------------------------------------------SSSS--------SQS--SQ
------------------------------------------------------------------------------------------------------------------------------------------------------
----------------------------------------------------------------------o-----------TT---------------%--------------------------------------------------
----------------------------------------------------------------------------------TT------------------------------------SS-?Q----------SSSS-----------
-------------------%--SSSSSS?----------T---------------ooo-------%%%--------------TT------S----------------------------------------------------SQS--S?
----------------------SSSSS------------T--------------------------|-----------#---TT-----T------------------------------------------------------------
----------------------SSSSS------------T--------------------------|----------##-T-TT-----T---%%%%---------*--------B-----------y----------------------
-------------%%%%----------ooo--gg-----T-------y------------------|-------------T-TT---k-T----||----gg----*--------b-------SSSSS-------------k------gg
XXXXXXXXXXX---||-----XXXXXXXXXXXXXXXXXXXXXXXXXXXXX--XXXXXXXX%%%%%-|---XXXXXXXXXXXXXXXXXXXX----||----XXXXXXXXX-XXXXXXXXXX-------XX----------XXXXXXXXXXX
XXXXXXXXXXX---||-----XXXXXXXXXXXXXXXXXXXXXXXXXXXXX--XXXXXXXX-|||--|---XXXXXXXXXXXXXXXXXXXX----||----XXXXXXXXX-XXXXXXXXXX-------XX----------XXXXXXXXXXX
