------------------------------------------------------------------------------------------------------------------------------------------------------
------------------------------------------------------------------------------------------------------------------------------------------------------
------------------------------------------------------------------------------------------------------------------------------------------------------
------------------------------------------------------------------------------------------SSSSSSSSSS--------------------------------------------------
------------------------------------------------------------------------------------------------------------------------------------------------------
------------------------------------------------------------------------------------------------------------------------------------------------k-----
------------------SC------------------------------------------USSS--------SS--------y------------------------------oo---SS--------!S-----------SQS--SQ
----------------------------------------------------------------------------------#SSS----------------------------------------------------------------
---------------------------------------------------------TT----------------------##-------------------------------------------------------------------
---------------------------------------------------TT----TT---------------------###1---------------------------------------TT-------------------------
--------------TT---2--------TT-TT------------------TT----XX--S-----TT-SS-----SS-###----------------------------%%%%--%%%---TT-----S------#-----SQS--S?
--------------TT------------TT-TT------------------TT--------------TT-----------###--SSS--t---------------------||----||t--TT-----------##------------
--------------TT------------TT-TT------------------TT--------------TT-----------###-------t---------------*-----||----||t--TT----------###------------
-M------------TT--------ggg-TTgTT--------------y---TT--------ggg---TT-----------###-------t---------gg----*---o-||----||t--TT---------####---k------gg
XXXXXXXXXXXXXXXXXXXXXXXXXXXXXXXXXXXXXX--XXXXXXXXXXXXXXXXXXXXXXXXXXXXXX----------XXXXXX---XXXXXXXXXXXXXXXXXXXX-%-||----||XXXXXXXXXXXXXXXXXXXXXXXXXXXXXX
XXXXXXXXXXXXXXXXXXXXXXXXXXXXXXXXXXXXXX--XXXXXXXXXXXXXXXXXXXXXXXXXXXXXX----------XXXXXX---XXXXXXXXXXXXXXXXXXXX---||----||XXXXXXXXXXXXXXXXXXXXXXXXXXXXXX
