------------------------------------------------------------------------------------------------------------------------------------------------------
------------------------------------------------------------------------------------------------------------------------------------------------------
------------------------------------------------------------------------------------------------------------------------------------------------------
S-----SSSS--------------------SSSSSSSSSSSSSSSSSSSS----------------------------------------SSSSSSSSSS--------------------------------------------------
S---------------------------------------SSSSSSSS------------------------------------------------------------------------------------------------------
S---------------------------------------SSSCSSSS------------------------------------------------------------------------------------------------------
S--------------------LSSS---------------SSSSSSSS--Q-----------------------SSCSS------1------------------SSQSSS-----oo---SS---------SSSS---------------
S----------------------------------------------------------------------------------------------------------------------------------------------y------
S----------------g---------------------S-----------------------------------------------------------------------------------------------------#SS--o---
S----------------#---------------------S---ggg------------------------------------------------------------K----------------TT----------SSSS-##--------
S---------S-----##---2-----#-----------SSSSSSSSS--Q---------------------QQQQ--QQ---QQQQ-----------------SSSSSS-%%%%--%%%---TT---------------##--SC----
S--------------###---------#---#--------SSSSSSSS------------------------------------------t---------------------||----||t--TT---------------##--------
S-------------####---------##--#-#------SSSSSSSS------------------------------------------t---------------------||----||t--TT---------------##---SSS--
S------------#####----kk---##--#-#------SSSSSSSS-----gg----kgg-------g--------------yy----t-------------------o-||----||t--TT---------------##--------
XXXXXXXXXXXXXXXXXXXXXXXXXXXXXXXXXXXXXXXXXXXXXXXXXXXXXXXXXXXXXXXXXXXXXXXXXXXXXXXXXXXXXXXXXXXXXXXXXXXXXXXXXXXXXX%-||----||XXXXXXXXXX---------XXX------XX
XXXXXXXXXXXXXXXXXXXXXXXXXXXXXXXXXXXXXXXXXXXXXXXXXXXXXXXXXXXXXXXXXXXXXXXXXXXXXXXXXXXXXXXXXXXXXXXXXXXXXXXXXXXXXX--||----||XXXXXXXXXX---------XXX------XX
