------------------------------------------------------------------------------------------------------------------------------------------------------
------------------------------------------------------------------------------------------------------------------------------------------------------
------------------------------------------------------------------------------------------------------------------------------------------------------
----------------------------------------------------------------------SSSSSSSSSS------------------------------SSSSSSSSSS------------------------------
--------------------------------------------------?--------------------------------------------------------------------------------------------------o
------------------------------------------------------------------------------------------------------------------------------------------------------
------------------SCS---------S------------------------------------------------------1-----------------------@----------SS----------------------------
---------------------------TT---------------------SS--------------------------TT--------------------------------------------------oo------------SSS---
---------------------------TT-------------------------------------------------TT------------------------------------------------------------oo--------
---------------------------XX-----------------------------------1-------------TT---------------oooo------------------------TT-------------------------
---------Q----TT---2---TT-----##--SSC---------------------------------------SCTT---QQQQ-------------SU----!--!T------------TT--------------QSS--------
--------------TT-------TT--------------------K---B-----SSS--------------TT----TT------------------------------T---------t--TT-------------------------
--------------TT-------TT------------------------b----------------------TT----TT------------------------------T----TT---t--TT-------------------------
--------------TT----k--TT------------------------B----------------------TT---kTT----yy--------------------k---T--g-TT---t--TT-------------------------
XXXXXXXXXXXXXXXXXXXXXXXXXXXXXXXX--XXXXXXXXXXXXXXXX----------XXXXXXXXX-XXXXXXXXXXXXXXXXXXXX%%%%%%%-%%XXXXXXXXXXXXXXXXXXXXXXXXXXXXXXXXXXXXXXXX----------
XXXXXXXXXXXXXXXXXXXXXXXXXXXXXXXX--XXXXXXXXXXXXXXXX----------XXXXXXXXX-XXXXXXXXXXXXXXXXXXXX||||||---|XXXXXXXXXXXXXXXXXXXXXXXXXXXXXXXXXXXXXXXX----------
