------------------------------------------------------------------------------------------------------------------------------------------------------
------------------------------------------------------------------------------------------------------------------------------------------------------
------------------------------------------------------------------------------------------------------------------------------------------------------
------------------------------------------------------------------------------------------------------------------------SSS-----SS--------------------
-----------------------------------------g-----------------------------------------------------------------------------------------------------------o
----------------------------------------%%---------------------------R--------------------------------oo----------------------------------------------
--------------------S---------S---------|---------------------------------SS---------1----------------------------------US---------------##-----------
---------------------------TT-----------|----oo------------------------------------------------------------------------------------------##-----SSS---
---------------------------TT-----------|-----------------------------------------------------------------------------------SSS--------####-oo--------
---------------------------XX-----------|-------------------------------------------------------g--------------------------------------####-----------
-----------------------TT-----##--SSC---|----------------tt------%%%--SS-----SS----QQQQ---------TT----------------------SSS----------######-SS--------
-----------------K-----TT---------------|----------------tt-------|-----------------------------TT-----------------------------------######-----------
------------B----------TT---------------|----------------tt-------|-----------------------------TT----------tt-----------------------######-----------
-M----------b-------k--TT---------------|------------g-g-tt-------|-----------------yy----------TT----ggg---tt-k----kkk--------------######-----------
XXXXXXXXXXXXXXXXXXXXXXXXXXXXXXXX--XXXXXX|----%%%%-XXXXXXXXXX%%%%%-|-------------XXXXXXXXXXXXXXXXXXX-XXXXXXXXXXXXXXXXXXXXXXX------XXXXXXXXXXX----------
XXXXXXXXXXXXXXXXXXXXXXXXXXXXXXXX--XXXXXX|-----||--XXXXXXXXXX-|||--|-------------XXXXXXXXXXXXXXXXXXX-XXXXXXXXXXXXXXXXXXXXXXX------XXXXXXXXXXX----------
