------------------------------------------------------------------------------------------------------------------------------------------------------
------------------------------------------------------------------------------------------------------------------------------------------------------
------------------------------------------------------------------------------------------------------------------------------------------------------
------------------------------------------------------------------------------------------------------------------------------------------------------
------------------------------------------------------------------------------------------------------------------------------------------------------
--------------------------------------------------------------------------------------------oo--------------------------------------------------------
---------------------------------------------------------------------------g---------1----------------------------------------------------------------
-----------------------------------------------------------------------%%%%%%-------------------------------------------------------------------------
---------------------------------------------------------B--------------||||-----------------------%--------------------------------------------------
---------------------------------------------------------b--------------||||---------------------------------------------------SSS--------------------
----------------!--------------------------------------SS#CS------------||||-------QQQQ---S-----------------------------%-----------------------------
--------------------------------------ttT-----TT---------------------T--||||---------------------------------------------------------TT------------#--
--------------------------------------ttT-----TT-----------K-B-------T--||||-----------------%%%%---------*--------------------------TT--------K---#--
-M-----------------------ggg----------ttT-----TT-------------b-------T--||||--------yy--------||----gg----*----k----kkk----------r---TT------------#--
XXXXXXXXXXXXXXXXXXXXXXXXXXXXXXXXXXXXXXXXXXXX--XXXXXXXXXXXXXXXXXXXX--XX--||||----XXXXXXXXXX----||----XXXXXXXXX-XXXXXXXXXX----XXXXXXXXXXXXXXXXXXXXX--XXX
XXXXXXXXXXXXXXXXXXXXXXXXXXXXXXXXXXXXXXXXXXXX--XXXXXXXXXXXXXXXXXXXX--XX--||||----XXXXXXXXXX----||----XXXXXXXXX-XXXXXXXXXX----XXXXXXXXXXXXXXXXXXXXX--XXX
