------------------------------------------------------------------------------------------------------------------------------------------------------
------------------------------------------------------------------------------------------------------------------------------------------------------
------------------------------------------------------------------------------------------------------------------------------------------------------
----------SSSSSSSSSS--------------------------------------------------------------------------------------------------------------SSSSSSSSSS----------
--------------------------------------------?-----?---------------------------------------------------------------------------------------------------
----------------------------------------------------------------------------------------oo--oo--------------------------------------------------------
--------------------------------------------------------------USSS---------g----oo----------------------SSQSSS-----oo---------------------------------
----------------------------------------------r---SS-------------------%%%%%%------------------------------------------------------------------y------
------------------------------------------%%%%%%------------------------||||-----------------------%-----------------------------------------#SS--o---
-------------------------------------------||||-------------------------||||-----SS-----------------------K---------------------------------##--------
----------------------------TT----------%%-||||ooo-----------S-----TT---||||-------------SS-------------SSSSSS-%%%%--%%%--------------------##--SC----
----------------------------TT--------tt|--||||--r-----SSS---------TT---||||------------------------------------||----||------------------TT##--------
----------------------------TT--------tt|%%%%%%%%%-----------------TT---||||-----------------%%%%---------------||----||-----------tt-----TT##---SSS--
-M----------------------ggg-TT--------tt|-||||||||-----------ggg---TT---||||------------------||--------------o-||----||--kkk------tt----kTT##--------
XXXXXXXXXXX--XX--X--XXXXXXXXXXXXXXXXXXXX|-||||||||----------XXXXXXXXXX--||||------------------||----XXXXXXXXXX%-||----||XXXXXXXXXXXXXXXXXXXXXX------XX
XXXXXXXXXXX--XX--X--XXXXXXXXXXXXXXXXXXXX|-||||||||----------XXXXXXXXXX--||||------------------||----XXXXXXXXXX--||----||XXXXXXXXXXXXXXXXXXXXXX------XX
