------------------------------------------------------------------------------------------------------------------------------------------------------
------------------------------------------------------------------------------------------------------------------------------------------------------
------------------------------------------------------------------------------------------------------------------------------------------------------
------------------------------------------------------------------------------------------------------------------------------------------------------
-----------------------------------------g------------------------------------------------------------------------------------------------------------
-----------------------SSS------------oo%%--------------------------------------K---------------------------------------------------------------------
-----------------------------------SSSS-|---------------------------------SSCSS-SS----1----------------------------------SSS----S!----------SS--------
---------------------g------------------|----oo--------------o---o---o--------------------------------------------------------------------------------
--------------------%%%-----------------|----------------B--%%%-%%%-%%---------------------------------------------------------------g#---------------
------------Q--?----||----SSS-----------|----------------b---|---|---|---------------------o----------------------------------------g##---------------
-------------------S||--------%---------|--------------SS#CS-|---|---|--QQQQ--QQSS---------------TT------------------------------S--###-----SS--------
--------------------||------------------|--------------------|---|---|----------------TT---------TT---------g----------------------####-----------#-TT
--------------------||------------------|------------------K-|---|---|----------------TT---------TT---------TT--------------------#####----------##-TT
------------------K-||----oo------------|--------------------|---|-r-|----------------TT---------TT---------TT-k----kkk-----gg-g-g#####---------###-TT
XXXXXXXXXXXXXXXXXXXX||---%%%----%%%%--%%|----%%%%-XXXXXXXXXX%%%%%%%%%%XXXXXXXXXXXXXXXXXXXXXXXXXXXXXX--XXXXXXXXXXXXXXXXXXXXXXXXXXXXXXXXX--XXXXXXXXXX-XX
XXXXXXXXXXXXXXXXXXXX||----|------||----||-----||--XXXXXXXXXX-|||||||||XXXXXXXXXXXXXXXXXXXXXXXXXXXXXX--XXXXXXXXXXXXXXXXXXXXXXXXXXXXXXXXX--XXXXXXXXXX-XX
