------------------------------------------------------------------------------------------------------------------------------------------------------
------------------------------------------------------------------------------------------------------------------------------------------------------
------------------------------------------------------------------------------------------------------------------------------------------------------
S-----SSSSSSSSSSSSSSSSSSSSSSSS--------------------SSSSSSS---------------------------------------------------------------------------------------------
S-----------------------------------------------------------------------------------------------------------------------------------------------------
S-----------------------------------------------------------------------------------------------------------------------------------------------------
S-------------------------------------------------QQ----------------------------------------------------------?SSS---------------------------------SSS
S-----------------------------------------------------------------------------------------------------------------------------------------------------
S----------------------------------------------------------S----------o--------------------------------------------------------------g#---------------
S----------------------------C----------------------------------------------------o--------------------------------------------SSS--g##---------------
S---------@QQQQ--------#-#-------------T----------QQ--QQQ------------#-----------------TT--------tt-----------SSSSS-----%-----------###-----------#---
S--------------------#-#-#-#-----------T----------------------------##--------#--------TT-T------tt--------------------------------####-----------#---
S----------------g-#-#-#-#-#-----------T--------------------TT-----###-------##--------TT-T------tt-------*-----------------------#####-----------#---
S---------------g#-#-#-#-#-#-E--gg-----T----y-y-------------TT----####-----------------TT-T------tt-gg----*-----K----------------r#####------ggg--#---
XXXXXXXXXXXXXXXXXXXXXXXXXXXXXXXXXXXXXXXXXXXXXXXXXXXXXXXXX---XXXXXXXXXXXXXXXXXXXXXXXXXXXXXXXXXXXXXXXXXXXXXXXXX-XXXXXXXXXX----XXXXXXXXXXX--XXXXXXXXXXXXX
XXXXXXXXXXXXXXXXXXXXXXXXXXXXXXXXXXXXXXXXXXXXXXXXXXXXXXXXX---XXXXXXXXXXXXXXXXXXXXXXXXXXXXXXXXXXXXXXXXXXXXXXXXX-XXXXXXXXXX----XXXXXXXXXXX--XXXXXXXXXXXXX
