------------------------------------------------------------------------------------------------------------------------------------------------------
------------------------------------------------------------------------------------------------------------------------------------------------------
------------------------------------------------------------------------------------------------------------------------------------------------------
-------------------------------------------------------------------SSS--------------------------------------------------------------------------------
------------------------------------------------------------------------------------------------------------------------------------------------------
----------------------------------------ooooo----------oooo---------------------K---------------------------------------------------------------------
---------------------LSSS------------------------------%%%%-----CSS--------g----SS----1---SSS------%--------------------------------------------------
------------------------------------------------SS------||-------------%%%%%%-----------------------oo------------------------------------------------
-----------------------------------------SSSS-----------||--SS--2-------||||-------------------------------------------------SSS----------------------
--------------------------------------------------SSS---||-----2-2------||||--------------------------------------------------------------------------
----------Q----------2-----#----------------------------||--------2-----||||----SS----------%%%--------------T----------r-----------------------------
---------------------------#-----------T--------------U-||--------------||||----------TT-----|---------------T-#--------%%%%%%------------------------
---------------------------##----------T----%%%%%-------||--------------||||----------TT-----|---------------T-#--------|||||----------------------F--
-------------------#--kk---##--------kkT-----|||--------||--------------||||----------TT-----|------------y--T-#----ggg-|||||-----k----------------#--
XXXXXXXXXXXXX--XXXXXXXXXXXXXXXXXXXXXXXXX%%---|||------%%%%%----XXXXXXX--||||----XXXXXXXXXX---|------XXXXXXXXXX-XXXXXXXXX|||||-----XX---XXXXXXXXXXXXXXX
XXXXXXXXXXXXX--XXXXXXXXXXXXXXXXXXXXXXXXX|----|||-------|||-----XXXXXXX--||||----XXXXXXXXXX---|------XXXXXXXXXX-XXXXXXXXX|||||-----XX---XXXXXXXXXXXXXXX
