------------------------------------------------------------------------------------------------------------------------------------------------------
------------------------------------------------------------------------------------------------------------------------------------------------------
------------------------------------------------------------------------------------------------------------------------------------------------------
----------------------------------------SSSSSSSSSS--------------------SSSSSSSSSS--------------------SSSSSSSSSS----------------------------------------
----------------------------------------SSSSSSSS----------------------------SSSS---------------------------------------------------------------------o
----------------------------------------SSSCSSSS---------------------R---g--SSSS----------------------------------------------------------------------
---------------------LSSS---------------SSSSSSSS---------Q-Q------------SS----------------------------------------------SSS---------------------------
------------------------------------------------------------------------SS----------------------------------------------------------------------SSS---
------------------------------------------------------------------------SS--------TT--------------------------------------------------------oo--------
-------------------------------------------ggg--------------------------SC--g-g---TT-----------oooo---------------------------------------------------
----------Q----------2-----#---TT-------SSSSSSSS---------Q-Q-----%%%----SS--SSSS--TT-------------------------T--------r---------------------SS--------
---------------------------#---TT-------SSSSSSSS------------------|---------------TT-----T-------------TT----T----%%%%%%-------------TT---------------
---------------------------##--TT-------SSSSSSSS------------------|-------------T-TT-----T-------------TT----T-----|||||------TT-----TT---------------
-------------------#--kk---##-gTT-------SSSSSSSS------------------|-------------T-TT---k-T----------g--TT----T-----|||||------TT-----TT---------------
XXXXXXXXXXXXX--XXXXXXXXXXXXXXXXXXXXXXX--XXXXXXXXXXXXXXXXXXXX%%%%%-|---XXXXXXXXXXXXXXXXXXXX%%%%%%%-%%XXXXXXXXXX-%%%-|||||----XXXXXXXXXXXXXXXX----------
XXXXXXXXXXXXX--XXXXXXXXXXXXXXXXXXXXXXX--XXXXXXXXXXXXXXXXXXXX-|||--|---XXXXXXXXXXXXXXXXXXXX||||||---|XXXXXXXXXX--|--|||||----XXXXXXXXXXXXXXXX----------
