------------------------------------------------------------------------------------------------------------------------------------------------------
------------------------------------------------------------------------------------------------------------------------------------------------------
------------------------------------------------------------------------------------------------------------------------------------------------------
--------------------SSSSSSSSSS----------SSSSSSSSSS----------SSSSSSSSSS----------ooo-------------------------------------------------------------------
--------------------SSSSSSSSSS----------SSSSSSSS------------SSSS--SSSS----------%%%-------------------------------------------------------------------
--------------------SSSSSSSSSS----------SSSCSSSS------------SSSS--SSSS-----------|--------------------------------------------------------------------
--------------------SSSSSSSSSS----------SSSSSSSS---------Q-Q--SS---S-------g-----|------------------------------------------------%-------------------
--------------------------------------------------------------SS---S---%%%%%%----|------------------oo------------------------------------------------
--------------------------------------------------------------SS---S----||||-----|--------------------------------------------SSS-------SSS-----------
------------Q--?---------------------------ggg--------------ooSS---SoU--||||-----|---%%%%--o----------------------------------------------------------
-------------------S--SSSSSS?--TT-------SSSSSSSS---------Q-QSSSS---SSS--||||-----|----||---------TT----------T----------%---------%%%%%---------------
----------------------SSSSS----TT-------SSSSSSSS------------------------||||----%%%%%%||---------TT----------T-#-------------------|||----------------
----------------------SSSSS----TT-------SSSSSSSS------------------------||||-----||||-||---------TT----------T-#-------------------|||-------------F--
------------------K--------ooogTT-------SSSSSSSS------------k--g-g------||||-----||||-||---------TT-------y--T-#----ggg----------r-|||-------------#--
XXXXXXXXXXXXXXXXXXXX-XXXXXXXXXXXXXXXXX--XXXXXXXXXXXXXXXXXXXXXXXXXXXXXX--||||-----||||-||%%XXXXXXXXXXXXXXXXXXXX-XXXXXXXXX----XXXXXX%|||------XXXXXXXXXX
XXXXXXXXXXXXXXXXXXXX-XXXXXXXXXXXXXXXXX--XXXXXXXXXXXXXXXXXXXXXXXXXXXXXX--||||-----||||-||-|XXXXXXXXXXXXXXXXXXXX-XXXXXXXXX----XXXXXX-|||------XXXXXXXXXX
