------------------------------------------------------------------------------------------------------------------------------------------------------
------------------------------------------------------------------------------------------------------------------------------------------------------
------------------------------------------------------------------------------------------------------------------------------------------------------
----------SSSSSSSSSS------------------------------------------------------------SSSSSSSSSL------------------------------------------------------------
------------------------------------------------------------------------------------------------------------------------------------------------------
----------------------ooor------------oo%%---------------------------R--------------------------------------------------------------------------------
---------------------%%%%%---------SSSS-|----------------------------------g--------oooooo--------------SSQSSS--------------------!S------------------
----------------------|||---------------|----oo------------------------%%%%%%---------------------oo------------oooo----------------------------------
----------------------|||---------------|-------------------------------||||--------SSSSSS-----------------------------------SSS----------------------
----------------------|||---------------|----------------o--------------||||--------SSSSSS----------------K-------------------------------------------
--------------------%%%%%%%---%---------|------------------------%%%----||||----------------------------SSSSSST---------r---------S------#----#LSS----
--------------------||||||--------------|-------------------------|-----||||--------------------#-------------T---------%%%%%%----------##----#-------
--------------------||||||--o-----------|-------------------------|-----||||--------------------#-------------T---------|||||----------###----#-------
-M------------------||||||-%%%----------|-----------k-------------|-----||||--------------------#-------------T---y-----|||||---------####--kk#-------
XXXXXXXXXXX--XX--X--||||||--|---%%%%--%%|----%%%%--XXXXXXXXX%%%%%-|-----||||-------XXXXXXXXXXXXXXXXXXXXXXXXXXXXXXXXXXXXX|||||-----XXXXXXXXXXXXXXXXX---
XXXXXXXXXXX--XX--X--||||||--|----||----||-----||---XXXXXXXXX-|||--|-----||||-------XXXXXXXXXXXXXXXXXXXXXXXXXXXXXXXXXXXXX|||||-----XXXXXXXXXXXXXXXXX---
