------------------------------------------------------------------------------------------------------------------------------------------------------
------------------------------------------------------------------------------------------------------------------------------------------------------
------------------------------------------------------------------------------------------------------------------------------------------------------
--------------------SSSSSSSSSS------------------------------------------------------------------------------------------------------------------------
--------------------SSSSSSSSSS------------------------------------------------------------------------------------------------------------------------
--------------------SSSSSSSSSS--------oo-----------------------------R------------------oo--oo--------------------------------------------------------
--------------------SSSSSSSSSS-----SSSS-----------------------------------SS----oo----------------------------------------SSC------SSSS---------------
----------------------------------------------------------------------------------------------------oo------------------------------------------------
---------------------------------------------------------B-----------------------------------------%--------------------------------------------------
---------------------------------------------------------b-----------------------SSS--------------------------------------SSS----------SSSS-----------
---------QQ-----------SSSSSS?-%------------------------SS#CS-----%%%--SS-----SS----------SSS-----------------T--!-----S-----------------------#LSS----
----------------------SSSSS---------------------------------------|------------------------------------------T--------------------------------#-------
----------------------SSSSS--------------------------------K------|--------------------------%%%%------------T--------------------------------#-------
-M-----------------#-------ooo-----------------ggg----------------|---------------------------||----------y--T-------------------#----------kk#-------
XXXXXXXXXXXXX--XXXXX-XXXXXXXXX--%%%%--%%-XXXXXXXXXXXXXXXXXXX%%%%%-|---------------------------||----XXXXXXXXXXXXXXXXXXXXX----XXXXX---------XXXXXXXX---
XXXXXXXXXXXXX--XXXXX-XXXXXXXXX---||----|-XXXXXXXXXXXXXXXXXXX-|||--|---------------------------||----XXXXXXXXXXXXXXXXXXXXX----XXXXX---------XXXXXXXX---
