------------------------------------------------------------------------------------------------------------------------------------------------------
------------------------------------------------------------------------------------------------------------------------------------------------------
------------------------------------------------------------------------------------------------------------------------------------------------------
-------------------------------------------------------------------SSS------------------------------SSSSSSSSSS----------------------------------------
------------------------------------------------------------------------------------------------------------------------------------------------------
--------------------------------------------------------------------------------------------oo--------------------------------------------------------
----------------------------------------------QQQQ--------------CSS----------------o--o-------------------------------------------%-------------------
------------------------------------------------------------------------------------------------------------------------------------------------------
------------------------------------------------------------SS--2----------------------------------%------------------------------------SSS-----------
------------------------------------------------k--------o-----2-2-------1---------SSSS---------------------------------------------------------------
---------Q------------------------------T-----?QQQ----------------2---T-------------------S----------------TT---------------------%%%%%---------------
-----------------K----------------------T-----------------------------T----TT---------------------------#--TT--#-------------------|||----------------
------------B---------------------------T-----------------------------T----TT---%%%----------%%%%------##--TT--#-------------------|||-------------F--
------------b------------ggg------k-k---T-----------k-----------------T---kTT---||------------||----kk-##--TT--#----ggg--k----ggg--|||-------------#--
XXXXXXXXXXXXXXXXXXXXXXXXXXXXXXXXXXXXXXX-XXXXXXXXXX-XXXXXXXXX---XXXXXXXXXXXXXXXXX||------------||----XXXXX--XX--XXXXXXXXXXXXXXXXXXX%|||------XXXXXXXXXX
XXXXXXXXXXXXXXXXXXXXXXXXXXXXXXXXXXXXXXX-XXXXXXXXXX-XXXXXXXXX---XXXXXXXXXXXXXXXXX||------------||----XXXXX--XX--XXXXXXXXXXXXXXXXXXX-|||------XXXXXXXXXX
