------------------------------------------------------------------------------------------------------------------------------------------------------
------------------------------------------------------------------------------------------------------------------------------------------------------
------------------------------------------------------------------------------------------------------------------------------------------------------
S-----SSSS------------------------------SSSSSSSSSS--------------------SSSSSSSSSSSSSSSSSSSLSSSSSSSSSS--------------------------------------------------
S---------------------------------------SSSSSSSS----------------------------SSSS----------------------------------------------------------------------
S---------------------ooor--------------SSSCSSSS-------------------------g--SSSS----------------------------------------------------------------------
S--------------------%%%%%--------------SSSSSSSS------------------------SS----------oooooo--------------------?SSS---------------------US-------------
S---------------------|||-----------------------------------------------SS----------------------------------------------------------------------------
S---------------------|||--------------------------------TT-------------SS----------SSSSSS------------------------------------------------------------
S---------------------|||------------------ggg-----TT----TT-------------SC--g-g-----SSSSSS-------------------------------------------SS---------------
S------------------%%%%%%%%------------TSSSSSSSS---TT----XX-------------SS--SSSS------------------------------SSSSS------------------------S----------
S-------------------||||||-------------TSSSSSSSS---TT-------------------------------------t-----------TT----------------------------------------------
S-------------------||||||--o----------TSSSSSSSS---TT-------------------------------------t-----------TT----TT--------------------TT---------------F--
S------------%%%%---||||||-%%%--gg-----TSSSSSSSS---TT-------gg-------g--------------------t-----------TT-k--TT--K---------kkk-----TT---------------#--
XXXXXXXXXXX---||----||||||--|-XXXXXXXXXXXXXXXXXXXXXXXXXXXXXXXXXXXXXXXXXXXXXXXXXX---XXXXXXXXXXXXXXXXXXXXXXXXXXXXXXXXXXXXXXXXXXXXXXXXXXXXX-X-XXXXXXXXXXX
XXXXXXXXXXX---||----||||||--|-XXXXXXXXXXXXXXXXXXXXXXXXXXXXXXXXXXXXXXXXXXXXXXXXXX---XXXXXXXXXXXXXXXXXXXXXXXXXXXXXXXXXXXXXXXXXXXXXXXXXXXXX-X-XXXXXXXXXXX
