------------------------------------------------------------------------------------------------------------------------------------------------------
------------------------------------------------------------------------------------------------------------------------------------------------------
------------------------------------------------------------------------------------------------------------------------------------------------------
------------------------------------------------------------------------------------------------------------------------SSS-----SS--------------------
-----------------------------------------------------------------------------------------------------------------------------------------------------o
----------------------------------------%%--------------------------------------K---------------------------------------------------------------------
------------------SC--------------------|---------Q-----------USSS--------SSCSS-SS----1---------------------------------US--------%-------------------
----------------------------------------|----oo-----------------------------------------------------------TT------------------------------------SSS---
----------------------------------------|-----------------------------------------------------------------TT----------------SSS---------SSS-oo--------
----------------------------------------|-----------------------------------------------------------------TT------------------------------------------
-----SSS------TT---2--------------------|---------Q----------S-----TT---QQQQ--QQSS--------------TT-------SXXS---!-----S-SSS-------%%%%%-----SS--------
--------------TT----------------------K-|--------------------------TT-----------------TT--------TT---------------------------------|||----------------
--------------TT--------------TTTT------|--------------------------TT-----------------TT--------TT--TT-----------------------------|||----------------
--------------TT---------ggg--TTTT------|------------gg----k-ggg---TT-----------------TT----k---TT--TT-----------------------------|||----------------
XXXXXXXXXXXXXXXXXXXXXXXXXXXXXXXXXXXXXXXX|----%%%%-XXXXXXXXXXXXXXXXXXXXXXXXXXXXXXXXXXXXXXXXXXXXXXXXXXXXXXXXXXXXXXXXXXXXXXXXX------X%|||----------------
XXXXXXXXXXXXXXXXXXXXXXXXXXXXXXXXXXXXXXXX|-----||--XXXXXXXXXXXXXXXXXXXXXXXXXXXXXXXXXXXXXXXXXXXXXXXXXXXXXXXXXXXXXXXXXXXXXXXXX------X-|||----------------
