------------------------------------------------------------------------------------------------------------------------------------------------------
------------------------------------------------------------------------------------------------------------------------------------------------------
------------------------------------------------------------------------------------------------------------------------------------------------------
--------------------SSSSSSSSSS------------------------------------------------------------------------------------------------------------------------
------------------------------------------------------------------------------------------------------------------------------------------------------
---------------------------------------------------------------------R----------------------oo---------------------k----------------------------------
---------------------------------------------------------------------------g---------SSSS---------------SSQSSSS---SSSSSS--oo---%%%-------##--QQQQ-----
-----------------------------------------------------------------------%%%%%%---------------------------------------------SS----||-------##-----------
---------------------------------------------------------B--------------||||-----------------------%----------------------------||-----####-----------
-----------------------------C---------------------------b--------------||||------------------------------K---------------------||-----####----y------
-----------------------#-#-----------------------------SS#CS-----%%%----||||----Q---------S-------------SSSSSS---------------SS-||---######-Q?SSQQQ---
---------------------#-#-#-#----------K-T-----TT------------------|-----||||----------------------------------------------------||---######-----------
---------------------#-#-#-#--TTTT------T-----TT-----------K------|-----||||-----------------%%%%-------------TT----------------||---######-----------
-M--------k---ggg----#-#-#-#-ETTTT------T-----TT------------------|-----||||-----ggg----------||--------------TT----------------||---######-----------
XXXXXXXXXXXXXXXXXXXXXXXXXXXXXXXXXXXXXXXXXXXX--XXXXXXXXXXXXXX%%%%%-|-----||||----XXXXX----X----||----XXXXXXXXXXXXXXXXXX--%%-----%%%XXXXXXXXXXXX--XXXXXX
XXXXXXXXXXXXXXXXXXXXXXXXXXXXXXXXXXXXXXXXXXXX--XXXXXXXXXXXXXX-|||--|-----||||----XXXXX----X----||----XXXXXXXXXXXXXXXXXX--|-------||XXXXXXXXXXXX--XXXXXX
