------------------------------------------------------------------------------------------------------------------------------------------------------
------------------------------------------------------------------------------------------------------------------------------------------------------
------------------------------------------------------------------------------------------------------------------------------------------------------
S-----SSSS--------------------------------------------------------------------------------SSSSSSSSSS--------------------------------------------------
S-----------------------------------------------------------------------------------------------------------------------------------------------------
S---------------------ooor------------oo------------------------------------------g-------------------------------------------------------------------
S--------------------%%%%%---------SSSS-----------Q-----------------------SSCSS-SSSSSSSS--------------------------------SS--------!S------------------
S---------------------|||-----------------------------------------------------------------------------------------------------------------------------
S----------------%%%--|||-----------------------------------------------------------------------------------------------------------------------------
S-----------------||--|||--------------------------------------------------------------------------------------------------TT-------------------------
S-----------------||%%%%%%%---%-------------------Q------------------T--QQQQ--QQ-------------------------------------------TT-----S------#------------
S------------%%%%%||||||||-------------------------------------------T-----------------------------------------#--------t--TT-----------##---------#--
S-------------|||-||||||||--o----------------------------------------T------------------------------------*----#--------t--TT----------###-----K---#--
S--M----------|||-||||||||-%%%-----------------ggg---gg----k--ggg----T--------------------------g-g-gg----*----#----ggg-t--TT---------####---------#--
XXXXXXXXXXX---|||-||||||||--|---%%%%--%%-XXXXXXXXXXXXXXXXXXXXXXXXXXXXXXXXXXXXXXXXXXXXX---XXXXXXXXXXXXXXXXXXXX--XXXXXXXXXXXXXXXXXXXXXXXXXXXXXXXXXX--XXX
XXXXXXXXXXX---|||-||||||||--|----||----|-XXXXXXXXXXXXXXXXXXXXXXXXXXXXXXXXXXXXXXXXXXXXX---XXXXXXXXXXXXXXXXXXXX--XXXXXXXXXXXXXXXXXXXXXXXXXXXXXXXXXX--XXX
