------------------------------------------------------------------------------------------------------------------------------------------------------
------------------------------------------------------------------------------------------------------------------------------------------------------
------------------------------------------------------------------------------------------------------------------------------------------------------
--------------------------------------------------------------------------------SSSSSSSSSL----------SSSSSSSSSS----------SSSSSSSSSSSSSSSSSSSS----------
------------------------------------------------------------------------------------------------------------------------------------------------------
------------------------------------------------------------------------------------------------------------------------------------------------------
---------------------------------------------------------Q-Q--------------SSCSS-----oooooo---------------------------------------------------------SSS
------------------------------------------------------------------------------------------------------------------------------------------------------
------------------------------------------------------------------------------------SSSSSS------------------------------------------------------------
------------------------------------------------------------------------------------SSSSSS------------------------------------------------------------
----------------!---SS-----------------------------------Q-Q------------QQQQ--QQ-----------------tt----------T------------------------------------#---
---------------------K---TT-------------T-----TT------------------------------------------T------tt----TT----T------------SS--------------TT------#---
-------------------------TT-------------T-----TT------------------------------------------T------tt----TT----T------------SS-------tt-----TT------#---
-------------------------TT-------k-k---T-----TT------------gg-------g--------------------T------tt-g--TT----T-k----kkk---SS-------tt----kTT-ggg--#---
XXXXXXXXXXXXXXXXXXXXXXXXXXXXXXXXXXXXXXX-XXXX--XXXXXXXXXXXXXXXXXXXXXXXXXXXXXXXXXX---XXXXXXXXXXXXXXXXXXXXXXXXXXXXXXXXXXXXX--XX--XXXXXXXXXXXXXXXXXXXXXXXX
XXXXXXXXXXXXXXXXXXXXXXXXXXXXXXXXXXXXXXX-XXXX--XXXXXXXXXXXXXXXXXXXXXXXXXXXXXXXXXX---XXXXXXXXXXXXXXXXXXXXXXXXXXXXXXXXXXXXX--XX--XXXXXXXXXXXXXXXXXXXXXXXX
