------------------------------------------------------------------------------------------------------------------------------------------------------
------------------------------------------------------------------------------------------------------------------------------------------------------
------------------------------------------------------------------------------------------------------------------------------------------------------
S-----SSSS--------------------SSSSSSSSSS--------------------SSSSSSSSSS--------------------------------------------------------------------------------
S----------------------------------------g------------------SSSS--SSSS--------------------------------------------------------------------------------
S---------------------------------------%%------------------SSSS--SSSS--------------------------------------------------------------------------------
S---------------------------------------|---------------------SS---S-----------------------------------------R--------US-SSS----S!--------------------
S---------------------------------------|----oo---------------SS---S-------------------------------------r--------------------------------------------
S--------------------------------------S|----------------TT---SS---S--------------------------------%%%%%%%--------------------------g#---------------
S--------------------------------------S|----------TT----TT-ooSS---SoU---1--------o-----------------||||||----------E---------------g##---------------
S------------------%-------------------S|----------TT----XX-SSSS---SSST----------------TT-----------||||||---------TT------------S--###---------------
S------------------------------#--------|----------TT-----------------T----TT----------TT-----------||||||---------TT--t-----------####---------------
S------------------------------#-#------|----------TT-----------------T----TT----------TT--------B--||||||---------TT--t----------#####------------F--
S--M---------%%%%--------ggg---#-#------|----------TT-------k--g-g----T---kTT----------TT--------b--||||||--oo--g--TT--t----gg-g-g#####------------#--
XXXXXXXXXXX---||----XXXXXXXXXXXXXXXXXXXX|----%%%%-XXXXXXXXXXXXXXXXXXXXXXXXXXXXXXXXXXXXXXXXXXXXXXXXXX||||||--%%XXXXXXXXXXXXXXXXXXXXXXXXX--XXXXXXXXXXXXX
XXXXXXXXXXX---||----XXXXXXXXXXXXXXXXXXXX|-----||--XXXXXXXXXXXXXXXXXXXXXXXXXXXXXXXXXXXXXXXXXXXXXXXXXX||||||---|XXXXXXXXXXXXXXXXXXXXXXXXX--XXXXXXXXXXXXX
