------------------------------------------------------------------------------------------------------------------------------------------------------
------------------------------------------------------------------------------------------------------------------------------------------------------
------------------------------------------------------------------------------------------------------------------------------------------------------
------------------------------------------------------------------------------------------------------------------------------------------------------
------------------------------------------------------------------------------------------------------------------------------------------------------
----------------------------------------------------------------------------------------oo------------------------------------------------------------
--------------------------------------------------Q-----------------------SS----oo------------------------------------US----------SS------------------
------------------------------------------------------------------------------------------------------------------------------------------------------
------------------------------------------------------------------------------------------------------------------------------------------------------
---------------------------------------------------------------------------------SSS-------o------------------------E----------SSS--------------------
-------------------%SS-------------------TT---SU--Q-------------------SS-----SS----------S-------TT---%%%%%%-------TT---%---------SS------------------
---------------------K---TT------------T-TT------------------------------------------------------TT----||||--------TT--t----------K---#----B----------
-------------------------TT------------T-TT------------------------------------------------------TT----||||--------TT--t--------------#----b-------F--
-M-----------%%%%--------TT----------kkT-TT------k---gg----kgg-------g---------------------------TT----||||-----g--TT--t---------r----#----B-------#--
XXXXXXXXXXX---||----XXXXXXXXXXXXXXXXXXXXXXXXXXXXXXXXXXXXXXXXXXXXXXXXXX--------------------XXXXXXXXXX%%-||||-%%XXXXXXXXXX----XXXXXXXXXXXXXXXXXXXXXXXXXX
XXXXXXXXXXX---||----XXXXXXXXXXXXXXXXXXXXXXXXXXXXXXXXXXXXXXXXXXXXXXXXXX--------------------XXXXXXXXXX|--||||--|XXXXXXXXXX----XXXXXXXXXXXXXXXXXXXXXXXXXX
