------------------------------------------------------------------------------------------------------------------------------------------------------
------------------------------------------------------------------------------------------------------------------------------------------------------
------------------------------------------------------------------------------------------------------------------------------------------------------
------------------------------------------------------------SSSSSSSSSS--------------------------------------------------------------------------------
------------------------------------------------------------SSSS--SSSS--------------------------------------------------------------------------------
----------------------ooor----------------------------------SSSS--SSSS--------------------------------------------------------------------------------
------------------SC-%%%%%------------------------------------SS---S--------SSSS---o--o----SSS!--------------------oo---------------------------------
----------------------|||-------------------------------------SS---S--------------------------------------TT----------------------oo------------------
----------------------|||-------------------------------------SS---S--------------------------------------TT------------------------------------------
----------------------|||--------------------------------o--ooSS---SoU-------K-----SSSS-------------------TT------------SS-?Q-------------------------
--------------TT---2%%%%%%%--------------TT---SU------------SSSS---SSS-----SSSSS--------------C----------SXXS--%%%%--%%%-------------------Q--#LSS----
--------------TT----||||||------------K--TT---------------------------T-----------------------------------------||----||----------------------#-------
--------------TT----||||||--o-TTTT-------TT---------------------------T---------%%%-----------------TT----------||----||-------y--------------#-------
---M----------TT----||||||-%%%TTTT-------TT------k--k-------k--g-g----T---------||-------------g-g--TT--------o-||----||---SSSSS------------kk#-------
XXXXXXXXXXXXXXXXXXXX||||||--|-XXXXXXXXXXXXXXXXXXXX-XXXXXXXXXXXXXXXXXXXXXXXXXXXXX||--------XXXXXXXXXXXXXXXXXXXX%-||----||-------XX-XXXXXXXXXXXXXXXXX---
XXXXXXXXXXXXXXXXXXXX||||||--|-XXXXXXXXXXXXXXXXXXXX-XXXXXXXXXXXXXXXXXXXXXXXXXXXXX||--------XXXXXXXXXXXXXXXXXXXX--||----||-------XX-XXXXXXXXXXXXXXXXX---
