------------------------------------------------------------------------------------------------------------------------------------------------------
------------------------------------------------------------------------------------------------------------------------------------------------------
------------------------------------------------------------------------------------------------------------------------------------------------------
--------------------------------oo------SSSSSSSSSS------------------------------ooo-----------------------------------------------SSSSSSSSSS----------
---------------------------------------gSSSSSSSS--------------------------------%%%-------------------------------------------------------------------
-----------------------------------%%%%%SSSCSSSS---------------------------------|--------------------------------------------------------------------
----------------------!-------------||||SSSSSSSS---------------------------------|---------------------------@-----------SSS----S!--------------------
------------------------------------||||-----------------------------------------|--------------------------------------------------------------------
-----------------g------------------||||-----------------------------------------|--------------------------------------------------------------------
-----------------#------------%%%%%-||||---ggg-----------------------------------|---%%%%--o----------------------------------------------------------
----------S-----##--S@S!S------|||--||||SSSSSSSS------S--------------#-----------|----||---------TT-SU----!--!--------r----------S--------------------
---------------###-------------|||--||||SSSSSSSS--TT----------------##----------%%%%%%||---------TT---------------%%%%%%------------------TT----------
--------------####----------tt-|||--||||SSSSSSSS--TT--------TT-----###-----------||||-||---------TT----------------|||||-----------tt-----TT-------F--
-M-----------#####---g------tt-|||--||||SSSSSSSS--TT------k-TT----####gg---------||||-||---------TT-------k--------|||||----gg-g-g-tt----kTT-------#--
XXXXXXXXXXXXXXXXXXXXXXXXXXXXXX-|||--||||XXXXXXXXXXXXXXXXXXXXXXXXXXXXXXXXXXXXXXXX-||||-||%%XXXXXXXXXXXXXXXXXXXX-%%%-|||||XXXXXXXXXXXXXXXXXXXXXXXXXXXXXX
XXXXXXXXXXXXXXXXXXXXXXXXXXXXXX-|||--||||XXXXXXXXXXXXXXXXXXXXXXXXXXXXXXXXXXXXXXXX-||||-||-|XXXXXXXXXXXXXXXXXXXX--|--|||||XXXXXXXXXXXXXXXXXXXXXXXXXXXXXX
