------------------------------------------------------------------------------------------------------------------------------------------------------
------------------------------------------------------------------------------------------------------------------------------------------------------
------------------------------------------------------------------------------------------------------------------------------------------------------
------------------------------------------------------------------------------------------------------------------------------------------------U-----
-----------------------------------------g------------------------------------------------------------------------------------------------------------
----------------------------------------%%----------------------------------------------oo--oo--------------------------------------------------------
----------------------------------------|----------------Q-Q------SSoo--SSSSS---oo--------------------------------------SS----------------------------
----------------------------------------|----oo-----------------------------------------------------oo--------------------------------------------SS--
----------------------------------------|----------------------------------------------------------%-------------------y------------------------------
----------------------------------------|----------------------------------------SS------------------------------------X---TT-----------------SS------
---------QQ-----------------TT----------|----------------Q-Q%%%%%%-----------2-----------SS------------------T--------XX---TT------------------------#
----------------------------TT--------K-|--------------------||||----------TT--------------------------------T-------XXXt--TT--------TT-------------##
----------------------------TTTTTT------|--------------------||||-----t----TT--T-------------%%%%------------T------XXXXt--TT--------TT------------###
-M-----------------#----ggg-TTTTTT------|--------------------||||-----t----TT--T--------------||----------y--T-----XXXXXt--TT--------TT-----------####
XXXXXXXXXXXXX--XXXXXXXXXXXXXXXXXXXXXXXXX|----%%%%-XXXXXXXXXX-||||-----XXXXXXXXXX--------------||----XXXXXXXXXXXXXXXXXXXXXXXXXXXXXXXXXXXXXXXXXXXXX-XXXX
XXXXXXXXXXXXX--XXXXXXXXXXXXXXXXXXXXXXXXX|-----||--XXXXXXXXXX-||||-----XXXXXXXXXX--------------||----XXXXXXXXXXXXXXXXXXXXXXXXXXXXXXXXXXXXXXXXXXXXX-XXXX
