------------------------------------------------------------------------------------------------------------------------------------------------------
------------------------------------------------------------------------------------------------------------------------------------------------------
------------------------------------------------------------------------------------------------------------------------------------------------------
--------------------------------------------------SSSSSSS---------------------------------------------------------------------------------------------
------------------------------------------------------------------------------------------------------------------------------------------------------
---------------------------------------------------------------------R--------------------------------------------------------------------------------
--------------------------------------------------QQ---------------------------------------SSS!------------------------------------------##--QQQQ-----
-----------------------------------------------------------------------------------------------------------------------------------------##-----------
-----------------------------------------------------------S----------------------TT---------------------------------------------------####-----------
------------Q--?---------------------------------------------------------1--------TT------------------------------------SS-?Q----------####----y------
-------------------S-----------TT-----------------QQ--QQQ--------%%%--T-----------TT----------C-------%%%%%%-------------------------######-Q?SSQQQ---
-------------------------------TT---------------------------------|---T----TT-----TT-----T-------------||||--------------------------######-----------
-------------------------------TT---------------------------------|---T----TT---T-TT-----T-------------||||--------------------y-----######-----------
-M----------------K------ggg--gTT--------------ggg----------------|---T---kTT---T-TT---k-T-----g-g-----||||----k----kkk----SSSSS-----######-----------
XXXXXXXXXXXXXXXXXXXXXXXXXXXXXXXXXXXXXX---XXXXXXXXXXXXXXXX---%%%%%-|---XXXXXXXXXXXXXXXXXXXXXXXXXXXXXX%%-||||-%%XXXXXXXXXX-------XX-XXXXXXXXXXXX--XXXXXX
XXXXXXXXXXXXXXXXXXXXXXXXXXXXXXXXXXXXXX---XXXXXXXXXXXXXXXX----|||--|---XXXXXXXXXXXXXXXXXXXXXXXXXXXXXX|--||||--|XXXXXXXXXX-------XX-XXXXXXXXXXXX--XXXXXX
