------------------------------------------------------------------------------------------------------------------------------------------------------
------------------------------------------------------------------------------------------------------------------------------------------------------
------------------------------------------------------------------------------------------------------------------------------------------------------
--------------------------------------------------SSSSSSS-----------------------------------------------------------------------------------SSSSSSSSSS
------------------------------------------------------------------------------------------------------------------------------------------------------
--------------------------------------oo%%----------------------------------------------oo--oo--------------------------------------------------------
------------------SC---------------SSSS-|---------QQ--------------SSoo----------oo--------------------------------------SS---------SSSS---------------
----------------------------------------|----oo-----------------------------------------------------oo----------oooo----------------------------------
----------------------------------------|------------------S---------------------------------------%--------------------------------------------------
----------------------------------------|----------------------------------------SS----------------------------------------TT----------SSSS-----------
--------------TT---2--------TT%---------|---------QQ--QQQ---%%%%%%-----------------------SSS-----------------TT------------TT-----------------TT------
--------------TT------------TT----------|--------------------||||--------------------------------------------TT---------t--TT-----------------TT------
--------------TT------------TT----------|--------------------||||----------------------------%%%%------------TT---------t--TT-----------------TT------
-M------------TT--------ggg-TT----------|--------------------||||-----gg----------------------||----------y--TT---y-----t--TT-----------------TT------
XXXXXXXXXXXXXXXXXXXXXXXXXXXXXX--%%%%--%%|----%%%%-XXXXXXX----||||-----XXXXXXXXXX--------------||----XXXXXXXXXXXXXXXXXXXXXXXXXXXXXX---------XXXXX--XXXX
XXXXXXXXXXXXXXXXXXXXXXXXXXXXXX---||----||-----||--XXXXXXX----||||-----XXXXXXXXXX--------------||----XXXXXXXXXXXXXXXXXXXXXXXXXXXXXX---------XXXXX--XXXX
