------------------------------------------------------------------------------------------------------------------------------------------------------
------------------------------------------------------------------------------------------------------------------------------------------------------
------------------------------------------------------------------------------------------------------------------------------------------------------
------------------------------------------------------------------------------------------------------------------------------------------------------
------------------------------------------------------------------------------------------------------------------------------------------------------
--------------------------------------oo-----------------------------R--------------------------------------------------------------------------------
--------------------USS------------SSSS----------------------------------------------1--------------------------------US-SSS----S!-------##--QQQQ-----
-----------------------------------------------------------------------------------------------------------------------------------------##-----------
---------------------------------------------------------------------------------------------------------------------------------------####-----------
-----------------------------------------------------------------------------------------------oooo-----------------E------------------####----y------
----------------%%%%----------%----------------------------------%%%---------------QQQQ---------------%%%%%%-------TT------------S---######-Q?SSQQQ---
-----------------||--B------------------------------K-------------|------------------------------------||||--------TT--t-------------######-----------
-----------------||--b-------B------------------------------------|------------------------------------||||--------TT--t-------------######-----------
---M-------------||--B-------b-----------------y-----------g------|---gg------------yy-----------------||||-----g--TT--t----gg-g-g---######-----------
XXXXXXXXXXX--%%%%||%XXXXXXXXXX--%%%%--%%XXXXXXXXXXXXXXXXXXXX%%%%%-|---XXXXXXXXXXXXXXXXXXXX%%%%%%%-%%%%-||||-%%XXXXXXXXXXXXXXXXXXXXXXXXXXXXXXXX--XXXXXX
XXXXXXXXXXX---||-||-XXXXXXXXXX---||----|XXXXXXXXXXXXXXXXXXXX-|||--|---XXXXXXXXXXXXXXXXXXXX||||||---||--||||--|XXXXXXXXXXXXXXXXXXXXXXXXXXXXXXXX--XXXXXX
