------------------------------------------------------------------------------------------------------------------------------------------------------
------------------------------------------------------------------------------------------------------------------------------------------------------
------------------------------------------------------------------------------------------------------------------------------------------------------
-------------------------------------------------------------------SSS------------------------------SSSSSSSSSS----------------------------------------
-----------------------------------------------------------------------------------------------------------------------------------------------------o
------------------------------------------------------------------------------------------------------------------------------------------------------
--------------------USS-----------------------------------------CSS--------g---------SSSS-------------------------------------------------------------
-----------------------------------------------------------------------%%%%%%-----------------------------------------------------oo------------SSS---
------------------------------------------------------------SS--2-------||||----------------------------------------------------------------oo--------
---------------------------------------------------------------2-2------||||---------------o-----------------------------------SSS--------------------
-------------------%-----------TT---------------------------------2-----||||----Q----------------TT--------TT-----------%------------------QSS--------
---------------------B---------TT-------------------K-------------------||||---------------------TT-----#--TT-----------------------------------------
---------------------b-------B-TT---------------------------------------||||---------------------TT----##--TT-----------------------------------------
-M-----------%%%%----B-------bgTT--------------ggg---------g------------||||-----ggg-------------TT-kk-##--TT--k----kkk----------r--------------------
XXXXXXXXXXX---||----XXXXXXXXXXXXXXXXXX---XXXXXXXXXXXXXXXXXXX---XXXXXXX--||||----XXXXX----XXXXXXXXXXXXXXXX--XX-XXXXXXXXXX----XXXXXXXXXXXXXXXX----------
XXXXXXXXXXX---||----XXXXXXXXXXXXXXXXXX---XXXXXXXXXXXXXXXXXXX---XXXXXXX--||||----XXXXX----XXXXXXXXXXXXXXXX--XX-XXXXXXXXXX----XXXXXXXXXXXXXXXX----------
