------------------------------------------------------------------------------------------------------------------------------------------------------
------------------------------------------------------------------------------------------------------------------------------------------------------
------------------------------------------------------------------------------------------------------------------------------------------------------
----------------------------------------SSSSSSSSSS--------------------------------------------------------------------------------SSSSSSSSSS----------
----------------------------------------SSSSSSSS------------------------------------------------------------------------------------------------------
----------------------------------------SSSCSSSS-------oooo--------------------------------------------------------k----------------------------------
----------------------!-----------------SSSSSSSS-------%%%%----------------g---------1-----SSS!---------------S---SSSSSS------------------------------
--------------------------------------------------------||---o---o---o-%%%%%%------------------------------------------------------------------y------
--------------------------------------------------------||--%%%-%%%-%%--||||-----------------------------------------------------------------#SS--o---
-------------------------------------------ggg----SSS---||---|---|---|--||||---------------------------------------------------SSS----------##--------
----------------%%%%S@S!S--------------TSSSSSSSS--------||---|---|---|--||||-------QQQQ-------C-------%%%%%%------------%-------------------##--SC----
-----------------||--------------------TSSSSSSSS------U-||---|---|---|--||||---------------------------||||-------------------------------TT##--------
-----------------||---------tt---------TSSSSSSSS--------||---|---|---|--||||---------------------------||||---TT-------------------tt-----TT##---SSS--
---M-------------||--g------tt--gg-----TSSSSSSSS--------||---|---|-r-|--||||--------yy---------g-g-----||||---TT-----------------r-tt----kTT##--------
XXXXXXXXXXX--%%%%||%XXXXXXXXXXXXXXXXXXXXXXXXXXXXXX----%%%%%-%%%%%%%%%%--||||----XXXXXXXXXXXXXXXXXXXX%%-||||-%%XXXXXXXX------XXXXXXXXXXXXXXXXXX------XX
XXXXXXXXXXX---||-||-XXXXXXXXXXXXXXXXXXXXXXXXXXXXXX-----|||---|||||||||--||||----XXXXXXXXXXXXXXXXXXXX|--||||--|XXXXXXXX------XXXXXXXXXXXXXXXXXX------XX
