------------------------------------------------------------------------------------------------------------------------------------------------------
------------------------------------------------------------------------------------------------------------------------------------------------------
------------------------------------------------------------------------------------------------------------------------------------------------------
--------------------------------------------------------------------------------SSSSSSSSSL------------------------------------------------------------
-------------------------------------------------------------------------o----------------------------------------------------------------------------
----------------------ooor------------------------------------g---------%%%---------------------------------------------------------------------------
---------------------%%%%%------------------------------------SSSSS------|--o-------ooooooSSS------%--------------------------------------------------
----------------------|||------------------------------------------------|--SSSS----------------------------------------------------------------------
----------------------|||--------------------------------B------------%--|----------SSSSSS-----------------------------------SSS----------------------
------------Q--?------|||--------------------------------b---------------|----------SSSSSS------------------------------------------------------------
---------Q---------S%%%%%%%------------T---------------SS#CS-------------|------------------%%%-------%%%%%%------------r-----------------------------
--------------------||||||-------------T---------------------------------|-------------------|---------||||----#--------%%%%%%------------------------
--------------------||||||--o----------T-------------------K--TT-----t---|-----%-------------|---------||||----#--------|||||----------------------F--
------------------K-||||||-%%%--gg-----T----------------------TT-----t---|-------------------|---------||||----#----ggg-|||||-----k----------------#--
XXXXXXXXXXXXXXXXXXXX||||||--|-XXXXXXXXXXX-XX-XX-XXXXXXXXXXXXXXXXXXXXXX%%%%%%-------XXXXXXX---|------%%-||||-%%-XXXXXXXXX|||||-----XX---XXXXXXXXXXXXXXX
XXXXXXXXXXXXXXXXXXXX||||||--|-XXXXXXXXXXX-XX-XX-XXXXXXXXXXXXXXXXXXXXXX|||||--------XXXXXXX---|------|--||||--|-XXXXXXXXX|||||-----XX---XXXXXXXXXXXXXXX
