------------------------------------------------------------------------------------------------------------------------------------------------------
------------------------------------------------------------------------------------------------------------------------------------------------------
------------------------------------------------------------------------------------------------------------------------------------------------------
------------------------------------------------------------------------------------------SSSSSSSSSS--------------------------------------------------
------------------------------------------------------------------------------------------------------------------------------------------------------
------------------------------------------------------------------------------------------------------------------------------------------------------
------------------Q--LSSS-----S---------------QQQQ--------------------------SSSS---o--o-------------------2----------------------------------------SSS
------------------------------------------------------------------------------------------------------------------------------------------------------
------------------------------------------------------------------------------------------------------------------------------------------------------
------------------------------------------------k----------------------------K-----SSSS-------------o-------------------------------------------------
------------------?--2-----#--##--SSC---T-----?QQQ-------tt----------------SSSSS--------------------------2-----------r---------------------------#---
--------------TT-----------#------------T----------------tt-----------T-------------------t-----------------------%%%%%%-------------TT-----------#---
--------------TT-----------##-----------T----------------tt-----------T---------%%%-------t------------------------|||||-------------TT-----------#---
-M------------TT------kk---##-----------T------------g-g-tt--y--------T---------||--------t-------------y--y-------|||||--kkk--------TT------ggg--#---
XXXXXXXXXXXXXXXXXXXXXXXXXXXXXXXX--XXXXXXXXXXXXXXXXXXXXXXXXXXXXXXXXXXXXXXXXXXXXXX||--------XXXXXXXXXXXXXXXXXXXX-%%%-|||||XXXXXXXXXXXXXXXXXXXXXXXXXXXXXX
XXXXXXXXXXXXXXXXXXXXXXXXXXXXXXXX--XXXXXXXXXXXXXXXXXXXXXXXXXXXXXXXXXXXXXXXXXXXXXX||--------XXXXXXXXXXXXXXXXXXXX--|--|||||XXXXXXXXXXXXXXXXXXXXXXXXXXXXXX
