------------------------------------------------------------------------------------------------------------------------------------------------------
------------------------------------------------------------------------------------------------------------------------------------------------------
------------------------------------------------------------------------------------------------------------------------------------------------------
------------------------------------------------------------SSSSSSSSSS----------SSSSSSSSSS----------SSSSSSSSSS----------------------------------------
-----------------------------------------g------------------SSSS--SSSS--------------------------------------------------------------------------------
----------------------------------------%%------------------SSSS--SSSS--------------------------------------------------------------------------------
----------------------------------------|---------------------SS---S----SSSSS---------------------------------------------SSC-------------------------
----------------------------------------|----oo---------------SS---S----------------------------------------------------------------------------------
-----------------%%%--------------------|---------------------SS---S---------------------------------------------------y------------------------------
------------------||--------------------|-------------------ooSS---SoU-----------------S-------------------------------X--SSS-------------------------
------------------||--------------------|-------------S-----SSSS---SSS-------2--SU---------------tt----------T--------XX------------------------------
-------------%%%%%||------------------K-|---------TT-----------------------TT-------TT---tT------tt----TT----T-------XXX-------------TT---------------
--------------|||-||----------TTTT------|---------TT------------------t----TT--T----TT---tT------tt----TT----T------XXXX-------------TT------------F--
-M------------|||-||----------TTTT------|---------TT------k-k--g-g----t----TT--T---kTT--ktT------tt-g--TT----T-----XXXXX---------#---TT------------#--
XXXXXXXXXXX---|||-||XXXXX--XXXXXXXXXXXXX|----%%%%-XXXXXXXXXXXXXXXXXXXXXXXXXXXXXXXXXXXXXXXXXXXXXXXXXXXXXXXXXXXXXXXXXXXXXXX----XXXXXXXXXXXXXXXXXXXXXXXXX
XXXXXXXXXXX---|||-||XXXXX--XXXXXXXXXXXXX|-----||--XXXXXXXXXXXXXXXXXXXXXXXXXXXXXXXXXXXXXXXXXXXXXXXXXXXXXXXXXXXXXXXXXXXXXXX----XXXXXXXXXXXXXXXXXXXXXXXXX
