------------------------------------------------------------------------------------------------------------------------------------------------------
------------------------------------------------------------------------------------------------------------------------------------------------------
------------------------------------------------------------------------------------------------------------------------------------------------------
------------------------------------------------------------------------------------------------------------------------------------------------------
------------------------------------------------------------------------------------------------------------------------------------------------------
----------------------ooor------------oo---------------------------------------------------------------------------k----------------------------------
---------------------%%%%%---------SSSS-------QQQQ------------------------SS---------1-----------------------@S---SSSSSS------------------------------
----------------------|||-------------------------------------------------------------------------oo--------------------------------------------------
----------------------|||-----------------------------------------------------------------------------------------------------------------------------
----------------------|||-----------------------k------------------------------------------------------------------------------SSS--------------------
-------------------%%%%%%%%---%---------T-----?QQQ-----ooo-----------#SS-----SS----QQQQ-------------SU----!--!----------%-------------------#---------
--------------------||||||--------------T---------------------------##--------------------------#------------------------------------TT-----##--------
--------------------||||||--o-----------T-------------------TT-----###--------------------------#-------------TT---------------------TT-----###------#
-M-----------%%%%---||||||-%%%----------T-------------------TT----####--------------yy----------#---------k---TT-----------------r---TT-----####----##
XXXXXXXXXXX---||----||||||--|---%%%%--%%XXXXXXXXXX--XXXXXXXXXXXXXXXXXX----------XXXXXXXXXXXXXXXXXXXXXXXXXXXXXXXXXXXXXX------XXXXXXXXXXXXXXXXXXXXXXXXXX
XXXXXXXXXXX---||----||||||--|----||----|XXXXXXXXXX--XXXXXXXXXXXXXXXXXX----------XXXXXXXXXXXXXXXXXXXXXXXXXXXXXXXXXXXXXX------XXXXXXXXXXXXXXXXXXXXXXXXXX
