------------------------------------------------------------------------------------------------------------------------------------------------------
------------------------------------------------------------------------------------------------------------------------------------------------------
------------------------------------------------------------------------------------------------------------------------------------------------------
----------------------------------------------------------------------------------------------------------------------------------SSSSSSSSSS----------
------------------------------------------------------------------------------------------------------------------------------------------------------
----------------------ooor-----------------------------------------------------------------------------------------k----------------------------------
---------------------%%%%%----------------------------------------SSoo----SS---------SSSS-SSS------%------2---S---SSSSSSSS-------------------QQQQ-----
----------------------|||-----------------------------------------------------------------------------------------------------------------------------
----------------------|||-----------------------------------------------------------------------------------------------------------------------------
----------------------|||--------------------------------o------------------------------------------o----------------------TT------------------y------
----------Q---------%%%%%%%------------T-TT---SU------------%%%%%%----SS-----SS-Q-----------%%%-----------2----------------TT---------------Q?SSQQQ---
--------------------||||||-------------T-TT------------------||||----------------------------|--------------------------t--TT-------------TT----------
--------------------||||||--o----------T-TT------------------||||----------------------------|----------------TT--------t--TT------tt-----TT----------
---M---------------#||||||-%%%--gg-----T-TT------k--k--------||||----------------ggg---------|----------y--y--TT--------t--TT------tt----kTT----------
XXXXXXXXXXXXX--XXXXX||||||--|-XXXXXXXXXXXXXXXXXXXX-XXXXXXXXX-||||---------------XXXXX----X---|------XXXXXXXXXXXXXXXXXX--XXXXXXXXXXXXXXXXXXXXXX--XXXXXX
XXXXXXXXXXXXX--XXXXX||||||--|-XXXXXXXXXXXXXXXXXXXX-XXXXXXXXX-||||---------------XXXXX----X---|------XXXXXXXXXXXXXXXXXX--XXXXXXXXXXXXXXXXXXXXXX--XXXXXX
