------------------------------------------------------------------------------------------------------------------------------------------------------
------------------------------------------------------------------------------------------------------------------------------------------------------
------------------------------------------------------------------------------------------------------------------------------------------------------
----------------------------------------------------------------------SSSSSSSSSS----------------------------------------------------------------------
------------------------------------------------------------------------------------------------------------------------------------------------------
------------------------------------------------------------------------------------------------------------------------------------------------------
--------------------------------------------------Q---------------------------------y-------------------SSQSSS?SSS--------oo---%%%--------------------
-------------------------------------------------------------o---o---o--------TT--#SSS------------------------------------SS----||--------------------
------------------------------------------------------------%%%-%%%-%%--------TT-##---------------------------------------------||--------------------
-------------------------------------------------------------|---|---|--------TT###1------------g---------K---------------------||--------------------
--------SU------!-----------TT--QQQQ--------------Q----------|---|---|------SCTT###-------------TT------SSSSSSSSSSS----------SS-||---------#----------
----------------------------TT-------K-B---------------------|---|---|--TT----TT###--SSS--------TT------------------------------||--------##----------
----------------------------TT---------b---------------------|---|---|--TT----TT###-------------TT------------------------------||-------###-------F--
--M---------------------ggg-TT---------b-------ggg---gg----k-|---|-r-|--TT---kTT###-------------TT--------------K---------------||---y--####-------#--
XXXXXXXXXXXXXXXXXXXXXXXXXXXXXXXXXXXXXXXX-XXXXXXXXXXXXXXXXXXX%%%%%%%%%%XXXXXXXXXXXXXXXX---XXXXXXXXXX-XXXXXXXXXXXXXXXXXXXX%%-----%%%XXXXXXXXXXXXXXXXXXXX
XXXXXXXXXXXXXXXXXXXXXXXXXXXXXXXXXXXXXXXX-XXXXXXXXXXXXXXXXXXX-|||||||||XXXXXXXXXXXXXXXX---XXXXXXXXXX-XXXXXXXXXXXXXXXXXXXX|-------||XXXXXXXXXXXXXXXXXXXX
