------------------------------------------------------------------------------------------------------------------------------------------------------
------------------------------------------------------------------------------------------------------------------------------------------------------
------------------------------------------------------------------------------------------------------------------------------------------------------
--------------------------------oo------SSSSSSSSSS------------------------------------------------------------SSSSSSSSSS------------------------------
-------------------------------------g-gSSSSSSSS-----------------------------------------------------------------------------------------------------o
-----------------------------------%%%%%SSSCSSSS------------------------------------------------------------------------------------------------------
------------------Q----------U------||||SSSSSSSS--Q-----------USSS------------------------SSS------%--------------------------------------------------
------------------------------------||||----------------------------------------------------------------------------------------oooo------------SSS---
------------------------------------||||------------------------------------------TT--------------------------------------------------------oo--------
------------------------------%%%%%-||||---ggg------------------------------------TT------------------------------------------------------------------
------------------?---------##-|||--||||SSSSSSSS--Q----------S-----TT-------------TT--------%%%---------------T--------------TT------------QSS--------
--------------TT-------y-#####-|||--||||SSSSSSSS-------------------TT-------------TT-----T---|----------------T--------------TT-----------------------
--------------TT----y-######---|||--||||SSSSSSSS-------------------TT-----------T-TT-----T---|------------*---T----TT--------TT-----------------------
-M------------TT----######-----|||--||||SSSSSSSS-----gg----k-ggg---TT-gg--------T-TT---k-T---|------gg----*---T--g-TT----y---TT-----------------------
XXXXXXXXXXXXXXXXXXXXXXXX-------|||--||||XXXXXXXXXXXXXXXXXXXXXXXXXXXXXXXXXXXXXXXXXXXXXXXXXX---|------XXXXXXXXX-XXXXXXXXXXXXXXXXXXXXXXXXXXXXXX----------
XXXXXXXXXXXXXXXXXXXXXXXX-------|||--||||XXXXXXXXXXXXXXXXXXXXXXXXXXXXXXXXXXXXXXXXXXXXXXXXXX---|------XXXXXXXXX-XXXXXXXXXXXXXXXXXXXXXXXXXXXXXX----------
