------------------------------------------------------------------------------------------------------------------------------------------------------
------------------------------------------------------------------------------------------------------------------------------------------------------
------------------------------------------------------------------------------------------------------------------------------------------------------
------------------------------SSSSSSSSSSSSSSSSSSSS----------------------------------------------------------------------------------------------------
------------------------------SSSSSSSSSSSSSSSSSS------------------------------------------------------------------------------------------------------
----------------------ooor----SSSSSSSSSSSSSCSSSS------------------------------------------------------------------------------------------------------
---------------------%%%%%----SSSSSSSSSSSSSSSSSS------------------------------------y-------------------SSQSSS-----oo--------------------##-----------
----------------------|||---------------------------------------------------------#SSS---------------------------------------------------##----y------
----------------------|||---------------------------------------------o----------##----------------------------------------------------####--#SS--o---
----------------------|||------------------ggg-----------o----------------------###1-------o--------------K--------------------SSS-----####-##--------
---------Q------%%%%%%%%%%%---SSSSSSSSSSSSSSSSSS--------------------------------###--------------TT-----SSSSSS-%%%%--%%%%------------######-##--SC----
-----------------||-||||||----SSSSSSSSSSSSSSSSSS------------------------------#-###--SSS---------TT-------------||----||-------------######-##--------
-----------------||-||||||--o-SSSSSSSSSSSSSSSSSS-----------------------------##-###--------------TT-------------||----||-------------######-##---SSS--
-M---------------||-||||||-%%%SSSSSSSSSSSSSSSSSS----k-------gg-------g----------###--------------TT-----------o-||----||---------r---######-##--------
XXXXXXXXXXX--%%%%||%||||||--|-XXXXXXXXXXXXXXXXXXXX-XXXXXXXXXXXXXXXXXXXXXXXXXXXXXXXXXXX---XXXXXXXXXXXXXXXXXXXXX%-||----||----XXXXXXXXXXXXXXXXXX------XX
XXXXXXXXXXX---||-||-||||||--|-XXXXXXXXXXXXXXXXXXXX-XXXXXXXXXXXXXXXXXXXXXXXXXXXXXXXXXXX---XXXXXXXXXXXXXXXXXXXXX--||----||----XXXXXXXXXXXXXXXXXX------XX
