------------------------------------------------------------------------------------------------------------------------------------------------------
------------------------------------------------------------------------------------------------------------------------------------------------------
------------------------------------------------------------------------------------------------------------------------------------------------------
----------------------------------------------------------------------------------------------------SSSSSSSSSS----------------------------------------
-----------------------------------------g------------------------------------------------------------------------------------------------------------
----------------------ooor--------------%%------------------------------------------------------------------------------------------------------------
---------------------%%%%%--------------|----------------------------------1-------USS--------------------------------USSS----------------------------
----------------------|||---------------|----oo-----------------------------------------------------------------------------------oo------------------
----------------------|||---------------|----------------------------o--------------------------------------------------------------------------------
----------------------|||----------oo---|------------------------y---------ggg--------------------------------------E------TT-------------------------
---------Q----------%%%%%%%-------o--o--|--------------ooo-------##---#########---#--------------------------T-----TT------TT--------------Q#---------
-----------------K--||||||--------------|-----------------------###-----------#---#--------------------TT----T-----TT--tt--TT---------------##--------
------------B-------||||||--o-----------|----------------------####-----------#---##-------------B-----TT----T-----TT--tt--TT---------------###------#
-M----------b-------||||||-%%%----------|---------------------#####-----------#---##--gg---------b--g--TT----T--g--TT--tt--TT---------------####----##
XXXXXXXXXXXXXXXXXXXX||||||--|-XXXXXXXXXX|----%%%%---XXXXXXXXXXXXXXX-----------X---XXXXXXXXXXXXXXXXXXXXXXXXXXXXXXXXXXXXXXXXXXXXXXXXXXXXXXXXXXXXXXXXXXXX
XXXXXXXXXXXXXXXXXXXX||||||--|-XXXXXXXXXX|-----||----XXXXXXXXXXXXXXX-----------X---XXXXXXXXXXXXXXXXXXXXXXXXXXXXXXXXXXXXXXXXXXXXXXXXXXXXXXXXXXXXXXXXXXXX
