------------------------------------------------------------------------------------------------------------------------------------------------------
------------------------------------------------------------------------------------------------------------------------------------------------------
------------------------------------------------------------------------------------------------------------------------------------------------------
S-----SSSS--------------------------------------------------------------------------------------------------------------------------------------------
S-------------------------------------------------?--------------------------------------------------------------------------------------------------o
S-------------------------------------------------------------------------------------------oo--------------------------------------------------------
S----------------------------U----------------QQQQ-----------------------------------SUS---------------------R--------US--SSC-----!S------------------
S-------------------------------------------------SS---------o---o---o-------------------------------r------------------------------------------SSS---
S-----------------------------------------------------------%%%-%%%-%%---------g-------------------%%%%%%%%---------------------------------oo--------
S-----------------------------------------------k------------|---|---|------------------------------||||||----------E-----SSS-------------------------
S---------------%%%%--------##----------T-----?QQQ-----------|---|---|-------S@S----#####-S---------||||||---------TT-------------S------#--SS--------
S----------------||----y-#####--------ttT--------------SSS---|---|---|--------------#---------------||||||---------TT--t----------------##------------
S----------------||-y-######----------ttT--------------------|---|---|-------------K#--------%%%%---||||||---------TT--t---------------###------------
S----------------||-######------------ttT--------------------|---|-r-|--------------#---------||----||||||--oo--g--TT--t---------#----####------------
XXXXXXXXXXX--%%%%||%XXXX------XXXXXXXXXXXXXXXXXXXX----------%%%%%%%%%%-XXXXXXXXXXXXXXXX-------||----||||||--%%XXXXXXXXXXX----XXXXXXXXXXXXXXX----------
XXXXXXXXXXX---||-||-XXXX------XXXXXXXXXXXXXXXXXXXX-----------|||||||||-XXXXXXXXXXXXXXXX-------||----||||||---|XXXXXXXXXXX----XXXXXXXXXXXXXXX----------
