------------------------------------------------------------------------------------------------------------------------------------------------------
------------------------------------------------------------------------------------------------------------------------------------------------------
------------------------------------------------------------------------------------------------------------------------------------------------------
----------SSSSSSSSSS----------------------------------------SSSSSSSSSS----------SSSSSSSSSL------------------------------------------------------------
------------------------------------------------------------SSSS--SSSS---o----------------------------------------------------------------------------
------------------------------------------------------------SSSS--SSSS--%%%---------------------------oo----------------------------------------------
---------------------------------------------------------Q-Q--SS---S-----|--o-------oooooo-------------------------------------SSS--------------------
--------------------------------------------------------------SS---S-----|--SSSS---------------------------------SSS---------------------------y------
--------------------------------------------------------------SS---S--%--|----------SSSSSS---------------------------------------------------#SS--o---
------------------------------------------------------------ooSS---SoU---|----------SSSSSS--------------------------------------K-----------##--------
---------Q-----------------------------T-----------------Q-QSSSS---SSS---|----------------------TT-----------------------------SSS---------###--SC----
---------------------------------------TT-----TT-------------------------|----------------------TT----------------------------------------####--------
---------------------------------------TT-----TT-------------------------|-----%----------------TT----------tt-----------TT--------------#####---SSS--
-M-----------------------ggg----gg-----TT-----TT------------k--g-g-------|------------------k---TT----ggg---tt-----------TT----------y--######--------
XXXXXXXXXXX--XX--X--XXXXXXXXXXXXXXXXXXXXXXXX--XXXXXXXXXXXXXXXXXXXXXXXX%%%%%%-------XXXXXXXXXXXXXXXXXXXXXXXXXXX%%%%----%%XXXXXXXXXXXXXXXXXXXXXX------XX
XXXXXXXXXXX--XX--X--XXXXXXXXXXXXXXXXXXXXXXXX--XXXXXXXXXXXXXXXXXXXXXXXX|||||--------XXXXXXXXXXXXXXXXXXXXXXXXXXX|||------|XXXXXXXXXXXXXXXXXXXXXX------XX
