------------------------------------------------------------------------------------------------------------------------------------------------------
------------------------------------------------------------------------------------------------------------------------------------------------------
------------------------------------------------------------------------------------------------------------------------------------------------------
--------------------------------oo----------------SSSSSSS---------------------------------------------------------------------------------------------
-------------------------------------g-g--------------------------------------------------------------------------------------------------------------
-----------------------------------%%%%%------------------------------------------g-------------------------------------------------------------k-----
----------------------!-------------||||----------QQ----------------------------SSSSSSSS---------------------@---------------------------------SQS--SQ
------------------------------------||||----------------------------------------------------------oo--------------------------------------------------
-----------------g------------------||||-------------------S------------------------------------------------------------------SSS----g#---------------
-----------------#------------%%%%%-||||---------------------------------1----------------------------------------------------------g##---------------
----------S-----##--S@S!S------|||--||||----------QQ--QQQ-------------T-----------------------------SU----!--!----------%-----------###--------SQS--S?
---------------###-------------|||--||||------------------------------T----TT-------------------#----------------------------------####---------------
--------------####----------tt-|||--||||------------------------------T----TT-------------------#------------------B--------------#####---------------
---M---------#####---g------tt-|||--||||-------y------------gg-------gT---kTT-------------------#---------k--------b-------------r#####------k------gg
XXXXXXXXXXXXXXXXXXXXXXXXXXXXXX-|||--||||XXXXXXXXXXXXXXXXX---XXXXXXXXXXXXXXXXXXXXXXXXXX---XXXXXXXXXXXXXXXXXXXXXXXXXXXXXXX----XXXXXXXXXXX--XXXXXXXXXXXXX
XXXXXXXXXXXXXXXXXXXXXXXXXXXXXX-|||--||||XXXXXXXXXXXXXXXXX---XXXXXXXXXXXXXXXXXXXXXXXXXX---XXXXXXXXXXXXXXXXXXXXXXXXXXXXXXX----XXXXXXXXXXX--XXXXXXXXXXXXX
