------------------------------------------------------------------------------------------------------------------------------------------------------
------------------------------------------------------------------------------------------------------------------------------------------------------
------------------------------------------------------------------------------------------------------------------------------------------------------
--------------------------------oo------------------------------------------------------------------------------------------------SSSSSSSSSS----------
-------------------------------------g-g--------------------------------------------------------------------------------------------------------------
----------------------ooor---------%%%%%-----------------------------R------------------------------oo------------------------------------------------
---------------------%%%%%----------||||------QQQQ-------------------------g-------o--o-------------%%%------------oo---------------------------------
----------------------|||-----------||||-------------------------------%%%%%%-----------------------||--o----R------------------oo-------------y------
-----------------%%%--|||-----------||||-----------------B--------------||||------------------------||-%%%-----------------------------------#SS--o---
------------------||--|||-----%%%%%-||||--------k--------b--------------||||-------SSSS-------------||--|-----------------------------------##--------
------------------||%%%%%%%----|||--||||T-----?QQQ-----SS#CS-----%%%----||||------------------------||--|------%%%%--%%%-----TT-------------##--SC----
-------------%%%%%||||||||-----|||--||||T-------------------------|-----||||------------------------||-o|-------||----||-----TT-----------TT##--------
--------------|||-||||||||--o--|||--||||T------------------K------|-----||||----%%%-----------------||%%%%%-----||----||-----TT----tt-----TT##---SSS--
---M----------|||-||||||||-%%%-|||--||||T-------------------------|-----||||----||-----------------g||-|||----o-||----||-y---TT----tt----kTT##--------
XXXXXXXXXXX---|||-||||||||--|--|||--||||XXXXXXXXXXXXXXXXXXXX%%%%%-|-----||||----||---------XXXXXXXXX||-|||----%-||----||XXXXXXXXXXXXXXXXXXXXXX------XX
XXXXXXXXXXX---|||-||||||||--|--|||--||||XXXXXXXXXXXXXXXXXXXX-|||--|-----||||----||---------XXXXXXXXX||-|||------||----||XXXXXXXXXXXXXXXXXXXXXX------XX
