------------------------------------------------------------------------------------------------------------------------------------------------------
------------------------------------------------------------------------------------------------------------------------------------------------------
------------------------------------------------------------------------------------------------------------------------------------------------------
--------------------------------oo------SSSSSSSSSS--------------------SSSSSSSSSSSSSSSSSSSSSSSSSSSSSS--------------------------------------------------
---------------------------------------g--------------------------------------------------------------------------------------------------------------
----------------------ooor---------%%%%%--------------------------------------------------------------------------------------------------------------
---------------------%%%%%----------||||-oooo-------------------------------------------------------------2--------oo------------------------------SSS
----------------------|||-----------||||--------------------------------------TT--------------------------------------------------oo------------------
-----------------%%%--|||-----------||||-SSSS-U----------------------o--------TT----------------------------------------------SSS---------------------
------------------||--|||-----%%%%%-||||oS--SoS------------------y------------TT-------S------------o-------------------------------------------------
---------Q--------||%%%%%%%----|||--||||SS--SSS-------S----------##---------SCTTSU------------------------2----%%%%--%%%%------------------Q------#---
-------------%%%%%||||||||-----|||--||||----------TT------------###-----TT----TT----TT---tt---------------------||----||--------------------------#---
--------------|||-||||||||--o--|||--||||----------TT-----------####-----TT----TT----TT---tt---------------------||----||--------------------------#---
-M------------|||-||||||||-%%%-|||--||||--kk------TT------k---#####-----TT---kTT---kTT--ktt-------------y--y--o-||----||---------r-----------ggg--#---
XXXXXXXXXXX---|||-||||||||--|--|||--||||XXXXXXXXXXXXXXXXXXXXXXXXXXX---XXXXXXXXXXXXXXXXXXXXXXXXXXXXXXXXXXXXXXXX%-||----||----XXXXXXXXXXXXXXXXXXXXXXXXXX
XXXXXXXXXXX---|||-||||||||--|--|||--||||XXXXXXXXXXXXXXXXXXXXXXXXXXX---XXXXXXXXXXXXXXXXXXXXXXXXXXXXXXXXXXXXXXXX--||----||----XXXXXXXXXXXXXXXXXXXXXXXXXX
