------------------------------------------------------------------------------------------------------------------------------------------------------
------------------------------------------------------------------------------------------------------------------------------------------------------
------------------------------------------------------------------------------------------------------------------------------------------------------
------------------------------------------------------------------------------------------------------------------------------------------------------
------------------------------------------------------------------------------------------------------------------------------------------------------
----------------------ooor-------------------------------------------R------------g---------oo--------------------------------------------------------
---------------------%%%%%--------------------------------------------------SSSSSSSSSSSS----------------------------------oo---%%%-SSSS---------------
----------------------|||---------------------------------------------------------------------------oo--------------------SS----||--------------------
----------------------|||--------------------------------------------------------------------------%----------------------------||--------------------
----------------------|||----------oo--------------------o-------------------K--------------------------------------------------||-----SSSS-----------
-------------------%%%%%%%%-------o--o---------------------------%%%-------SSSSS----------S------------------T--!-----S------SS-||----------#---------
--------------------||||||----------------------------------------|---T--------------------------------------T------------------||----------##--------
--------------------||||||--o-------------------------------------|---T----------------------%%%%------------T------------------||----------###------#
---M---------%%%%---||||||-%%%----------------------k-------------|---T-----------------------||----------y--T------------------||----------####----##
XXXXXXXXXXX---||----||||||--|-XXXXXXXXXXX-XX-XX-XX-XXXXXXXXX%%%%%-|---XXXXXXXXXXXXXXXX---X----||----XXXXXXXXXXXXXXXXXXXX%%-----%%%---------XXXXXXXXXXX
XXXXXXXXXXX---||----||||||--|-XXXXXXXXXXX-XX-XX-XX-XXXXXXXXX-|||--|---XXXXXXXXXXXXXXXX---X----||----XXXXXXXXXXXXXXXXXXXX|-------||---------XXXXXXXXXXX
