------------------------------------------------------------------------------------------------------------------------------------------------------
------------------------------------------------------------------------------------------------------------------------------------------------------
------------------------------------------------------------------------------------------------------------------------------------------------------
------------------------------SSSSSSSSSSSSSSSSSSSS------------------------------------------------------------SS-------S------------------------------
------------------------------SSSSSSSSSS--------------------------------------------------------------------------------------------------------------
------------------------------SSSSSSSSSS-----------------------------R------------g-------------------oo----------------------------------------------
------------------------------SSSSSSSSSS-oooo-----------------------------------SSSSSSSS-------------------------------S--oo---%%%--------------------
--------------------------------------------------------------------------------------------------------------------------SS----||--------------------
-----------------------------------------SSSS-U--------------------------------------------------------------------SSS----------||--------------------
----------------------------------------oS--SoS----------o---------------1------------------------------------------------------||--------------------
--------------------SS--------SSSSSSSSSSSS--SSS------------------%%%--T-------------------------TT---------------------S-----SS-||----------#---------
---------------------K---TT---SSSSSSSSSS--------------------------|---T----TT-------------------TT-------------##---------------||----------##--------
-------------------------TT---SSSSSSSSSS--------------------------|---T----TT-------------------TT----------tt-##---------------||----------###------#
-M------------k-ggg------TT---SSSSSSSSSS--kk--------k-------------|---T---kTT---------------k---TT----ggg---tt-##---------------||k---------####----##
XXXXXXXXXXXXXXXXXXXXXXXXXXXXXXXXXXXXXXXXXXXXXXXXXX-XXXXXXXXX%%%%%-|---XXXXXXXXXXXXXXXX---XXXXXXXXXXXXXXXXXXXXX-XX------X%%-----%%%XX---XXXXXXXXXXXXXXX
XXXXXXXXXXXXXXXXXXXXXXXXXXXXXXXXXXXXXXXXXXXXXXXXXX-XXXXXXXXX-|||--|---XXXXXXXXXXXXXXXX---XXXXXXXXXXXXXXXXXXXXX-XX------X|-------||XX---XXXXXXXXXXXXXXX
