------------------------------------------------------------------------------------------------------------------------------------------------------
------------------------------------------------------------------------------------------------------------------------------------------------------
------------------------------------------------------------------------------------------------------------------------------------------------------
----------SSSSSSSSSS----------------------------------------------------------------------------------------------------------------------------------
------------------------------------------------------------------------------------------------------------------------------------------------------
----------------------------------------ooooo-------------------------------------------------------oo------------------------------------------------
----------------------------------------------------------------------------------------------------%%%------------oo-------------%---------SSS-------
------------------------------------------------SS--------------------------------------------------||--o----R----------------------------------------
-----------------------------------------SSSS------------TT--------------------g--TT----------------||-%%%-------------------SSS--------SSS-----------
---------------------------------------------------TT----TT-----------------------TT------------g---||--|----------------------------------------SSSSS
--------------------SS-----------------------------TT----XX------------------S@S--TT------------TT--||--|------%%%%--%%%r---------%%%%%---------------
---------------------K---TT------------T-----------TT----------------T------------TT-----T------TT--||-o|-------||----||%%%%%%-----|||----------------
-------------------------TT------------T----%%%%%--TT--------B-------T----------T-TT-----T------TT--||%%%%%-----||----|||||||------|||------SSS-------
-M-----------------------TT----------kkT-----|||---TT--------b-------T----------T-TT---k-T------TT--||-|||----o-||----|||||||------|||-------------r--
XXXXXXXXXXX--XX--X--XXXXXXXXXXXXXXXXXXXX%%---|||--XXXXXXXXXXXXXXXX--XX-XXXXXXXXXXXXXXXXXXXXXXXXXXXX-||-|||----%-||----|||||||-----%|||-----------XXXXX
XXXXXXXXXXX--XX--X--XXXXXXXXXXXXXXXXXXXX|----|||--XXXXXXXXXXXXXXXX--XX-XXXXXXXXXXXXXXXXXXXXXXXXXXXX-||-|||------||----|||||||------|||-----------XXXXX
