------------------------------------------------------------------------------------------------------------------------------------------------------
------------------------------------------------------------------------------------------------------------------------------------------------------
------------------------------------------------------------------------------------------------------------------------------------------------------
----------------------------------------SSSSSSSSSS--------------------------------------------------SSSSSSSSSS----------------------------------------
----------------------------------------SSSSSSSS--?---------------------------------------------------------------------------------------------------
----------------------------------------SSSCSSSS----------------------------------------oo------------------------------------------------------------
------------------Q---------------------SSSSSSSS----------------------------SSSSoo--------SSS------%-------------------------------SSSS---------------
--------------------------------------------------SS------------------------------------------------------------oooo----------------------------------
------------------------------------------------------------------------------------------------------------------------------SSS---------------------
-------------------------------------------ggg-------------------------------K---SS----------------------------------------------------SSSS-----------
------------------?---------TT--QQQQ----SSSSSSSS---------------------------SSSSS---------S--%%%--------------TT---------%-----------------------------
--------------TT------------TT-------K-BSSSSSSSS-------SSS------------T----------------------|---------TT----TT---------------------------------------
--------------TT------------TT---------bSSSSSSSS----------------------T----------------------|---------TT----TT------------------------------------F--
-M------------TT--------ggg-TT---------bSSSSSSSS-------------y--------T----------------------|------g--TT----TT---y--------------r-----------------#--
XXXXXXXXXXXXXXXXXXXXXXXXXXXXXXXXXXXXXXXXXXXXXXXXXX----------XXXXXXXXXXXXXXXXXXXX-------------|------XXXXXXXXXXXXXXXXXXXX----XXXXXX---------XXXXXXXXXXX
XXXXXXXXXXXXXXXXXXXXXXXXXXXXXXXXXXXXXXXXXXXXXXXXXX----------XXXXXXXXXXXXXXXXXXXX-------------|------XXXXXXXXXXXXXXXXXXXX----XXXXXX---------XXXXXXXXXXX
