------------------------------------------------------------------------------------------------------------------------------------------------------
------------------------------------------------------------------------------------------------------------------------------------------------------
------------------------------------------------------------------------------------------------------------------------------------------------------
------------------------------------------------------------SSSSSSSSSSSSSSSSSSSS----------------------------------------------------------------------
------------------------------------------------------------SSSS--SSSS--------------------------------------------------------------------------------
--------------------------------------oo--------------------SSSS--SSSS------------------oo------------------------------------------------------------
-----------------------------------SSSS-----------------------SS---S------------oo---------------------------R-------------------------------QQQQ-----
--------------------------------------------------------------SS---S----------TT---------------------r----------oooo----------------------------------
-----------------%%%-------------------------------------TT---SS---S----------TT--------------------%%%%%%%-------------------SSS----g#---------------
------------------||-------------------------------TT----TT-ooSS---SoU--------TT-SS-----------------||||||--------------------------g##--------y------
------------------||----------%--------------------TT----XX-SSSS---SSS------SCTT---------S----------||||||----T---------%-----------###-----Q?SSQQQ---
-------------%%%%%||-------------------------------TT-------------------TT----TT--------------------||||||----T--------------------####---------------
--------------|||-||-------------------------------TT-------------------TT----TT--------------------||||||----T-------------------#####---------------
-M------------|||-||-----ggg-----------------------TT-------k--g-g------TT---kTT-------------------g||||||--ooT---y--------------r#####---------------
XXXXXXXXXXX---|||-||XXXXXXXXXX--%%%%--%%X-XX-XX-XXXXXXXXXXXXXXXXXXXXXXXXXXXXXXXX-----------XXXXXXXXX||||||--%%XXXXXXXXXX----XXXXXXXXXXX--XXXXX--XXXXXX
XXXXXXXXXXX---|||-||XXXXXXXXXX---||----|X-XX-XX-XXXXXXXXXXXXXXXXXXXXXXXXXXXXXXXX-----------XXXXXXXXX||||||---|XXXXXXXXXX----XXXXXXXXXXX--XXXXX--XXXXXX
