------------------------------------------------------------------------------------------------------------------------------------------------------
------------------------------------------------------------------------------------------------------------------------------------------------------
------------------------------------------------------------------------------------------------------------------------------------------------------
----------SSSSSSSSSS------------------------------SSSSSSSSSS------------------------------------------------------------------------------------------
------------------------------------------------------SS--SS------------------------------------------------------------------------------------------
----------------------ooor------------oo--------------SS--SS--------------------K-------------------oo-------------k----------------------------------
---------------------%%%%%---------SSSS-------------SS--------USSS--------------SS----1----SSS!-----%%%-------S---SSSSSS--------------------SSS-------
----------------------|||---------------------------SS----------------------------------------------||--o----R----------------------------------------
----------------------|||---------------------------SS----------------o-----------------------------||-%%%--------------------------------------------
----------------------|||---------------------------SS----oo----------------------------------------||--|---------------SS-?Q--------------------SSSSS
--------------------%%%%%%%---%---------------------SSSS--SS-S-----TT-----------SS------------C-----||--|---------------------------------------------
--------------------||||||----------------------------SS-----------TT---------#-------TT------------||-o|---------------------------------------------
--------------------||||||--o-------------------------SS-----------TT--------##-------TT------------||%%%%%---TT---------------y------------SSS-------
-M------------------||||||-%%%-----------------y-------------ggg---TT-----------------TT-------g-g--||-|||----TT-----------SSSSS-------------------r--
XXXXXXXXXXX--XX--X--||||||--|---%%%%--%%XXXXXXXXXXXXXXXXXXXXXXXXXXXXXXXXXXXXXXXXXXXXXXXXXXXXXXXXXXXX||-|||----XXXXXXXX---------XX-XXXXXXXXXX-----XXXXX
XXXXXXXXXXX--XX--X--||||||--|----||----|XXXXXXXXXXXXXXXXXXXXXXXXXXXXXXXXXXXXXXXXXXXXXXXXXXXXXXXXXXXX||-|||----XXXXXXXX---------XX-XXXXXXXXXX-----XXXXX
