------------------------------------------------------------------------------------------------------------------------------------------------------
------------------------------------------------------------------------------------------------------------------------------------------------------
------------------------------------------------------------------------------------------------------------------------------------------------------
--------------------------------oo-----------------oo-------SSSSSSSSSS------------------------------------------------------------SSSSSSSS------------
---------------------------------------g----------%%%%------SSSS--SSSS--------------------------------------------------------------------------------
-----------------------------------%%%%%-----------||-------SSSS--SSSS--------------------------------------------------------------------------------
--------------------USS-------------||||-----------||---------SS---S-------g---------SUS------------------2-------------------------------------------
------------------------------------||||-----------||--SSS----SS---S---%%%%%%-------------------------------------------------------------------------
------------------------------------||||-----------||---------SS---S----||||--------------------------------------------------------------------------
------------------------------%%%%%-||||-----------||-------ooSS---SoU--||||-------------------oooo-o-------------------SS-?Q-------------------------
---------Q---------------------|||--||||-----------||-------SSSS---SSS--||||--------#####-----------------2----------------------------g##------------
---------------------B---------|||--||||-----------||-------------------||||--------#--------------------------------------------------###------------
---------------------b-------B-|||--||||----------%||-------------------||||-------K#------------------------------------------y-----g####---------F--
----------k---ggg----B-------b-|||--||||-------y---||-------k--g-g------||||--------#-------------------y--y---k----kkk----SSSSS-----#####---------#--
XXXXXXXXXXXXXXXXXXXXXXXXXXXXXX-|||--||||XXXXXXXXXX-||-------XXXXXXXXXX--||||----XXXXXXX---%%%%%%%-%%XXXXXXXXXXXXXXXXXXXX-------XX-XXXXXXXX--XXXXXXXXXX
XXXXXXXXXXXXXXXXXXXXXXXXXXXXXX-|||--||||XXXXXXXXXX-||-------XXXXXXXXXX--||||----XXXXXXX---||||||---|XXXXXXXXXXXXXXXXXXXX-------XX-XXXXXXXX--XXXXXXXXXX
