------------------------------------------------------------------------------------------------------------------------------------------------------
------------------------------------------------------------------------------------------------------------------------------------------------------
------------------------------------------------------------------------------------------------------------------------------------------------------
----------SSSSSSSSSS------------------------------------------------------------------------------------------SS-------S------------------------------
------------------------------------------------------------------------------------------------------------------------------------------------------
-----------------------SSS----------------------------------------------------------------------------------------------------------------------------
------------------------------------------------------------------------------------y------------------------R---------S--oo---%%%SS--------SS--------
---------------------g------------------------------------------------------------#SSS-------------------r----------------SS----||--------------------
--------------------%%%-----------------------------------------------o----------##-----------------%%%%%%%--------SSS----------||--------------------
--------------------||----SSS---------------------------------------------------###1-------o--------||||||----------------------||--------------------
--------------------||--------------------------------S--------------#----------###--------------TT-||||||-------------S-----SS-||SS--------SS--------
--------------------||-----------------T-----K---BTT----------------##--------#-###--SSS---------TT-||||||-----##---------------||K---#----B------#-TT
--------------------||-----------------T---------bTT--------TT-----###-------##-###--------------TT-||||||-----##---------------||----#----b-----##-TT
-M------------------||----oo---------kkT---------BTT------k-TT----####----------###--------------TT-||||||--oo-##---------------||----#----B----###-TT
XXXXXXXXXXX--XX--X--||---%%%--XXXXXXXXXXXXXXXXXXXXXXXXXXXXXXXXXXXXXXXXXXXXXXXXXXXXXXXX---XXXXXXXXXXX||||||--%%-XX------X%%-----%%%XXXXXXXXXXXXXXXXX-XX
XXXXXXXXXXX--XX--X--||----|---XXXXXXXXXXXXXXXXXXXXXXXXXXXXXXXXXXXXXXXXXXXXXXXXXXXXXXXX---XXXXXXXXXXX||||||---|-XX------X|-------||XXXXXXXXXXXXXXXXX-XX
