------------------------------------------------------------------------------------------------------------------------------------------------------
------------------------------------------------------------------------------------------------------------------------------------------------------
------------------------------------------------------------------------------------------------------------------------------------------------------
--------------------------------------------------------------------------------SSSSSSSSSS------------------------------------------------------------
--------------------------------------------?----------------------------o---------------------------------------------------------------------------o
-----------------------SSS----------------------------------------------%%%---------------------------------------------------------------------------
-------------------------------------------------------------------------|--o-------------SSS------%---------R----------------------------------------
---------------------g------------------------r--------------------------|--SSSS-------------------------r------------------------oo------------SSS---
--------------------%%%-------------------%%%%%%----------------------%--|--------------------------%%%%%%%------------y--------------------oo--------
--------------------||----SSS--------------||||--------------------------|-------------S------------||||||-------------XSS-?Q-------------------------
-------------------%||----------QQQQ----%%-||||ooo-----------------------|------SU----------%%%-----||||||------------XX-------------------QSS--------
--------------------||---------------K-B|--||||--r--K----------------T---|----------TT---t---|------||||||-----------XXX------------------------------
--------------------||-----------------b|%%%%%%%%%-----------B-------T---|-----%----TT---t---|------||||||----------XXXX-------y----------------------
-M-----------%%%%---||----oo-----------b|-||||||||---------g-b-------T---|---------kTT--kt---|------||||||--oo-----XXXXX---SSSSS----------------------
XXXXXXXXXXX---||----||---%%%--XXXXXXXXXX|-||||||||XXXXXXXXXXXXXXXX--XX%%%%%%----XXXXXXXXXX---|------||||||--%%XXXXXXXXXX-------XX-XXXXXXXXXX----------
XXXXXXXXXXX---||----||----|---XXXXXXXXXX|-||||||||XXXXXXXXXXXXXXXX--XX|||||-----XXXXXXXXXX---|------||||||---|XXXXXXXXXX-------XX-XXXXXXXXXX----------
