------------------------------------------------------------------------------------------------------------------------------------------------------
------------------------------------------------------------------------------------------------------------------------------------------------------
------------------------------------------------------------------------------------------------------------------------------------------------------
----------------------------------------------------------------------SSSSSSSSSS--------------------------------------------------SSSSSSSS--SSSSSSSSSS
-----------------------------------------g------------------------------------------------------------------------------------------------------------
----------------------------------------%%-------------oooo-------------------------------------------------------------------------------------------
----------------------------------------|--------------%%%%---USSS-------------------1-----------------------R----------------------------------------
----------------------------------------|----oo---------||--------------------TT---------------------r----------oooo----------------------------------
----------------------------------------|---------------||--------------------TT--------------------%%%%%%%-------------------------------------------
----------------------------------------|---------SSS---||--------------------TT----------------g---||||||--------------SS-?Q-------------------------
---------------------------------------T|---------------||---S-----TT-------SCTT---QQQQ---------TT--||||||----T------------------------g##----TT------
---------------------------------------T|-------------U-||---------TT---TT----TT----------------TT--||||||----T------------------------###----TT------
---------------------------------------T|---------------||---------TT---TT----TT----------------TT--||||||----T----------------y-----g####----TT------
-M------------k-ggg------ggg----gg-----T|---------------||---ggg---TT---TT---kTT----yy----------TT--||||||--ooT---y--------SSSSS-----#####----TT------
XXXXXXXXXXXXXXXXXXXXXXXXXXXXXXXXXXXXXXXX|----%%%%-----%%%%%-XXXXXXXXXXXXXXXXXXXXXXXXXXXXXXXXXXXXXXX-||||||--%%XXXXXXXXXX-------XX-XXXXXXXX--XXXX--XXXX
XXXXXXXXXXXXXXXXXXXXXXXXXXXXXXXXXXXXXXXX|-----||-------|||--XXXXXXXXXXXXXXXXXXXXXXXXXXXXXXXXXXXXXXX-||||||---|XXXXXXXXXX-------XX-XXXXXXXX--XXXX--XXXX
