------------------------------------------------------------------------------------------------------------------------------------------------------
------------------------------------------------------------------------------------------------------------------------------------------------------
------------------------------------------------------------------------------------------------------------------------------------------------------
--------------------SSSSSSSSSS--------------------------------------------------------------------------------SS-------S------------------------------
------------------------------------------------------------------------------------------------------------------------------------------------------
---------------------------------------------------------------------R------------g-------------------------------------------------------------------
------------------------------S--------------------------------------------g----SSSSSSSS-------------------------------S------------------------------
-----------------------------------------------------------------------%%%%%%-----------------------------TT-----------------------------------y------
------------------------------------------------------------------------||||------------------------------TT-------SSS-----------------------#SS--o---
-----------------------------C------------------------------------------||||-------------------oooo-------TT------------SS-?Q---------------##--------
----------------%%%%---#-#----##--SSC--------------------tt------%%%----||||-----------------------------SXXS----------S--------------------##--SC----
-----------------||--#-#-#-#-----------------------------tt-------|-----||||-----------------------------------##---------------------------##--------
-----------------||--#-#-#-#-----------------------------tt-------|-----||||------------------------TT---------##--------------y------------##---SSS--
-M---------------||--#-#-#-#-E-----------------ggg---g-g-tt-------|-----||||------------------------TT---------##----------SSSSS------------##--------
XXXXXXXXXXX--%%%%||%XXXXXXXXXXXX--XXXXXX-XXXXXXXXXXXXXXXXXXX%%%%%-|-----||||----XXXXXX---X%%%%%%%-%%XXXXXXXXXX-XX------X-------XX-XXXXXXXXXXXX------XX
XXXXXXXXXXX---||-||-XXXXXXXXXXXX--XXXXXX-XXXXXXXXXXXXXXXXXXX-|||--|-----||||----XXXXXX---X||||||---|XXXXXXXXXX-XX------X-------XX-XXXXXXXXXXXX------XX
