------------------------------------------------------------------------------------------------------------------------------------------------------
------------------------------------------------------------------------------------------------------------------------------------------------------
------------------------------------------------------------------------------------------------------------------------------------------------------
--------------------------------------------------------------------------------SSSSSSSSSS------------------------------SSSSSSSSSSSSSSSSSSSS----------
------------------------------------------------------------------------------------------------------------------------------------------------------
-------------------------------------------------------oooo----------R--------------------------------------------------------------------------------
------------------Q------------------------------------%%%%---------------SS---------------------------------R-------------------------------------SSS
--------------------------------------------------SSSS--||-----------------------------------------------r--------------------------------------------
--------------------------------------------------------||------------------------------------------%%%%%%%------------y------------------------------
--------------------------------------------------------||-----------------------------S--------g---||||||-------------X------------------------------
-----SSS----------?-SS----------------------------------||-------%%%--SS-----SS-SU--------------TT--||||||------------XX--------------------------#---
--------------TT-----K---TT------------T--------------U-||--------|-----------------TT---t------TT--||||||-----------XXX--SS--------------TT------#---
--------------TT---------TT------------T----------------||--------|-----------------TT---t------TT--||||||----------XXXX--SS-------tt-----TT------#---
--------------TT---------TT----------kkT----------------||--------|----------------kTT--kt------TT--||||||--oo-----XXXXX--SS-------tt----kTT-ggg--#---
XXXXXXXXXXXXXXXXXXXXXXXXXXXXXXXXXXXXXXXXX-XX-XX-XX----%%%%%-%%%%%-|-------------XXXXXXXXXXXXXXXXXXX-||||||--%%XXXXXXXXXX--XX--XXXXXXXXXXXXXXXXXXXXXXXX
XXXXXXXXXXXXXXXXXXXXXXXXXXXXXXXXXXXXXXXXX-XX-XX-XX-----|||---|||--|-------------XXXXXXXXXXXXXXXXXXX-||||||---|XXXXXXXXXX--XX--XXXXXXXXXXXXXXXXXXXXXXXX
