------------------------------------------------------------------------------------------------------------------------------------------------------
------------------------------------------------------------------------------------------------------------------------------------------------------
------------------------------------------------------------------------------------------------------------------------------------------------------
--------------------------------oo------SSSSSSSSSS--------------------SSSSSSSSSS----------------------------------------SSSSSSSSSS--------------------
-------------------------------------g-g--------------------------------------------------------------------------------------------------------------
-----------------------------------%%%%%--------------------------------------------------------------------------------------------------------------
-----------------------------U------||||-oooo----------------------------------------SSSS-SSS------%---------R----------------------------------------
------------------------------------||||---------------------o---o---o--------TT---------------------r------------------------------------------------
------------------------------------||||-SSSS-U----------TT-%%%-%%%-%%--------TT--------------------%%%%%%%-------------------------------------------
------------------------------%%%%%-||||oS--SoS----TT----TT--|---|---|--------TT--------------------||||||--------------------------------------------
-------------------%--------##-|||--||||SS--SSS----TT----XX--|---|---|------SCTTQ-----------%%%-----||||||--------------------------------------------
-----------------------y-#####-|||--||||-----------TT--------|---|---|--TT----TT-------------|------||||||----------------SS--------------------------
--------------------y-######---|||--||||-----------TT--------|---|---|--TT----TT-------------|------||||||----------------SS-----------------------F--
-M-----------%%%%---######-----|||--||||--kk-------TT--------|---|-r-|--TT---kTT-ggg---------|------||||||--oo-k----kkk---SS------k----------------#--
XXXXXXXXXXX---||----XXXX-------|||--||||XXXXXXXXXXXXXXXXXXXX%%%%%%%%%%XXXXXXXXXXXXXXX----X---|------||||||--%%XXXXXXXXXX--XX--XXXXXX---XXXXXXXXXXXXXXX
XXXXXXXXXXX---||----XXXX-------|||--||||XXXXXXXXXXXXXXXXXXXX-|||||||||XXXXXXXXXXXXXXX----X---|------||||||---|XXXXXXXXXX--XX--XXXXXX---XXXXXXXXXXXXXXX
