------------------------------------------------------------------------------------------------------------------------------------------------------
------------------------------------------------------------------------------------------------------------------------------------------------------
------------------------------------------------------------------------------------------------------------------------------------------------------
----------------------------------------------------------------------SSSSSSSSSS----------SSSSSSSSSS----------------------------------------SSSSSSSSSS
------------------------------------------------------------------------------------------------------------------------------------------------------
-------------------------------------------------------oooo-------------------------------------------------------------------------------------------
-----------------------------U-------------------------%%%%------------------------USS-----------------------------oo---------------------------------
--------------------------------------------------------||--------------------TT----------------------------------------------------------------------
--------------------------------------------------------||--------------------TT----------------------------------------------------------------------
--------------------------------------------------SSS---||--------------------TT----------------------------------------------------------------------
----------------------------##-TT-------------tt--------||------------------SCTT--#-------------------%%%%%%---%%%%--%%%-------------------#--TT------
-----------------------y-#####-TT-------------tt------U-||--------------TT----TT--#--------------------||||-----||----||------------------##--TT------
--------------------y-######---TT-------------tt--------||--------------TT----TT--##-------------------||||-----||----||-----------------###--TT------
---M----------k-ggg-######----gTT--------g----tt--------||--gg-------g--TT---kTT--##--gg--------g-g----||||---o-||----||-k----ggg----y--####--TT------
XXXXXXXXXXXXXXXXXXXXXXXX------XXXXXXXX--XXXXXXXXXX----%%%%%-XXXXXXXXXXXXXXXXXXXX--XXXXXXXXXXXXXXXXXX%%-||||-%%%-||----||XXXXXXXXXXXXXXXXXXXXXXXX--XXXX
XXXXXXXXXXXXXXXXXXXXXXXX------XXXXXXXX--XXXXXXXXXX-----|||--XXXXXXXXXXXXXXXXXXXX--XXXXXXXXXXXXXXXXXX|--||||--|--||----||XXXXXXXXXXXXXXXXXXXXXXXX--XXXX
