------------------------------------------------------------------------------------------------------------------------------------------------------
------------------------------------------------------------------------------------------------------------------------------------------------------
------------------------------------------------------------------------------------------------------------------------------------------------------
--------------------------------------------------SSSSSSSSSS------------------------------------------------------------------------------------------
------------------------------------------------------SS--SS------------------------------------------------------------------------------------------
------------------------------------------------------SS--SS----------------------g-------------------------------------------------------------------
----------------------------------------------------SS----------------------SSSSSSSSSSSS---------------------R-----oo-----oo---%%%--------------------
----------------------------------------------------SS-----------------------------------------------r--------------------SS----||--------------------
----------------------------------------------------SS----------------------------------------------%%%%%%%---------------------||---g#---------------
----------------------------------------------------SS----oo-----------------K------------------g---||||||----------------------||--g##---------------
----------------%%%%--------------------------------SSSS--SS---------------SSSSS----------------TT--||||||-----%%%%--%%%-----SS-||--###---------------
-----------------||-------------------K---------------SS--------------T-------------------------TT--||||||------||----||--------||-####------------#--
-----------------||-----------TTTT--------------------SS--------------T-------------------------TT--||||||------||----||--------||#####--------K---#--
-M---------------||------ggg--TTTT-------------ggg-----------y--------T-------------------------TT--||||||--ooo-||----||--------||#####------------#--
XXXXXXXXXXX--%%%%||%XXXXXXXXXXXXXXXXXXXX-XXXXXXXXXXXXXXXXXXXXXXXXXXXXXXXXXXXXXXXXXXXXX---XXXXXXXXXX-||||||--%%%-||----||%%-----%%%XXXXX--XXXXXXXX--XXX
XXXXXXXXXXX---||-||-XXXXXXXXXXXXXXXXXXXX-XXXXXXXXXXXXXXXXXXXXXXXXXXXXXXXXXXXXXXXXXXXXX---XXXXXXXXXX-||||||---|--||----|||-------||XXXXX--XXXXXXXX--XXX
