------------------------------------------------------------------------------------------------------------------------------------------------------
------------------------------------------------------------------------------------------------------------------------------------------------------
------------------------------------------------------------------------------------------------------------------------------------------------------
S-----SSSS----------SSSSSSSSSS--------------------------------------------------SSSSSSSSSS----------------------------------------SSSSSSSS------------
S-------------------------------------------------?---------------------------------------------------------------------------------------------------
S---------------------------------------ooooo---------------------------------------------------------------------------------------------------k-----
S-----------------SC-------------------------------------------------------g---------------------------------R-----------SSS----S!-------------SQS--SQ
S-----------------------------------------------SSSS-------------------%%%%%%----------------------------r--------------------------------------------
S----------------------------------------SSSS---------------------------||||------------------------%%%%%%%-------------------------------------------
S----------------------------C------------------------------------------||||-----------S------------||||||--------------------------------------------
S-------------TT---2---#-#-------------------------------------------T--||||----SU------------------||||||-----------------------S-----g##-----SQS--S?
S-------------TT-----#-#-#-#---------------------------SSS-----------T--||||--------TT---t----------||||||-----#-----------------------###------------
S-------------TT-----#-#-#-#----------------%%%%%--------------------T--||||--------TT---t-------B--||||||-----#---------------------g####------------
S--M----------TT-----#-#-#-#-E----k-k--------|||--------------ggg----T--||||-------kTT--kt-------b--||||||--oo-#----ggg-----gg-g-g---#####---k------gg
XXXXXXXXXXXXXXXXXXXXXXXXXXXXXXXXXXXXXXX-%%---|||------------XXXXXXXXXX--||||----XXXXXXXXXXXXXXXXXXXX||||||--%%-XXXXXXXXXXXXXXXXXXXXXXXXXXX--XXXXXXXXXX
XXXXXXXXXXXXXXXXXXXXXXXXXXXXXXXXXXXXXXX-|----|||------------XXXXXXXXXX--||||----XXXXXXXXXXXXXXXXXXXX||||||---|-XXXXXXXXXXXXXXXXXXXXXXXXXXX--XXXXXXXXXX
