------------------------------------------------------------------------------------------------------------------------------------------------------
------------------------------------------------------------------------------------------------------------------------------------------------------
------------------------------------------------------------------------------------------------------------------------------------------------------
----------------------------------------------------------------------SSSSSSSSSS----------------------------------------------------------------------
----------------------------------------------------------------------------SSSS----------------------------------------------------------------------
-------------------------------------------------------------------------g--SSSSK-----------oo--------------------------------------------------------
--------------------------------------------------------------USSS------SS------SS----1----------------------@-----oo--------------------##-SSS-------
------------------------------------------------------------------------SS------------------------------------------------------oo-------##-----------
------------------------------------------------------------------------SS-------------------------%-----------------------------------####-----------
------------------------------------------------------------------------SC--g-g--------------------------------------------------------####------SSSSS
-------------------------------------------------------ooo---S-----TT---SS--SSSSSS--------SS--------SU----!--!-%%%%--%%%-----TT------######-----------
---------------------------------------T---------------------------TT-----------------TT------------------------||----||-----TT------######-----------
---------------------------------------T---------------------------TT-----------------TT-----%%%%---------------||----||-----TT------######-SSS-------
-M--------k---ggg--------ggg---------kkT---------------------ggg---TT-----------------TT------||----------k---o-||----||-y---TT------######--------r--
XXXXXXXXXXXXXXXXXXXXXXXXXXXXXXXXXXXXXXXXX-XX-XX-XX--XXXXXXXXXXXXXXXXXXXXXXXXXXXXXXXXXXXXXX----||----XXXXXXXXXX%-||----||XXXXXXXXXXXXXXXXXXXX-----XXXXX
XXXXXXXXXXXXXXXXXXXXXXXXXXXXXXXXXXXXXXXXX-XX-XX-XX--XXXXXXXXXXXXXXXXXXXXXXXXXXXXXXXXXXXXXX----||----XXXXXXXXXX--||----||XXXXXXXXXXXXXXXXXXXX-----XXXXX
