------------------------------------------------------------------------------------------------------------------------------------------------------
------------------------------------------------------------------------------------------------------------------------------------------------------
------------------------------------------------------------------------------------------------------------------------------------------------------
---------------------------------------------------oo---------------------------SSSSSSSSSL----------SSSSSSSSSS----------------------------------------
--------------------------------------------------%%%%------------------------------------------------------------------------------------------------
----------------------ooor-------------------------||---------g---------------------------------------------------------------------------------k-----
------------------SC-%%%%%--------------------QQQQ-||---------SSSSS---------SSSS----oooooo------------------------------SSS------------US------SQS--SQ
----------------------|||--------------------------||--SSS-------------------------------------------------------SSS----------------------------------
----------------------|||--------------------------||-------------------------------SSSSSS------------------------------------------------------------
----------------------|||-----------------------k--||------------------------K------SSSSSS--------oo---------------------------------SS---------------
--------------TT---2%%%%%%%------------TT-----?QQQ-||----------------------SSSSS-----------------------------T-----------------------------S---SQS--S?
--------------TT----||||||-------------TT----------||-----------------T------------------------TT------TT----T----------------------------------------
--------------TT----||||||--o----------TT---------%||---------TT-----tT------------------------TT------TT----T----------------TT--TT------------------
-M------------TT----||||||-%%%--gg-----TT----------||---------TT-----tT---------------------y--TT---g--TT----T----------------TT--TT---------k------gg
XXXXXXXXXXXXXXXXXXXX||||||--|-XXXXXXXXXXXXXXXXXXXX-||-------XXXXXXXXXXXXXXXXXXXX---XXXXXXXXXXXXXXXXXXXXXXXXXXX%%%%----%%----XXXXXXXXXXXX-X-XXXXXXXXXXX
XXXXXXXXXXXXXXXXXXXX||||||--|-XXXXXXXXXXXXXXXXXXXX-||-------XXXXXXXXXXXXXXXXXXXX---XXXXXXXXXXXXXXXXXXXXXXXXXXX|||------|----XXXXXXXXXXXX-X-XXXXXXXXXXX
