------------------------------------------------------------------------------------------------------------------------------------------------------
------------------------------------------------------------------------------------------------------------------------------------------------------
------------------------------------------------------------------------------------------------------------------------------------------------------
----------------------------------------SSSSSSSSSS----------------------------------------------------------------------------------------------------
--------------------------------------------------?---------------------------------------------------------------------------------------------------
------------------------------------------------------------------------------------------------------------------------------------------------------
---------------------LSSS----------------oooo---------------------SSoo--------------y---------------------------------US------------------------------
--------------------------------o----ooo----------SS------------------------------#SSS----------------------------------------------------------------
-----------------------------------------SSSS-U----------------------------------##------------------------------------------SSS----------------------
----------------------------------------oS--SoS--------------------------1------###1--------------oo----------------E---------------------------------
-------------------%-2-----#----------%%SS--SSS-------------%%%%%%----T---------###--------------------------------TT---r------------------#----------
---------------------------#-----------|---------------SSS---||||-----T----TT---###--SSS-------TT------------------TT--t%%%%%%------------##----------
---------------------------##----------|---------------------||||-----T----TT---###------------TT---------*--------TT--t|||||------------###-------F--
-M-----------%%%%-----kk---##--%%%%%%%-|--kk-----------------||||-----T---kTT---###---------y--TT---gg----*-----g--TT--t|||||--------y--####-------#--
XXXXXXXXXXX---||----XXXXXXXXXX--|||||--|XXXXXXXXXX-----------||||-----XXXXXXXXXXXXXXXX---XXXXXXXXXXXXXXXXXXXX-XXXXXXXXXX|||||-----XXXXXXXXXXXXXXXXXXXX
XXXXXXXXXXX---||----XXXXXXXXXX--|||||--|XXXXXXXXXX-----------||||-----XXXXXXXXXXXXXXXX---XXXXXXXXXXXXXXXXXXXX-XXXXXXXXXX|||||-----XXXXXXXXXXXXXXXXXXXX
