------------------------------------------------------------------------------------------------------------------------------------------------------
------------------------------------------------------------------------------------------------------------------------------------------------------
------------------------------------------------------------------------------------------------------------------------------------------------------
-----------------------oo---------------------------------------------SSSSSSSSSSSSSSSSSSSS----------------------------------------SSSSSSSS------U-----
-----------------------------------------g----------------------------------SSSS----------------------------------------------------------------------
----------------------------------------%%-------------oooo---g----------g--SSSS------------oo--------------------------------------------------------
----------------------SSSS--------------|--------------%%%%---SSSSS-----SS--------------------------------2-----------US------------------------------
----------------------------------------|----oo---------||--------------SS------------------------------------------------------------------------SS--
----------------------------------------|---------------||--------------SS-------------------------%--------------------------------------------------
----------------------------------------|---------SSS---||--------------SC--g-g--------S------------o---------------E-------------------------SS------
----------Q---------------%%%%----------|---------------||--------------SS--SSSSSU--------S---------------2--------TT------------------g##-----------#
---------------------------|||----------|-------------U-||--------------------------TT---t-------------------------TT--t---------------###----------##
---------------------------|||----------|---------------||----TT-----t--------------TT---t---%%%%------------------TT--t-------------g####---------###
-M-----------------#-------|||----k-k---|---------------||----TT-----t-------------kTT--kt----||--------y--y----g--TT--t-k----ggg----#####--------####
XXXXXXXXXXXXX--XXXXX%%%----|||XXXXXXXXX-|----%%%%-----%%%%%-XXXXXXXXXXXXXXXXXXXXXXXXXXXXXX----||----XXXXXXXXXXXXXXXXXXXXXXXXXXXXXXXXXXXXXX--XXXXX-XXXX
XXXXXXXXXXXXX--XXXXX||-----|||XXXXXXXXX-|-----||-------|||--XXXXXXXXXXXXXXXXXXXXXXXXXXXXXX----||----XXXXXXXXXXXXXXXXXXXXXXXXXXXXXXXXXXXXXX--XXXXX-XXXX
