------------------------------------------------------------------------------------------------------------------------------------------------------
------------------------------------------------------------------------------------------------------------------------------------------------------
------------------------------------------------------------------------------------------------------------------------------------------------------
--------------------------------------------------------------------------------SSSSSSSSSS------------------------------SSS-----SS--------------------
------------------------------------------------------------------------------------------------------------------------------------------------------
------------------------------------------------------------------------------------------------------------------------------------------------------
------------------------------------------------------------------------------------------------------------------------US--------%-------------------
------------------------------------------------------------------------------------------------------------------------------------------------------
----------------------------------------------------------------------------------------------------------------------------SSS---------SSS-----------
-----------------------------------oo--------------------------------------------------S--------g-----------------------------------------------------
----------------------------TT----o--o---TT---SU---------tt----------#----------SU--------------TT----------------------SSS-------%%%%%---------------
-----------------K----------TT-----------TT--------------tt---------##--------------TT---t------TT-------------#-------------------|||----------------
------------B---------------TT-----------TT--------------tt-TT-----###--------------TT---t------TT--------*----#-------------------|||-------------F--
-M----------b-----------ggg-TT-----------TT------k---g-g-tt-TT----####gg-----------kTT--kt------TT--gg----*----#----ggg------------|||-------------#--
XXXXXXXXXXXXXXXXXXXXXXXXXXXXXXXXXXXXXXXXXXXXXXXXXXXXXXXXXXXXXXXXXXXXXXXXXXXXXXXXXXXXXXXXXXXXXXXXXXX-XXXXXXXXX--XXXXXXXXXXXX------X%|||------XXXXXXXXXX
XXXXXXXXXXXXXXXXXXXXXXXXXXXXXXXXXXXXXXXXXXXXXXXXXXXXXXXXXXXXXXXXXXXXXXXXXXXXXXXXXXXXXXXXXXXXXXXXXXX-XXXXXXXXX--XXXXXXXXXXXX------X-|||------XXXXXXXXXX
