------------------------------------------------------------------------------------------------------------------------------------------------------
------------------------------------------------------------------------------------------------------------------------------------------------------
------------------------------------------------------------------------------------------------------------------------------------------------------
------------------------------SSSSSSSSSS--------------------------------------------------------------------------------------------------------------
--------------------------------------------------?---------------------------------------------------------------------------------------------------
----------------------------------------------------------------------------------g-------------------------------------------------------------------
---------------------LSSS---------------------------------------------------SSSSSSSSSSSS--SSS------%---------R--------------------SS------------------
--------------------------------------------------SS-------------------------------------------------r----------oooo----------------------------------
---------------------------------------S------------------------------------------------------------%%%%%%%-------------------------------------------
---------------------------------------S-------------------------------------K----------------------||||||--------------SS-?Q-------------------------
---------------------2-----#-----------S-----------------------------------SSSSS------------%%%-----||||||----T-------------------SS--------#---------
---------------------------#---#-----------------------SSS-----------TT----------------------|------||||||----T-------------------K---#----B##--------
---------------------------##--#-#---------------------------B-------TT----------------------|------||||||----T----------------y------#----b###------#
--------------k-ggg---kk---##--#-#-------------y-------------b-------TT----------------------|------||||||--ooT---y--------SSSSS------#----B####----##
XXXXXXXXXXXXXXXXXXXXXXXXXXXXXXXXXXXXXXXXXXXXXXXXXX----------XXXXXX--XXXXXXXXXXXXXXXXXX---X---|------||||||--%%XXXXXXXXXX-------XX-XXXXXXXXXXXXXXXXXXXX
XXXXXXXXXXXXXXXXXXXXXXXXXXXXXXXXXXXXXXXXXXXXXXXXXX----------XXXXXX--XXXXXXXXXXXXXXXXXX---X---|------||||||---|XXXXXXXXXX-------XX-XXXXXXXXXXXXXXXXXXXX
