------------------------------------------------------------------------------------------------------------------------------------------------------
------------------------------------------------------------------------------------------------------------------------------------------------------
------------------------------------------------------------------------------------------------------------------------------------------------------
-----------------------oo-----------------------------------------------------------------------------------------------------------------------------
------------------------------------------------------------------------------------------------------------------------------------------------------
--------------------------------------------------------------------------------------------oo--------------------------------------------------------
----------------------SSSS-------------------------------------------------g-------USS------------------------?SSS------SSS--------------##-----------
-------------------------------------------------------------o---o---o-%%%%%%-----------------------oo-----------------------------------##-----------
------------------------------------------------------------%%%-%%%-%%--||||-----------------------%-----------------------------------####-----------
-------------------------------------------------------------|---|---|--||||-----------------------------------------------------------####-----------
----------Q---------------%%%%-------------------------------|---|---|--||||------#-------SS-----------------TSSSSS------------------######---#LSS----
---------------------------|||----------------------K--------|---|---|--||||------#--------------------------T-----------------------######---#-------
---------------------------|||-------------------------------|---|---|--||||------##---------%%%%------------T----------------TT-----######---#-------
-M-----------------#-------|||----k-k----------------------g-|---|-r-|--||||------##--gg------||----------y--T--K-------------TT-----######-kk#-------
XXXXXXXXXXXXX--XXXXX%%%----|||XXXXXXXXX-X-XX-XX-XXXXXXXXXXXX%%%%%%%%%%--||||------XXXXXXXX----||----XXXXXXXXXXXXXXXXXXXX----XXXXXXXXXXXXXXXXXXXXXXX---
XXXXXXXXXXXXX--XXXXX||-----|||XXXXXXXXX-X-XX-XX-XXXXXXXXXXXX-|||||||||--||||------XXXXXXXX----||----XXXXXXXXXXXXXXXXXXXX----XXXXXXXXXXXXXXXXXXXXXXX---
