------------------------------------------------------------------------------------------------------------------------------------------------------
------------------------------------------------------------------------------------------------------------------------------------------------------
------------------------------------------------------------------------------------------------------------------------------------------------------
--------------------------------------------------------------------------------------------------------------------------------------------SSSSSSSSSS
--------------------------------------------------?---------------------------------------------------------------------------------------------------
------------------------------------------------------------------------------------------------------oo----------------------------------------------
----------------------!-------S---------------QQQQ-------------------------g---------SUS---SSS!-------------------------------------------------------
--------------------------------------------------SS---------o---o---o-%%%%%%-------------------------------------------------------------------------
-----------------g------------------------------------------%%%-%%%-%%--||||---------------------------------------------------------g#---------------
-----------------#------------------------------k------------|---|---|--||||--------------------------------------------SS-?Q-------g##---------------
----------S-----##--S@S!S-----##--SSC---T-----?QQQ-----------|---|---|--||||--------#####-----C-------------------------------------###-------TT------
---------------###----------------------T--------------SSS---|---|---|--||||--------#--------------------------#-------------------####-------TT------
--------------####----------tt----------T--------------------|---|---|--||||-------K#-----------------------tt-#---------------y--#####-------TT------
-M-----------#####---g------tt----------T--------------------|---|-r-|--||||--------#----------g-g----ggg---tt-#----ggg----SSSSS--#####-------TT------
XXXXXXXXXXXXXXXXXXXXXXXXXXXXXXXX--XXXXXXXXXXXXXXXX----------%%%%%%%%%%--||||----XXXXXXX---XXXXXXXXXXXXXXXXXXXX-XXXXXXXXX-------XX-XXXXX--XXXXXXX--XXXX
XXXXXXXXXXXXXXXXXXXXXXXXXXXXXXXX--XXXXXXXXXXXXXXXX-----------|||||||||--||||----XXXXXXX---XXXXXXXXXXXXXXXXXXXX-XXXXXXXXX-------XX-XXXXX--XXXXXXX--XXXX
