------------------------------------------------------------------------------------------------------------------------------------------------------
------------------------------------------------------------------------------------------------------------------------------------------------------
------------------------------------------------------------------------------------------------------------------------------------------------------
------------------------------SSSSSSSSSSSSSSSSSSSSSSSSSSS---------------------------------------------------------------------------------------------
----------------------------------------SSSSSSSS------------------------------------------------------------------------------------------------------
----------------------------------------SSSCSSSS----------------------------------------------------oo------------------------------------------------
--------------------USS-----------------SSSSSSSS--QQ-----------------------g-------USS--------------%%%-----------------SS---------------##-----------
-----------------------------------------------------------------------%%%%%%-----------------------||--o----R---------------------------##-----------
---------------------------------------S-------------------S------------||||------------------------||-%%%-----------------------------####-----------
---------------------------------------S---ggg--------------------------||||--------------------g---||--|------------------TT----------####-----------
---------Q------%%%%-------------------SSSSSSSSS--QQ--QQQ---------------||||------#-------------TT--||--|-------!-----S----TT--------######-----------
-----------------||--B---------#--------SSSSSSSS---------------------T--||||------#-------------TT--||-o|---------------t--TT--------######--------#--
-----------------||--b-------B-#-#------SSSSSSSS-------------B-------T--||||------##------------TT--||%%%%%-------------t--TT--------######----K---#--
-M---------------||--B-------b-#-#------SSSSSSSS-------------b-------T--||||------##--gg--------TT--||-|||--------------t--TT--------######--------#--
XXXXXXXXXXX--%%%%||%XXXXXXXXXXXXXXXXXXXXXXXXXXXXXXXXXXXXX---XXXXXX--XX--||||------XXXXXXXXXXXXXXXXX-||-|||----XXXXXXXXXXXXXXXXXXXXXXXXXXXXXXXXXXX--XXX
XXXXXXXXXXX---||-||-XXXXXXXXXXXXXXXXXXXXXXXXXXXXXXXXXXXXX---XXXXXX--XX--||||------XXXXXXXXXXXXXXXXX-||-|||----XXXXXXXXXXXXXXXXXXXXXXXXXXXXXXXXXXX--XXX
