------------------------------------------------------------------------------------------------------------------------------------------------------
------------------------------------------------------------------------------------------------------------------------------------------------------
------------------------------------------------------------------------------------------------------------------------------------------------------
----------------------------------------SSSSSSSSSS-----------------SSS----------SSSSSSSSSL----------SSSSSSSSSS----------------------------------U-----
----------------------------------------SSSSSSSS------------------------------------------------------------------------------------------------------
----------------------------------------SSSCSSSS------------------------------------------------------------------------------------------------------
----------------------------------------SSSSSSSS----------------CSS-----------------oooooo----------------------------------------SS------------------
--------------------------------------------------------------------------------------------------------------------------------------------------SS--
-----------------%%%-------------------------------------TT-SS--2--------------g----SSSSSS-----------------------------------SSS----------------------
------------------||-----------------------ggg-----TT----TT----2-2------------------SSSSSS-o--------------------------------------------------SS------
-----SSS----------||SS------------------SSSSSSSS---TT----XX-------2----------S@S-----------------TT--------TT-----------r---------SS-----------------#
-------------%%%%%||-K---TT-----------ttSSSSSSSS---TT--------------------------------------------TT-----#--TT-----------%%%%%%----K---#----B--------##
--------------|||-||-----TT-----------ttSSSSSSSS---TT--------------------------------------------TT----##--TT-----------|||||---------#----b-------###
--------------|||-||-----TT-----------ttSSSSSSSS---TT--------------------------------------------TT-kk-##--TT--k----kkk-|||||---------#----B------####
XXXXXXXXXXX---|||-||XXXXXXXXXXXXXXXXXXXXXXXXXXXXXXXXXXXXXXXX---XXXXXXX-XXXXXXXXX---XXXXXXXXXXXXXXXXXXXXXX--XX-XXXXXXXXXX|||||-----XXXXXXXXXXXXXXX-XXXX
XXXXXXXXXXX---|||-||XXXXXXXXXXXXXXXXXXXXXXXXXXXXXXXXXXXXXXXX---XXXXXXX-XXXXXXXXX---XXXXXXXXXXXXXXXXXXXXXX--XX-XXXXXXXXXX|||||-----XXXXXXXXXXXXXXX-XXXX
