------------------------------------------------------------------------------------------------------------------------------------------------------
------------------------------------------------------------------------------------------------------------------------------------------------------
------------------------------------------------------------------------------------------------------------------------------------------------------
--------------------SSSSSSSSSS----------------------------------------SSSSSSSSSS----------------------------------------------------------------------
--------------------SSSSSSSSSS-----------------------------------------------------------------------------------------------------------------------o
--------------------SSSSSSSSSS------------------------------------------------------------------------------------------------------------------------
--------------------SSSSSSSSSS--------------------Q----------------------------------------SSS!---------SSQSSS----------------------------------------
------------------------------------------------------------------------------TT----------------------------------------------------------------SSS---
---------------------------------------------------------------------o--------TT------------------------------------------------------------oo--------
-----------------------------------------------------------------y------------TT--o-----------------------K--------------------SSS--------------------
---------Q------------SSSSSS?----------T------tt--Q--------------##---------SCTT-------TT-----C---------SSSSSS----------%------------------#SS--------
----------------------SSSSS------------T------tt----------------###-----TT----TT-------TT----------------------#--------------------------##----------
----------------------SSSSS------------T------tt---------------####-----TT----TT-------TT----------------------#-------------------------###----------
--------------k-ggg--------ooo--gg-----T-g----tt-----gg----k--#####-----TT---kTT-------TT------g-g-------------#----ggg----------r---y--####----------
XXXXXXXXXXXXXXXXXXXX-XXXXXXXXXXXXXXXXXXXXXXXXXXXXXXXXXXXXXXXXXXXXXX---XXXXXXXXXXXXXXXXXXXXXXXXXXXXXXXXXXXXXXXX-XXXXXXXXX----XXXXXXXXXXXXXXXX----------
XXXXXXXXXXXXXXXXXXXX-XXXXXXXXXXXXXXXXXXXXXXXXXXXXXXXXXXXXXXXXXXXXXX---XXXXXXXXXXXXXXXXXXXXXXXXXXXXXXXXXXXXXXXX-XXXXXXXXX----XXXXXXXXXXXXXXXX----------
