------------------------------------------------------------------------------------------------------------------------------------------------------
------------------------------------------------------------------------------------------------------------------------------------------------------
------------------------------------------------------------------------------------------------------------------------------------------------------
--------------------SSSSSSSSSS--oo--------------------------SSSSSSSSSSSSSSSSSSSS----------SSSSSSSSSS--------------------------------------------------
--------------------SSSSSSSSSS---------g--------------------SSSS--SSSS------SSSS----------------------------------------------------------------------
--------------------SSSSSSSSSS-----%%%%%--------------------SSSS--SSSS---g--SSSS--g-------------------oo----------------------------------------------
------------------SCSSSSSSSSSS------||||----------------------SS---S----SS------SSSSSSSS---------------------------------SSS----S!--------------------
------------------------------------||||----------------------SS---S----SS----------------------------------------------------------------------------
------------------------------------||||-----------------B----SS---S----SS----------------------------------------------------------------------------
------------------------------%%%%%-||||-----------------b--ooSS---SoU--SC--g-g-----------------------------------------------------------------------
--------------TT---2--SSSSSS?--|||--||||---------------SS#CSSSSS---SSS--SS--SSSS-------------------------------------------------S------------#LSS----
--------------TT------SSSSS----|||--||||-----------------------------------------------------------------------#------------------------------#-------
--------------TT------SSSSS----|||--||||-------------------K------------------------------------------------tt-#------------------------------#-------
-M------------TT-----------ooo-|||--||||----y-y-------------k--g-g------------------------------g-g---ggg---tt-#----ggg-----gg-g-g----------kk#-------
XXXXXXXXXXXXXXXXXXXX-XXXXXXXXX-|||--||||XXXXXXXXXXXXXXXXXXXXXXXXXXXXXXXXXXXXXXXXXXXXXX---XXXXXXXXXXXXXXXXXXXXX-XXXXXXXXXXXXXXXXXXXXXXXXXXXXXXXXXXXX---
XXXXXXXXXXXXXXXXXXXX-XXXXXXXXX-|||--||||XXXXXXXXXXXXXXXXXXXXXXXXXXXXXXXXXXXXXXXXXXXXXX---XXXXXXXXXXXXXXXXXXXXX-XXXXXXXXXXXXXXXXXXXXXXXXXXXXXXXXXXXX---
