------------------------------------------------------------------------------------------------------------------------------------------------------
------------------------------------------------------------------------------------------------------------------------------------------------------
------------------------------------------------------------------------------------------------------------------------------------------------------
------------------------------SSSSSSSSSS----------------------------------------SSSSSSSSSS------------------------------------------------------------
-----------------------------------------g------------------------------------------------------------------------------------------------------------
----------------------------------------%%---------------------------R--------------------------------------------------------------------------------
----------------------------------------|--------------------------------------------------------------------R-----------SSS----S!SS--------SS--------
----------------------------------------|----oo------------------------------------------------------r------------------------------------------------
---------------------------------------S|-----------------------------o-----------------------------%%%%%%%-------------------------------------------
------------Q--?-----------------------S|----------------o-----------------------------S------------||||||--------------------------------------------
-------------------S-------------------S|------------------------%%%------------SU------------------||||||------------r----------SSS--------SS--------
-------------------------------#--------|-------------------------|-----------#-----TT---t----------||||||--------%%%%%%----------K---#----B------#-TT
-------------------------------#-#------|-------------------------|----------##-----TT---t-------B--||||||---------|||||--------------#----b-----##-TT
-M----------------K------------#-#------|-----------k-------------|----------------kTT--kt-------b--||||||--oo-----|||||----gg-g-g----#----B----###-TT
XXXXXXXXXXXXXXXXXXXXXXXXX--XXXXXXXXXXXXX|----%%%%--XXXXXXXXX%%%%%-|---XXXXXXXXXXXXXXXXXXXXXXXXXXXXXX||||||--%%-%%%-|||||XXXXXXXXXXXXXXXXXXXXXXXXXXX-XX
XXXXXXXXXXXXXXXXXXXXXXXXX--XXXXXXXXXXXXX|-----||---XXXXXXXXX-|||--|---XXXXXXXXXXXXXXXXXXXXXXXXXXXXXX||||||---|--|--|||||XXXXXXXXXXXXXXXXXXXXXXXXXXX-XX
