------------------------------------------------------------------------------------------------------------------------------------------------------
------------------------------------------------------------------------------------------------------------------------------------------------------
------------------------------------------------------------------------------------------------------------------------------------------------------
--------------------------------------------------------------------------------SSSSSSSSSL------------------------------------------------------------
-----------------------------------------------------------------------------------------------------------------------------------------------------o
-------------------------------------------------------------------------------------------------------------------k----------------------------------
------------------------------------------------------------------------------------oooooo-SSS!---------------S---SSSSSS------------------------------
--------------------------------------------------------------------------------------------------------------------------------oo--------------SSS---
------------------------------------------------------------------------------------SSSSSS--------------------------------------------------oo--------
-------------------------------------------------------------------------1----------SSSSSS------------------------------------------------------------
----------------%%%%------------QQQQ---------------------------------#T-----------------------C-------%%%%%%-----------------TT-------------SS--------
-----------------||------------------K-B------------K---------------##T----TT--------------------------||||------------------TT------TT---------------
-----------------||--------------------b--------------------TT-----###T----TT--------------------------||||---TT-------------TT------TT---------------
-M---------------||--------------------b-------------------gTT----####T---kTT------------------g-g-----||||---TT---------y---TT------TT---------------
XXXXXXXXXXX--%%%%||%XXXXX--XXXXXXXXXXXXXX-XX-XX-XXXXXXXXXXXXXXXXXXXXXXXXXXXXXXXX---XXXXXXXXXXXXXXXXX%%-||||-%%XXXXXXXX--XXXXXXXXXXXXXXXXXXXX----------
XXXXXXXXXXX---||-||-XXXXX--XXXXXXXXXXXXXX-XX-XX-XXXXXXXXXXXXXXXXXXXXXXXXXXXXXXXX---XXXXXXXXXXXXXXXXX|--||||--|XXXXXXXX--XXXXXXXXXXXXXXXXXXXX----------
