------------------------------------------------------------------------------------------------------------------------------------------------------
------------------------------------------------------------------------------------------------------------------------------------------------------
------------------------------------------------------------------------------------------------------------------------------------------------------
--------------------SSSSSSSSSS------------------------------------------------------------SSSSSSSSSS--------------------------------------------------
------------------------------------------------------------------------------------------------------------------------------------------------------
-------------------------------------------------------oooo-----------------------g-------------------------------------------------------------k-----
-------------------------------------------------------%%%%----------------g----SSSSSSSS---------------------------oo--------------------##----SQS--SQ
--------------------------------------------------SSSS--||-------------%%%%%%------------------------------------------------------------##-----------
--------------------------------------------------------||-----------o--||||-----------------------------------------------------------####-----------
-----------------------------C--------------------------||-------y------||||-----------------------------------------------------------####-----------
----------------%%%%---#-#------------------------------||-------##-----||||--------------------------%%%%%%---%%%%--%%%-------------######----SQS--S?
-----------------||--#-#-#-#----------tt--------------U-||------###-----||||--------------t------------||||-----||----||-------------######-----------
-----------------||--#-#-#-#----------tt----------------||-----####-----||||--------------t------------||||-----||----||-------------######-----------
-M---------------||--#-#-#-#-E--------tt-------ggg------||----#####-----||||--------------t------------||||---o-||----||--kkk--------######--k------gg
XXXXXXXXXXX--%%%%||%XXXXXXXXXXXXXXXXXXXX-XXXXXXXXX----%%%%%-XXXXXXX-----||||----XXXXXX---XXXXXXXXXXX%%-||||-%%%-||----||XXXXXXXXXXXXXXXXXXXXXXXXXXXXXX
XXXXXXXXXXX---||-||-XXXXXXXXXXXXXXXXXXXX-XXXXXXXXX-----|||--XXXXXXX-----||||----XXXXXX---XXXXXXXXXXX|--||||--|--||----||XXXXXXXXXXXXXXXXXXXXXXXXXXXXXX
