------------------------------------------------------------------------------------------------------------------------------------------------------
------------------------------------------------------------------------------------------------------------------------------------------------------
------------------------------------------------------------------------------------------------------------------------------------------------------
------------------------------------------------------------------------------------------------------------------------SSSSSSSSSS--------------------
------------------------------------------------------------------------------------------------------------------------------------------------------
--------------------------------------------------------------g---------------------------------------------------------------------------------------
------------------------------S-------------------------------SSSSS-----------------y------SSS!-----------------------------------!S------------------
----------------------------------------------------------------------------------#SSS--------------oo------------------------------------------------
-----------------g---------------------------------------TT----------------------##-------------------------------------------------------------------
-----------------#---------------------------------TT----TT---------------------###1------------------------------------------------------------------
----------S-----##--SS--------##--SSC--------------TT----XX---------------------###-----------C--------------T--------------------S------#------------
---------------###---K---TT------------------------TT---------------------------###--SSS---------------------T-#----------SS------------##---------#--
--------------####-------TT------------------------TT---------TT-----t----------###--------------------------T-#----------SS-----------###-----K---#--
-M-----------#####-------TT-----------------y-y----TT---------TT-----t----------###------------g-g--------y--T-#----ggg---SS----------####---------#--
XXXXXXXXXXXXXXXXXXXXXXXXXXXXXXXX--XXXXXXXXXXXXXXXXXXXXXXXXXXXXXXXXXXXXX----XXXXXXXXXXX---XXXXXXXXXXXXXXXXXXXXX-XXXXXXXXX--XX--XXXXXXXXXXXXXXXXXXX--XXX
XXXXXXXXXXXXXXXXXXXXXXXXXXXXXXXX--XXXXXXXXXXXXXXXXXXXXXXXXXXXXXXXXXXXXX----XXXXXXXXXXX---XXXXXXXXXXXXXXXXXXXXX-XXXXXXXXX--XX--XXXXXXXXXXXXXXXXXXX--XXX
