------------------------------------------------------------------------------------------------------------------------------------------------------
------------------------------------------------------------------------------------------------------------------------------------------------------
------------------------------------------------------------------------------------------------------------------------------------------------------
------------------------------SSSSSSSSSS--------------------SSSSSSSSSS--------------------------------------------------------------------------------
------------------------------SSSSSSSSSS--------------------SSSS--SSSS--------------------------------------------------------------------------------
------------------------------SSSSSSSSSS--------------------SSSS--SSSS--------------------------------------------------------------------------------
----------------------!-------SSSSSSSSSS------QQQQQ-----------SS---S----------------y----------------------------------------------SSSS-----SS--------
--------------------------------------------------------------SS---S--------------#SSS---------------------------SSS----------------------------------
--------------------------------------------------------------SS---S-------------##------------------------------------------SSS----------------------
------------------------------------------------k-----------ooSS---SoU----------###1-----------oooo------------------------------------SSSS-----------
--------------------S@S!S-----SSSSSSSSSST-----?QQQQ---------SSSS---SSS----------###-------------------------------------r-------------------SS--------
-----------------K------------SSSSSSSSSST---------------------------------------###--SSS--------------------g-----------%%%%%%--------------------#-TT
------------B---------------ttSSSSSSSSSST---------------------------------------###-------------------------TT----------|||||--------------------##-TT
---M--------b--------g------ttSSSSSSSSSST------------gg----kk--g-g----gg--------###-------------------------TT----------|||||-------------------###-TT
XXXXXXXXXXXXXXXXXXXXXXXXXXXXXXXXXXXXXXXXXXXXXXXXXXXXXXXXXXXXXXXXXXXXXXXXXXXXXXXXXXXXXX---X%%%%%%%-%%--XXXXXXXX%%%%----%%|||||--------------XXXXXXXX-XX
XXXXXXXXXXXXXXXXXXXXXXXXXXXXXXXXXXXXXXXXXXXXXXXXXXXXXXXXXXXXXXXXXXXXXXXXXXXXXXXXXXXXXX---X||||||---|--XXXXXXXX|||------||||||--------------XXXXXXXX-XX
