------------------------------------------------------------------------------------------------------------------------------------------------------
------------------------------------------------------------------------------------------------------------------------------------------------------
------------------------------------------------------------------------------------------------------------------------------------------------------
--------------------------------oo--------------------------------------------------------------------------------------------------------------------
-------------------------------------g-g--------------------------------------------------------------------------------------------------------------
-----------------------------------%%%%%--------------------------------------------------------------------------------------------------------------
------------------------------------||||--------------------------SSoo----SS---------SSSS---------------------?SSS---------------------------QQQQ-----
------------------------------------||||------------------------------------------------------------------------------------------oo------------------
------------------------------------||||--------------------------------------------------------------------------------------------------------------
------------------------------%%%%%-||||-----------------o-------------------------------------------------------------------------------------y------
----------------!--------------|||--||||--------------------%%%%%%----SS-----SS-Q-----------------------------SSSSS------------------------QQ?SSQQQ---
-------------------------------|||--||||---------------------||||-------------------------------------------g-----------------------------------------
-------------------------------|||--||||---------------------||||--------------------------------B----------TT----------------------------------------
-M-----------------------------|||--||||------------k--------||||----------------ggg-------------b----------TT--K--------k----ggg---------------------
XXXXXXXXXXXXXXXXXXXXXXXXX--XXX-|||--||||X-XX-XX-XX-XXXXXXXXX-||||---------------XXXXX----XXXXXXXXXXX--XXXXXXXXXXXXXXXXXXXXXXXXXXXXXXXXXXXXXXXX--XXXXXX
XXXXXXXXXXXXXXXXXXXXXXXXX--XXX-|||--||||X-XX-XX-XX-XXXXXXXXX-||||---------------XXXXX----XXXXXXXXXXX--XXXXXXXXXXXXXXXXXXXXXXXXXXXXXXXXXXXXXXXX--XXXXXX
