------------------------------------------------------------------------------------------------------------------------------------------------------
------------------------------------------------------------------------------------------------------------------------------------------------------
------------------------------------------------------------------------------------------------------------------------------------------------------
------------------------------------------------------------------------------------------------------------------------------------------------------
------------------------------------------------------------------------------------------------------------------------------------------------------
-------------------------------------------------------oooo-------------------------------------------------------------------------------------------
-------------------------------------------------------%%%%---------------SSCSS------SSSS--------------------R?SSS--------SSC---------------SSS-------
--------------------------------------------------------||----------------------------------------oo-r------------------------------------------------
--------------------------------------------------------||------------------------------------------%%%%%%%-------------------------------------------
--------------------------------------------------SSS---||------------------------------------------||||||----------------SSS--------------------SSSSS
-------------------%-------------------T------tt--------||--------------QQQQ--QQQ-------------------||||||----SSSSS-----------------------------------
---------------------------------------T------tt------U-||--------------------------------------#---||||||--------------------------------------------
---------------------------------------T------tt--------||--------------------------------------#---||||||----------------------------------SSS-------
-------------%%%%---------------gg-----T-g----tt--------||--gg-------g-----------ggg------------#---||||||--oo--K----------------#k----------------r--
XXXXXXXXXXX---||----XXXXX--XXXXXXXXXXXXXXXXXXXXXXX----%%%%%-XXXXXXXXXXXXXXXXXXXXXXXXX----XXXXXXXXXXX||||||--%%XXXXXXXXXXX----XXXXXXX---XXXXX-----XXXXX
XXXXXXXXXXX---||----XXXXX--XXXXXXXXXXXXXXXXXXXXXXX-----|||--XXXXXXXXXXXXXXXXXXXXXXXXX----XXXXXXXXXXX||||||---|XXXXXXXXXXX----XXXXXXX---XXXXX-----XXXXX
