------------------------------------------------------------------------------------------------------------------------------------------------------
------------------------------------------------------------------------------------------------------------------------------------------------------
------------------------------------------------------------------------------------------------------------------------------------------------------
----------------------------------------SSSSSSSSSS------------------------------SSSSSSSSSS--------------------SS-------S------------------------------
----------------------------------------SSSSSSSS------------------------------------------------------------------------------------------------------
----------------------------------------SSSCSSSS------------------------------------------------------------------------------------------------------
--------------------S-------------------SSSSSSSS--------------------------SS----------------------------SSQSSS---------S--oo---%%%-SSSS---------------
---------------------------TT---------------------------------------------------------------------oo----------------------SS----||--------------------
---------------------------TT--------------------------------------------------------------------------------------SSS----------||--------------------
---------------------------XX------oo------ggg-----------------------------------------S------------------K---------------------||-----SSSS-----------
-----------------------TT---------o--o--SSSSSSSS-------ooo------------SS-----SS-SU----------------------SSSSSS---------S-----SS-||------------#LSS----
-----------------K-----TT---------------SSSSSSSS------------------------------------TT---t------#--------------##---------------||------------#-------
------------B----------TT---------------SSSSSSSS------------------------------------TT---t------#--------------##---------------||------------#-------
------------b-------k--TT---------------SSSSSSSS-------------y---------------------kTT--kt------#--------------##---------------||----------kk#-------
XXXXXXXXXXXXXXXXXXXXXXXXXXXXXXXXXXXXXXXXXXXXXXXXXX--XXXXXXXXXXXXXXXXXX----------XXXXXXXXXXXXXXXXXXXXXXXXXXXXXX-XX------X%%-----%%%---------XXXXXXXX---
XXXXXXXXXXXXXXXXXXXXXXXXXXXXXXXXXXXXXXXXXXXXXXXXXX--XXXXXXXXXXXXXXXXXX----------XXXXXXXXXXXXXXXXXXXXXXXXXXXXXX-XX------X|-------||---------XXXXXXXX---
