------------------------------------------------------------------------------------------------------------------------------------------------------
------------------------------------------------------------------------------------------------------------------------------------------------------
------------------------------------------------------------------------------------------------------------------------------------------------------
----------SSSSSSSSSS----------SSSSSSSSSS----------SSSSSSSSSS----------------------------------------------------------------------SSSSSSSS------------
------------------------------------------------------SS--SS------------------------------------------------------------------------------------------
------------------------------------------------------SS--SS--------------------------------oo--------------------------------------------------------
--------------------S-------------------------------SS----------------------SSSS---USS----------------------------------------------------------------
---------------------------TT-----------------------SS------------------------------------------------------------------------------------------------
---------------------------TT----------S------------SS---------------------------------------------%--------------------------SSS---------------------
---------------------------XX----------S------------SS----oo-----------------K------------------------------------------------------------------------
-----------------------TT--------------S------------SSSS--SS---------------SSSSS--#-------S---------------------!-----S-%--------------g##------------
-----------------------TT------#----------------------SS--------------T-----------#-------------------------g--------------------------###------------
-----------------------TT------#-#--------------------SS--------------T-----------##---------%%%%-----------TT-----------------------g####---------F--
-M------------------k--TT------#-#---------------------------y--------T-----------##--gg------||------------TT-------------------r---#####---------#--
XXXXXXXXXXX--XX--X--XXXXXXXXXXXXXXXXXXXXX-XX-XX-XXXXXXXXXXXXXXXXXXXXXXXXXXXXXXXX--XXXXXXXX----||------XXXXXXXXXXXXXXXXXX----XXXXXXXXXXXXXX--XXXXXXXXXX
XXXXXXXXXXX--XX--X--XXXXXXXXXXXXXXXXXXXXX-XX-XX-XXXXXXXXXXXXXXXXXXXXXXXXXXXXXXXX--XXXXXXXX----||------XXXXXXXXXXXXXXXXXX----XXXXXXXXXXXXXX--XXXXXXXXXX
