------------------------------------------------------------------------------------------------------------------------------------------------------
------------------------------------------------------------------------------------------------------------------------------------------------------
------------------------------------------------------------------------------------------------------------------------------------------------------
---------------------------------------------------oo-------------------------------------------------------------------------------------------------
--------------------------------------------------%%%%------------------------------------------------------------------------------------------------
---------------------------------------------------||---------g---------------------------------------------------------------------------------------
---------------------------------------------------||---------SSSSS-----------------y-----SSS------%---------R---------------------------##-SSS-------
---------------------------------------------------||--SSS------------------------#SSS-------------------r------oooo---------------------##-----------
---------------------------------------------------||----------------------------##-----------------%%%%%%%------------------SSS-------####-----------
-----------------------------------oo--------------||---------------------------###1----------------||||||-----------------------------####------SSSSS
---------QQ-----------------TT----o--o-------------||---------------------------###---------%%%-----||||||----T---------r------------######-----------
----------------------------TT---------------------||---------------------------###--SSS-----|------||||||----T---------%%%%%%-------######-----------
----------------------------TT--------------------%||---------TT-----t----------###----------|------||||||----T---------|||||--------######-SSS-------
-M-----------------#----ggg-TT-----------------y---||---------TT-----t----------###----------|------||||||--ooT---y-----|||||--------######--------r--
XXXXXXXXXXXXX--XXXXXXXXXXXXXXXXXXXXXXXXXXXXXXXXXXX-||-------XXXXXXXXXXX----XXXXXXXXXXX---X---|------||||||--%%XXXXXXXXXX|||||-----XXXXXXXXXX-----XXXXX
XXXXXXXXXXXXX--XXXXXXXXXXXXXXXXXXXXXXXXXXXXXXXXXXX-||-------XXXXXXXXXXX----XXXXXXXXXXX---X---|------||||||---|XXXXXXXXXX|||||-----XXXXXXXXXX-----XXXXX
