------------------------------------------------------------------------------------------------------------------------------------------------------
------------------------------------------------------------------------------------------------------------------------------------------------------
------------------------------------------------------------------------------------------------------------------------------------------------------
----------SSSSSSSSSSSSSSSSSSSS---------------------oo-------------------------------------------------------------------------------------------------
--------------------------------------------------%%%%------------------------------------------------------------------------------------------------
----------------------------------------ooooo------||-----------------------------------------------oo------------------------------------------------
---------------------------------------------------||-------------SSoo----SS------------------------%%%---------------------------SS------------------
------------------------------------------------SS-||--SSS------------------------------------------||--o----R--oooo----------------------------------
-----------------------------------------SSSS------||-----------------------------TT----------------||-%%%--------------------------------------------
-----------------------------C---------------------||-----------------------------TT----------------||--|---------------------------------------------
----------@QQQQ--------#-#-------------------------||-------%%%%%%----SS-----SS---TT-------------tt-||--|-----T-------------------SS------------------
---------------------#-#-#-#-----------T-----------||--------||||-----------------TT-----TT------tt-||-o|-----T-------------------K---#----B----------
-----------------g-#-#-#-#-#-----------T----%%%%%-%||--------||||---------------T-TT-----TT------tt-||%%%%%---T-----------------------#----b-------F--
-M--------------g#-#-#-#-#-#-E-------kkT-----|||---||--------||||---------------T-TT---k-TT------tt-||-|||----T---y------k----ggg-----#----B-------#--
XXXXXXXXXXXXXXXXXXXXXXXXXXXXXXXXXXXXXXXX%%---|||---||--------||||---------------XXXXXXXXXXXXXXXXXXXX||-|||----XXXXXXXXXXXXXXXXXXXXXXXXXXXXXXXXXXXXXXXX
XXXXXXXXXXXXXXXXXXXXXXXXXXXXXXXXXXXXXXXX|----|||---||--------||||---------------XXXXXXXXXXXXXXXXXXXX||-|||----XXXXXXXXXXXXXXXXXXXXXXXXXXXXXXXXXXXXXXXX
