------------------------------------------------------------------------------------------------------------------------------------------------------
------------------------------------------------------------------------------------------------------------------------------------------------------
------------------------------------------------------------------------------------------------------------------------------------------------------
----------SSSSSSSSSS--------------------SSSSSSSSSS----------------------------------------------------------------------------------------------------
----------------------------------------SSSSSSSS------------------------------------------------------------------------------------------------------
----------------------ooor--------------SSSCSSSS--------------g-------------------------------------oo------------------------------------------------
---------------------%%%%%--------------SSSSSSSS--------------SSSSS---------SSSS--------------------%%%---------------------------SS--------SSS-------
----------------------|||---------------------------------------------------------------------------||--o----R---SSS----------------------------------
----------------------|||---------------------------------------------------------------------------||-%%%--------------------------------------------
----------------------|||------------------ggg-------------------------------K----o------------oooo-||--|----------------------------------------SSSSS
--------------------%%%%%%%-----QQQQ----SSSSSSSS---------tt----------------SSSSS-------TT-----------||--|-------------------------SS------------------
--------------------||||||-----------K-BSSSSSSSS---------tt-----------T----------------TT-----------||-o|-------------------------K---#----B----------
--------------------||||||--o----------bSSSSSSSS---------tt---TT-----tT----------------TT-----------||%%%%%---------------------------#----bSSS-------
-M------------------||||||-%%%---------bSSSSSSSS-----g-g-tt---TT-----tT----------------TT-----------||-|||---------------k----ggg-----#----B-------r--
XXXXXXXXXXX--XX--X--||||||--|-XXXXXXXXXXXXXXXXXXXXXXXXXXXXXXXXXXXXXXXXXXXXXXXXXXXXXXXXXXXX%%%%%%%-%%||-|||----%%%%----%%XXXXXXXXXXXXXXXXXXXX-----XXXXX
XXXXXXXXXXX--XX--X--||||||--|-XXXXXXXXXXXXXXXXXXXXXXXXXXXXXXXXXXXXXXXXXXXXXXXXXXXXXXXXXXXX||||||---|||-|||----|||------|XXXXXXXXXXXXXXXXXXXX-----XXXXX
