------------------------------------------------------------------------------------------------------------------------------------------------------
------------------------------------------------------------------------------------------------------------------------------------------------------
------------------------------------------------------------------------------------------------------------------------------------------------------
--------------------SSSSSSSSSS--------------------------------------------------------------------------------------------------------------SSSSSSSSSS
--------------------SSSSSSSSSS------------------------------------------------------------------------------------------------------------------------
--------------------SSSSSSSSSS--------ooooooo-------------------------------------------------------oo------------------------------------------------
--------------------SSSSSSSSSS-----SSSS------------------Q-Q------SSoo----SSCSS------1--------------%%%------------oo--------------SSSS---------------
------------------------------------------------SS--------------------------------------------------||--o----R----------------------------------------
-----------------------------------------SSSS-------------------------------------------------------||-%%%-------------------SSS----------------------
--------------------------------------------------------------------------------------------------oo||--|------------------------------SSSS-----------
----------------%%%%--SSSSSS?-%--------------------------Q-Q%%%%%%------QQQQ--QQ---QQQQ-------------||--|------%%%%--%%%r---------------------TT------
-----------------||---SSSSS----------------------------------||||------------------------------TT---||-o|-------||----||%%%%%%----------------TT------
-----------------||---SSSSS-----------------%%%%%------------||||------------------------------TT---||%%%%%-----||----|||||||-----------------TT------
---M-------------||--------ooo---------------|||-------------||||-------------------yy------y--TT---||-|||----o-||----|||||||-----------------TT------
XXXXXXXXXXX--%%%%||%-XXXXXXXXX--%%%%--%%%%---|||--XXXXXXXXXX-||||-----XXXXXXXXXXXXXXXXXXXXXXXXXXXXXX||-|||----%-||----|||||||--------------XXXXX--XXXX
XXXXXXXXXXX---||-||--XXXXXXXXX---||----||----|||--XXXXXXXXXX-||||-----XXXXXXXXXXXXXXXXXXXXXXXXXXXXXX||-|||------||----|||||||--------------XXXXX--XXXX
