------------------------------------------------------------------------------------------------------------------------------------------------------
------------------------------------------------------------------------------------------------------------------------------------------------------
------------------------------------------------------------------------------------------------------------------------------------------------------
-----------------------oo-----------------------------------SSSSSSSSSS--------------------------------------------------------------------------------
------------------------------------------------------------SSSS--SSSS--------------------------------------------------------------------------------
----------------------------------------%%------------------SSSS--SSSS--------------------------------------------------------------------------------
----------------------SSSS--------------|---------Q-----------SS---S-------g-------USS----------------------------------------------------------------
----------------------------------------|----oo---------------SS---S---%%%%%%---------------------oooo------------------------------------------------
----------------------------------------|---------------------SS---S----||||--------------------------------------------------SSS---------------------
------------Q--?------------------------|-------------------ooSS---SoU--||||--------------------------------------------------------------------------
--------SU---------S------%%%%---------T|---------Q---------SSSS---SSS--||||------#--------------------------T----------%------------------#----------
---------------------------|||---------T|-------------------------------||||------#-------------#------------T----------------------------##----------
---------------------------|||---------T|-------------------------------||||------##------------#------------T-----B---------------------###-------F--
--M---------------K--------|||--gg-----T|------------gg----kk--g-g------||||------##--gg--------#---------y--T-----b-------------r---y--####-------#--
XXXXXXXXXXXXXXXXXXXX%%%----|||XXXXXXXXXX|----%%%%-XXXXXXXXXXXXXXXXXXXX--||||------XXXXXXXXXXXXXXXXXXXXXXXXXXXXXXXXXXXXXX----XXXXXXXXXXXXXXXXXXXXXXXXXX
XXXXXXXXXXXXXXXXXXXX||-----|||XXXXXXXXXX|-----||--XXXXXXXXXXXXXXXXXXXX--||||------XXXXXXXXXXXXXXXXXXXXXXXXXXXXXXXXXXXXXX----XXXXXXXXXXXXXXXXXXXXXXXXXX
