------------------------------------------------------------------------------------------------------------------------------------------------------
------------------------------------------------------------------------------------------------------------------------------------------------------
------------------------------------------------------------------------------------------------------------------------------------------------------
----------SSSSSSSSSS------------oo------------------------------------------------------------------------------------------------SSSSSSSS------------
---------------------------------------g--------------------------------------------------------------------------------------------------------------
-----------------------------------%%%%%--------------------------------------------------------------------------------------------------------------
--------------------S---------------||||----------------------USSS---------g---------SSSS--------------------R-----------SSS----S!--------------------
---------------------------TT-------||||-------------------------------%%%%%%----------------------------r--------------------------------------------
---------------------------TT-------||||--------------------------------||||------------------------%%%%%%%-------------------------------------------
---------------------------XX-%%%%%-||||--------------------------------||||------------------------||||||--------------------------------------------
----------@QQQQ--------TT------|||--||||-----------------tt--S-----TT---||||----Q-------------------||||||------!-----S----------S-----g##------------
-----------------------TT------|||--||||-----------------tt--------TT---||||------------------------||||||-----------------------------###------------
-----------------g-#---TT------|||--||||-----------------tt--------TT---||||------------------------||||||---------------------------g####---------F--
-M--------------g#-#k--TT------|||--||||-------y-----g-g-tt--ggg---TT---||||-----ggg---------------g||||||--oo--------------gg-g-g---#####---------#--
XXXXXXXXXXXXXXXXXXXXXXXXXXXXXX-|||--||||XXXXXXXXXXXXXXXXXXXXXXXXXXXXXX--||||----XXXXX----X-XXXXXXXXX||||||--%%XXXXXXXXXXXXXXXXXXXXXXXXXXXX--XXXXXXXXXX
XXXXXXXXXXXXXXXXXXXXXXXXXXXXXX-|||--||||XXXXXXXXXXXXXXXXXXXXXXXXXXXXXX--||||----XXXXX----X-XXXXXXXXX||||||---|XXXXXXXXXXXXXXXXXXXXXXXXXXXX--XXXXXXXXXX
