------------------------------------------------------------------------------------------------------------------------------------------------------
------------------------------------------------------------------------------------------------------------------------------------------------------
------------------------------------------------------------------------------------------------------------------------------------------------------
----------------------------------------------------------------------------------------------------SSSSSSSSSS----------------------------------------
------------------------------------------------------------------------------------------------------------------------------------------------------
--------------------------------------------------------------------------------K-----------oo--------------------------------------------------------
--------------------S-----------------------------------------USSS---------g----SS----1--------------------------------------------SSSS-----SSS-------
---------------------------TT------------------------------------------%%%%%%---------------------------------------------------oo--------------------
---------------------------TT-------------------------------------------||||-----------------------%--------------------------------------------------
---------------------------XX-------------------------------------------||||-----------------------------------------------------------SSSS------SSSSS
----------------%%%%---TT-------QQQQ------------------S------S-----TT---||||----SS--------S------------------T---------------TT-----------------------
-----------------||----TT------------K-B----------TT---------------TT---||||----------TT---------------TT----T-#-------------TT-----------------------
-----------------||----TT--------------b----------TT---------------TT---||||----------TT-----%%%%------TT----T-#-------------TT-------------SSS-------
-M---------------||-k--TT--------------b-------y--TT------k--ggg---TT---||||----------TT------||----g--TT----T-#----ggg--y---TT--------------------r--
XXXXXXXXXXX--%%%%||%XXXXXXXXXXXXXXXXXXXXXXXXXXXXXXXXXXXXXXXXXXXXXXXXXX--||||----XXXXXXXXXX----||----XXXXXXXXXX-XXXXXXXXXXXXXXXXXXX---------X-----XXXXX
XXXXXXXXXXX---||-||-XXXXXXXXXXXXXXXXXXXXXXXXXXXXXXXXXXXXXXXXXXXXXXXXXX--||||----XXXXXXXXXX----||----XXXXXXXXXX-XXXXXXXXXXXXXXXXXXX---------X-----XXXXX
