------------------------------------------------------------------------------------------------------------------------------------------------------
------------------------------------------------------------------------------------------------------------------------------------------------------
------------------------------------------------------------------------------------------------------------------------------------------------------
----------SSSSSSSSSS-------------------------------oo-------------------------------------------------------------------SSSSSSSSSS--------------------
--------------------------------------------------%%%%------------------------------------------------------------------------------------------------
----------------------------------------ooooo------||-------------------------------------------------------------------------------------------------
---------------------LSSS--------------------------||-------------------SSSSS--------SSSS-SSS------%-------------------------------------##-----------
------------------------------------------------SS-||--SSS------------------------------------------oo-----------------------------------##----y------
-----------------------------------------SSSS------||----------------------------------------------------------------------------------####--#SS--o---
---------------------------------------------------||----------------------------------------------------------------------------------####-##--------
----------@QQQQ------2-----#-----------T-----------||----------------T-------2--Q-----------%%%--------------T-----------------------######-##--SC----
---------------------------#-----------T-----------||----------------T-----TT----------------|---------------T------------SS---------######-##--------
-----------------g-#-------##----------T----%%%%%-%||----------------Tt----TT--T-------------|---------------T-----B------SS---------######-##---SSS--
-M--------------g#-#--kk---##---gg-----T-----|||---||---------ggg----Tt----TT--T-ggg---------|------------y--T-----b------SS---------######-##--------
XXXXXXXXXXXXXXXXXXXXXXXXXXXXXXXXXXXXXXXX%%---|||---||-------XXXXXXXXXXXXXXXXXXXXXXXXX----X---|------XXXXXXXXXXXXXXXXXXXX--XX--XXXXXXXXXXXXXXXX------XX
XXXXXXXXXXXXXXXXXXXXXXXXXXXXXXXXXXXXXXXX|----|||---||-------XXXXXXXXXXXXXXXXXXXXXXXXX----X---|------XXXXXXXXXXXXXXXXXXXX--XX--XXXXXXXXXXXXXXXX------XX
