------------------------------------------------------------------------------------------------------------------------------------------------------
------------------------------------------------------------------------------------------------------------------------------------------------------
------------------------------------------------------------------------------------------------------------------------------------------------------
----------SSSSSSSSSS---oo--------------------------oo---------------------------SSSSSSSSSS--------------------SS-------S------------------------------
--------------------------------------------------%%%%-------------------o----------------------------------------------------------------------------
---------------------------------------------------||-------------------%%%-----------------oo--------------------------------------------------------
----------------------SSSS-------------------------||---------USSS-------|--o--------------------------------R---------S----------!S------------------
---------------------------------------------------||--SSS---------------|--SSSS-------------------------r-------------------------------------y------
---------------------------------------------------||-----------------%--|-------------------------%%%%%%%%--------SSS-----------------------#SS--o---
---------------------------------------------------||--------------------|-------------S------------||||||----------------------------------##--------
-----SSS--@QQQQ-----------%%%%---------------------||--------S-----TT----|------SU--------S---------||||||-------------S----------S------#--##--SC----
---------------------------|||---------T-----------||--------------TT----|----------TT---t----------||||||-----##-----------------------##--##--------
-----------------g-#-------|||---------T----------%||--------------TT----|-----%----TT---t---%%%%---||||||-----##----------------------###--##---SSS--
----------------g#-#-------|||-------kkT-------ggg-||--------ggg---TT----|---------kTT--kt----||----||||||--oo-##---------kkk---------####--##--------
XXXXXXXXXXXXXXXXXXXX%%%----|||XXXXXXXXXX-XXXXXXXXX-||-------XXXXXXXXXX%%%%%%----XXXXXXXXXX----||----||||||--%%-XX------XXXXXXXXXXXXXXXXXXXXXXX------XX
XXXXXXXXXXXXXXXXXXXX||-----|||XXXXXXXXXX-XXXXXXXXX-||-------XXXXXXXXXX|||||-----XXXXXXXXXX----||----||||||---|-XX------XXXXXXXXXXXXXXXXXXXXXXX------XX
