------------------------------------------------------------------------------------------------------------------------------------------------------
------------------------------------------------------------------------------------------------------------------------------------------------------
------------------------------------------------------------------------------------------------------------------------------------------------------
----------------------------------------SSSSSSSSSS----------SSSSSSSSSS--------------------SSSSSSSSSSSSSSSSSSSS----------SSSSSSSSSS----------SSSSSSSSSS
--------------------------------------------------?---------SSSS--SSSS---o----------------------------------------------------------------------------
----------------------ooor------------oo--------------------SSSS--SSSS--%%%---------------------------------------------------------------------------
---------------------%%%%%---------SSSS--oooo-----------------SS---S-----|--o-------y-------------------------?SSS-----------------------##-----------
----------------------|||-------------------------SS----------SS---S-----|--SSSS--#SSS---------------------------------------------------##-----------
----------------------|||----------------SSSS-U---------------SS---S--%--|-------##----------------------------------------------------####-----------
------------Q--?------|||---------------oS--SoS-------------ooSS---SoU---|------###1---------------------------------------------------####-----------
--------SU---------S%%%%%%%---%---------SS--SSS-------------SSSS---SSS---|------###------------------------TT-SSSSS------------------######---TT------
--------------------||||||-----------------------------SSS---------------|------###--SSS----------------#--TT-------------SS---------######---TT------
--------------------||||||--o--------------------------------------------|-----%###--------------------##--TT-------------SS---------######---TT------
--M---------------K-||||||-%%%------------kk----------------k--g-g-------|------###-------------g-g-kk-##--TT---K---------SS---------######---TT------
XXXXXXXXXXXXXXXXXXXX||||||--|---%%%%--%%XXXXXXXXXX----------XXXXXXXXXX%%%%%%----XXXXXX---XXXXXXXXXXXXXXXX--XX-XXXXXXXXXX--XX--XXXXXXXXXXXXXXXXXX--XXXX
XXXXXXXXXXXXXXXXXXXX||||||--|----||----|XXXXXXXXXX----------XXXXXXXXXX|||||-----XXXXXX---XXXXXXXXXXXXXXXX--XX-XXXXXXXXXX--XX--XXXXXXXXXXXXXXXXXX--XXXX
