------------------------------------------------------------------------------------------------------------------------------------------------------
------------------------------------------------------------------------------------------------------------------------------------------------------
------------------------------------------------------------------------------------------------------------------------------------------------------
------------------------------------------------------------------------------------------------------------------------------------------------------
-----------------------------------------g------------------------------------------------------------------------------------------------------------
----------------------ooor--------------%%-------------------------------------------------------------------------k----------------------------------
---------------------%%%%%--------------|-----------------------------------SSSS-----1-----SSS!---------------S---SSSSSS--SSC------------##-SSS-------
----------------------|||-------o----ooo|----oo------------------------------------------------------------------------------------------##-----------
----------------------|||---------------|----------------TT----------------------------------------------------------------------------####-----------
----------------------|||---------------|----------TT----TT-----1------------K--------------------------------------------SSS----------####------SSSSS
-------------------%%%%%%%%-----------%%|----------TT----XX----------------SSSSS---QQQQ-------C-------%%%%%%-------------------------######-----------
--------------------||||||-------------||----------TT-----------------T--------------------------------||||--------------------------######-----------
--------------------||||||--o----------||----------TT-----------------T--------------------------------||||---TT---------------------######-SSS-------
-M-----------%%%%---||||||-%%%-%%%%%%%-||----------TT-----------------T-------------yy---------g-g-----||||---TT-----------------#---######--------r--
XXXXXXXXXXX---||----||||||--|---|||||--||----%%%%-XXXXXXXXXXXXXXXXXXX-XXXXXXXXXXXXXXXXXXXXXXXXXXXXXX%%-||||-%%XXXXXXXX--X----XXXXXXXXXXXXXXX-----XXXXX
XXXXXXXXXXX---||----||||||--|---|||||--||-----||--XXXXXXXXXXXXXXXXXXX-XXXXXXXXXXXXXXXXXXXXXXXXXXXXXX|--||||--|XXXXXXXX--X----XXXXXXXXXXXXXXX-----XXXXX
