------------------------------------------------------------------------------------------------------------------------------------------------------
------------------------------------------------------------------------------------------------------------------------------------------------------
------------------------------------------------------------------------------------------------------------------------------------------------------
--------------------------------------------------------------------------------------------------------------SSSSSSSSSS----------SSSSSSSS------U-----
--------------------------------------------?----------------------------o----------------------------------------------------------------------------
------------------------------------------------------------------------%%%-------------oo------------------------------------------------------------
---------------------LSSS------------------------------------------------|--o---oo---------SSS!-------------------------------------------------------
----------------------------------------------r--------------o---o---o---|--SSSS------------------------------------------------------------------SS--
------------------------------------------%%%%%%------------%%%-%%%-%%%--|---------------------------------------------------SSS----------------------
-------------------------------------------||||--------------|---|---|---|-------SSS----------------------------------------------------------SS------
---------Q---------%-2-----#----QQQQ----%%-||||ooo-------tt--|---|---|---|---------------S----C---------------T---------r--------------g##-----------#
---------------------------#---------K-B|--||||--r-------tt--|---|---|---|----------------------------------g-T---------%%%%%%---------###----------##
---------------------------##----------b|%%%%%%%%%-------tt--|---|---|---|-----%----------------------------TTT----TT---|||||--------g####---------###
-------------%%%%-----kk---##----------b|-||||||||---g-g-tt--|---|-r-|---|---------------------g-g----------TTT--g-TT---|||||--------#####--------####
XXXXXXXXXXX---||----XXXXXXXXXXXXXXXXXXXX|-||||||||XXXXXXXXXX%%%%%%%%%%%%%%%%--------------XXXXXXXXXX--XXXXXXXXXXXXXXXXXX|||||-----XXXXXXXX--XXXXX-XXXX
XXXXXXXXXXX---||----XXXXXXXXXXXXXXXXXXXX|-||||||||XXXXXXXXXX-||||||||||||||---------------XXXXXXXXXX--XXXXXXXXXXXXXXXXXX|||||-----XXXXXXXX--XXXXX-XXXX
