------------------------------------------------------------------------------------------------------------------------------------------------------
------------------------------------------------------------------------------------------------------------------------------------------------------
------------------------------------------------------------------------------------------------------------------------------------------------------
S-----SSSS----------------------------------------------------------------------ooo-------------------------------------------------------------------
S-------------------------------------------------------------------------------%%%-------------------------------------------------------------------
S----------------------SSS------------oo-----------------------------------------|--------------------------------------------------------------------
S----------------------------------SSSS-----------------------USSS---------------|----------------------------------------SSC------------##-----------
S--------------------g-----------------------------------------------------------|-------------------------------------------------------##-----------
S-------------------%%%--------------------------------------------------------g-|-----------------------------------------------------####-----------
S-------------------||----SSS----------------------------------------------------|---%%%%---------------------------------SSS----------####-----------
S-------------------||--------%-----------------------S------S-----TT--------S@S-|----||------------------------------r--------------######-#---------
S-------------------||----------------------------TT---------------TT-----------%%%%%%||--------------TT----------%%%%%%-------------######-##--------
S-------------------||----------------------------TT---------------TT------------||||-||--------------TT----TT-----|||||-------------######-###------#
S--M----------k-ggg-||----oo----------------------TT------k--ggg---TT------------||||-||-----------g--TT-k--TT-----|||||---------#---######-####----##
XXXXXXXXXXXXXXXXXXXX||---%%%----%%%%--%%X-XX-XX-XXXXXXXXXXXXXXXXXXXXXX-XXXXXXXXX-||||-||%%-XXXXXXXXXXXXXXXXXXX-%%%-|||||X----XXXXXXXXXXXXXXXXXXXXXXXXX
XXXXXXXXXXXXXXXXXXXX||----|------||----|X-XX-XX-XXXXXXXXXXXXXXXXXXXXXX-XXXXXXXXX-||||-||-|-XXXXXXXXXXXXXXXXXXX--|--|||||X----XXXXXXXXXXXXXXXXXXXXXXXXX
