------------------------------------------------------------------------------------------------------------------------------------------------------
------------------------------------------------------------------------------------------------------------------------------------------------------
------------------------------------------------------------------------------------------------------------------------------------------------------
--------------------------------oo----------------------------------------------ooo-------------------------------------------------------------------
-------------------------------------g-g-g--------------------------------------%%%------------------------------------------------------------------o
-----------------------------------%%%%%%%--------------------g------------------|--------------------------------------------------------------------
------------------SC---------U------|||||---------------------SSSSS--------g-----|--------SSS------%--------------------SSS---------------------------
------------------------------------|||||----oo------------------------%%%%%%----|-------------------------------SSS----------------------------SSS---
------------------------------------|||||-------------------------------||||-----|----------------------------------------------------------oo--------
------------------------------%%%%%-|||||----------------o--------------||||-----|---%%%%-------------------------------------------------------------
--------------TT---2--------##-|||--|||||-------------------------------||||-----|----||----%%%--------------------------------------------#SS--------
--------------TT-------y-#####-|||--|||||-------------------------------||||----%%%%%%||-----|--------------g-----------------------------##----------
--------------TT----y-######---|||--|||||---------------------TT-----t--||||-----||||-||-----|--------------TT----------------TT---------###----------
-M------------TT----######-----|||--|||||-----------k---------TT-----t--||||-----||||-||-----|--------------TT----------------TT-----y--####----------
XXXXXXXXXXXXXXXXXXXXXXXX-------|||--|||||----%%%%--XXXXXXXXXXXXXXXXXXX--||||-----||||-||%%---|--------XXXXXXXX%%%%----%%----XXXXXXXXXXXXXXXX----------
XXXXXXXXXXXXXXXXXXXXXXXX-------|||--|||||-----||---XXXXXXXXXXXXXXXXXXX--||||-----||||-||-|---|--------XXXXXXXX|||------|----XXXXXXXXXXXXXXXX----------
