------------------------------------------------------------------------------------------------------------------------------------------------------
------------------------------------------------------------------------------------------------------------------------------------------------------
------------------------------------------------------------------------------------------------------------------------------------------------------
S-----SSSS----------------------------------------------------------------------SSSSSSSSSL--------------------SSSSSSSSSSSSSSSSSSSS--------------------
S-----------------------------------------------------------------------------------------------------------------------------------------------------
S------------------------------------------------------oooo-------------------------------------------------------------------------------------------
S------------------------------------------------------%%%%-------------------------oooooo--------------------------------------------------SSS-------
S-------------------------------------------------------||------------------------------------------oo------------------------------------------------
S-------------------------------------------------------||------------o-------------SSSSSS-------------------------------------------g#---------------
S----------------------------------oo-------------SSS---||--------------------------SSSSSS-o----------------------------------------g##----------SSSSS
S---------------%%%%--------------o--o------------------||-----------T---------------------------TT----------TT---------------------###---------------
S----------------||-----------------------------------U-||-----------T--------#------------------TT----------TT-----------SS-------####---------------
S----------------||-------------------------------------||-----------T-------##------------------TT----------TT----TT-----SS------#####-----SSS-------
S----------------||----------------------------ggg------||----ggg----T---------------------------TT-------y--TT--g-TT-----SS------#####------------r--
XXXXXXXXXXX--%%%%||%XXXXX--XXXXXXXXXXXXX-XXXXXXXXX----%%%%%-XXXXXXXXXXXXXXXXXXXX---XXXXXXXXXXXXXXXXXXXXXXXXXXXXXXXXXXXXX--XX--XXXXXXXXX--XXX-----XXXXX
XXXXXXXXXXX---||-||-XXXXX--XXXXXXXXXXXXX-XXXXXXXXX-----|||--XXXXXXXXXXXXXXXXXXXX---XXXXXXXXXXXXXXXXXXXXXXXXXXXXXXXXXXXXX--XX--XXXXXXXXX--XXX-----XXXXX
