------------------------------------------------------------------------------------------------------------------------------------------------------
------------------------------------------------------------------------------------------------------------------------------------------------------
------------------------------------------------------------------------------------------------------------------------------------------------------
--------------------------------------------------------------------------------------------------------------SS-------S------------------------------
-------------------------------------------------------------------------o----------------------------------------------------------------------------
----------------------ooor-------------------------------------------R--%%%-----K---------------------------------------------------------------------
---------------------%%%%%--------------------QQQQ-----------------------|--o---SS----1-----------------SSQSSS---------S------------------------------
----------------------|||------------------------------------------------|--SSSS--------------------------------------------------oo-----------y------
-----------------%%%--|||--------------------------------B------------%--|-----------------------------------------SSS-----------------------#SS--o---
------------------||--|||-----------------------k--------b---------------|-----------------o--------------K-------------SS-?Q---------------##--------
------------------||%%%%%%%------------TT-----?QQQ-----SS#CS-----%%%-----|------SS---------------TT-----SSSSSS---------S-------------------Q##--SC----
-------------%%%%%||||||||-------------TT-------------------------|------|------------TT---------TT------------##---------------------------##--------
--------------|||-||||||||--o----------TT------------------K------|------|-----%------TT---------TT------------##--------------y------------##---SSS--
-M------------|||-||||||||-%%%--gg-----TT-------------------------|------|------------TT---------TT------------##----------SSSSS------------##--------
XXXXXXXXXXX---|||-||||||||--|-XXXXXXXXXXXXXXXXXXXXXXXXXXXXXX%%%%%-|---%%%%%%----XXXXXXXXXXXXXXXXXXXXXXXXXXXXXX-XX------X-------XX-XXXXXXXXXXXX------XX
XXXXXXXXXXX---|||-||||||||--|-XXXXXXXXXXXXXXXXXXXXXXXXXXXXXX-|||--|---|||||-----XXXXXXXXXXXXXXXXXXXXXXXXXXXXXX-XX------X-------XX-XXXXXXXXXXXX------XX
