------------------------------------------------------------------------------------------------------------------------------------------------------
------------------------------------------------------------------------------------------------------------------------------------------------------
------------------------------------------------------------------------------------------------------------------------------------------------------
----------SSSSSSSSSS------------------------------SSSSSSSSSS------------------------------SSSSSSSSSS--------------------------------------------------
------------------------------------------------------SS--SS------------------------------------------------------------------------------------------
------------------------------------------------------SS--SS--------------------K-------------------oo------------------------------------------------
----------------------------------------------------SS--------------------SS----SS----1-------------%%%----------------------------SSSS---------------
----------------------------------------------------SS-------o---o---o------------------------------||--o----R----------------------------------------
----------------------------------------------------SS------%%%-%%%-%%------------------------------||-%%%--------------------------------------------
----------------------------------------------------SS----oo-|---|---|------------------------------||--|---------------SS-?Q----------SSSS-----------
-----SSS--@QQQQ-------------------------------------SSSS--SS-|---|---|SS-----SS-SS------------------||--|-------------r---------------------#---------
------------------------------------------------------SS-----|---|---|----------------TT------------||-o|---------%%%%%%--------------------##--------
-----------------g-#----------------------------------SS-----|---|---|----------------TT------------||%%%%%--------|||||-------y------------###------#
----------------g#-#-----ggg------k-k----------y-------------|---|-r-|----------------TT--------g-g-||-|||---------|||||---SSSSS------------####----##
XXXXXXXXXXXXXXXXXXXXXXXXXXXXXXXXXXXXXXX-XXXXXXXXXXXXXXXXXXXX%%%%%%%%%%----------XXXXXXXXXXXXXXXXXXXX||-|||-----%%%-|||||-------XX----------XXXXXXXXXXX
XXXXXXXXXXXXXXXXXXXXXXXXXXXXXXXXXXXXXXX-XXXXXXXXXXXXXXXXXXXX-|||||||||----------XXXXXXXXXXXXXXXXXXXX||-|||------|--|||||-------XX----------XXXXXXXXXXX
