------------------------------------------------------------------------------------------------------------------------------------------------------
------------------------------------------------------------------------------------------------------------------------------------------------------
------------------------------------------------------------------------------------------------------------------------------------------------------
S-----SSSSSSSSSSSSSS---oo-------oo-----------------oo-------------------------------------------------------------------------------------------------
S--------------------------------------g-g--------%%%%------------------------------------------------------------------------------------------------
S----------------------------------%%%%%%%---------||---------------------------------------oo--------------------------------------------------------
S---------------------SSSS----------|||||----------||--------------------------------1--------------------2-------------------------------------------
S-----------------------------------|||||----oo----||--SSS--------------------------------------------------------------------------------------------
S-----------------------------------|||||----------||----------------------------------------------%--------------------------------------------------
S-----------------------------%%%%%-|||||----------||-----------------------------------------------o-------------------SS-?Q-------------------------
S---------@QQQQ-----------%%%%-|||--|||||----------||----------------T-------------QQQQ---SS--------------2-------------------------------------------
S--------------------------|||-|||--|||||----------||----------------T-----------------------------------------------------------------------------#--
S----------------g-#-------|||-|||--|||||---------%||----------------T-----------------------%%%%------------------B-----------y---------------K---#--
S---------------g#-#-------|||-|||--|||||----------||---------ggg----Tgg------------yy--------||--------y--y-------b-------SSSSS-------------------#--
XXXXXXXXXXXXXXXXXXXX%%%----|||-|||--|||||----%%%%--||-------XXXXXXXXXXXXXXXXXXXXXXXXXXXXXX----||----XXXXXXXXXXXXXXXXXXXX-------XX-XXXXXXXXXXXXXXX--XXX
XXXXXXXXXXXXXXXXXXXX||-----|||-|||--|||||-----||---||-------XXXXXXXXXXXXXXXXXXXXXXXXXXXXXX----||----XXXXXXXXXXXXXXXXXXXX-------XX-XXXXXXXXXXXXXXX--XXX
