------------------------------------------------------------------------------------------------------------------------------------------------------
------------------------------------------------------------------------------------------------------------------------------------------------------
------------------------------------------------------------------------------------------------------------------------------------------------------
------------------------------------------------------------------------------------------------------------------------------------------------------
------------------------------------------------------------------------------------------------------------------------------------------------------
--------------------------------------------------------------------------------------------oo--------------------------------------------------------
--------------------------------------------------------------USSS-------------------SUS---------------------@?SSS--------------------------SS--------
------------------------------------------------------------------------------------------------------------------------------------------------------
-----------------%%%-----------------------------------------------------------g-------------------%--------------------------------------------------
------------------||----------------------------------------------------------------------------------------------------SS-?Q-------------------------
------------------||SS---------------------------------ooo---S-----TT--------S@S----#####-S---------SU----!--!SSSSS-------------------------SS--------
-------------%%%%%||-K---TT-----------K------K---B-----------------TT---------------#-------------------------------------------------------------#-TT
--------------|||-||-----TT---TTTT---------------b-----------------TT--------------K#--------%%%%------------------------------y-----------------##-TT
-M------------|||-||-----TT---TTTT---------------B-----------ggg---TT---------------#---------||----------k-----K----------SSSSS--k-------------###-TT
XXXXXXXXXXX---|||-||XXXXXXXXXXXXXXXXXXXXXXXXXXXXXX--XXXXXXXXXXXXXXXXXX-XXXXXXXXXXXXXXXX-------||----XXXXXXXXXXXXXXXXXXXX-------XX-XX---XXXXXXXXXXXX-XX
XXXXXXXXXXX---|||-||XXXXXXXXXXXXXXXXXXXXXXXXXXXXXX--XXXXXXXXXXXXXXXXXX-XXXXXXXXXXXXXXXX-------||----XXXXXXXXXXXXXXXXXXXX-------XX-XX---XXXXXXXXXXXX-XX
