------------------------------------------------------------------------------------------------------------------------------------------------------
------------------------------------------------------------------------------------------------------------------------------------------------------
------------------------------------------------------------------------------------------------------------------------------------------------------
-----------------------oo-----------------------------------------------------------------------------------------------------------------------------
------------------------------------------------------------------------------------------------------------------------------------------------------
--------------------------------------oo%%----------------------------------------------oo------------------------------------------------------------
------------------SC--SSSS---------SSSS-|---------------------USSS------SSSSS---oo---------------------------------oo--------------------##-SSS-------
----------------------------------------|----oo-----------------------------------------------------------TT-----------------------------##-----------
----------------------------------------|-----------------------------------------------------------------TT---------------------------####-----------
----------------------------------------|----------------------------------------SSS----------------------TT---------------------------####------SSSSS
--------------TT---2------%%%%%---------|----------------tt--S-----TT--------2-----------S---------------SXXS--%%%%--%%%-------------######-----------
--------------TT-----------|||----------|----------------tt--------TT------TT-----------------------------------||----||-------------######-----------
--------------TT-----------|||----------|----------------tt--------TT-t----TT--T--------------------TT----------||----||-------------######-SSS-------
-M------------TT-----------|||----------|------------g-g-tt--ggg---TT-t----TT--T-------------------gTT--------o-||----||-k----ggg----######--------r--
XXXXXXXXXXXXXXXXXXXX%%%----|||--%%%%--%%|----%%%%-XXXXXXXXXXXXXXXXXXXXXXXXXXXXXX-----------XXXXXXXXXXXXXXXXXXX%-||----||XXXXXXXXXXXXXXXXXXXX-----XXXXX
XXXXXXXXXXXXXXXXXXXX||-----|||---||----||-----||--XXXXXXXXXXXXXXXXXXXXXXXXXXXXXX-----------XXXXXXXXXXXXXXXXXXX--||----||XXXXXXXXXXXXXXXXXXXX-----XXXXX
