------------------------------------------------------------------------------------------------------------------------------------------------------
------------------------------------------------------------------------------------------------------------------------------------------------------
------------------------------------------------------------------------------------------------------------------------------------------------------
--------------------SSSSSSSSSS--oo---------------------------------SSS----------SSSSSSSSSS------------------------------SSSSSSSSSS--------------------
-------------------------------------g-g---------------------------------o---------------------------------------------------------------------------o
-----------------------------------%%%%%--------------------------------%%%---------------------------------------------------------------------------
------------------------------------||||----------Q-------------CSS------|--o---------------------------------?SSS------------------------------------
------------------------------------||||---------------------------------|--SSSS----------------------------------------------------------------SSS---
------------------------------------||||--------------------SS--2-----%--|------------------------------------------------------------------oo--------
-----------------------------C%%%%%-||||-----------------------2-2-------|-------------S--------------------------------------------------------------
-----------------------#-#-----|||--||||------tt--Q---------------2------|------SU----------------------------SSSSS-------------------------SS--------
---------------------#-#-#-#---|||--||||------tt-------------------------|----------TT---t--------------------------------SS--------------------------
---------------------#-#-#-#---|||--||||------tt-------------------------|-----%----TT---t-------B--------*---------------SS--------------------------
---M------k---ggg----#-#-#-#-E-|||--||||-g----tt-----gg----k-------------|---------kTT--kt-------b--gg----*-----K---------SS------k-------------------
XXXXXXXXXXXXXXXXXXXXXXXXXXXXXX-|||--||||XXXXXXXXXXXXXXXXXXXX---XXXXXXX%%%%%%----XXXXXXXXXXXXXXXXXXXXXXXXXXXXX-XXXXXXXXXX--XX--XXXXXX---XXXXX----------
XXXXXXXXXXXXXXXXXXXXXXXXXXXXXX-|||--||||XXXXXXXXXXXXXXXXXXXX---XXXXXXX|||||-----XXXXXXXXXXXXXXXXXXXXXXXXXXXXX-XXXXXXXXXX--XX--XXXXXX---XXXXX----------
