------------------------------------------------------------------------------------------------------------------------------------------------------
------------------------------------------------------------------------------------------------------------------------------------------------------
------------------------------------------------------------------------------------------------------------------------------------------------------
--------------------SSSSSSSSSS----------SSSSSSSSSS------------------------------------------------------------SSSSSSSSSS------------------------------
--------------------SSSSSSSSSS----------SSSSSSSS------------------------------------------------------------------------------------------------------
--------------------SSSSSSSSSS----------SSSCSSSS------------------------------------------------------------------------------------------------------
------------------Q-SSSSSSSSSS----------SSSSSSSS--Q--------------------------------o--o---------------------------------SSS-----------------SS--------
--------------------------------------------------------------------------------------------------oo--------------------------------------------------
-------------------------------------------------------------------------------g----------------------------------------------------------------------
-------------------------------------------ggg-------------------------------------SSSS---------------------------------------------------------------
------------------?---SSSSSS?--TT-------SSSSSSSS--Q------------------T-------S@S------------------------------T-----------------------------SS--------
--------------TT------SSSSS----TT-------SSSSSSSS---------------------T--------------------------#-----TT------T----------------------TT-----------#-TT
--------------TT------SSSSS----TT-------SSSSSSSS---------------------T----------%%%-------------#-----TT----TTT----TT---------TT-----TT----------##-TT
-M------------TT-----------ooogTT-------SSSSSSSS-----gg----k--ggg----T----------||--------------#-----TT-k--TTT--g-TT---------TT-----TT---------###-TT
XXXXXXXXXXXXXXXXXXXX-XXXXXXXXXXXXXXXXX--XXXXXXXXXXXXXXXXXXXXXXXXXXXXXX-XXXXXXXXX||--------XXXXXXXXXXXXXXXXXXXXXXXXXXXXXX----XXXXXXXXXXXXXXXXXXXXXXX-XX
XXXXXXXXXXXXXXXXXXXX-XXXXXXXXXXXXXXXXX--XXXXXXXXXXXXXXXXXXXXXXXXXXXXXX-XXXXXXXXX||--------XXXXXXXXXXXXXXXXXXXXXXXXXXXXXX----XXXXXXXXXXXXXXXXXXXXXXX-XX
