------------------------------------------------------------------------------------------------------------------------------------------------------
------------------------------------------------------------------------------------------------------------------------------------------------------
------------------------------------------------------------------------------------------------------------------------------------------------------
--------------------------------------------------SSSSSSS---------------------------------------------------------------------------------------------
-----------------------------------------------------------------------------------------------------------------------------------------------------o
---------------------------------------------------------------------R----------K---------------------------------------------------------------------
--------------------------------------------------QQ----------------------------SS----1----------------------@------------oo---%%%SS------------------
--------------------------------o----ooo----------------------------------------------------------------------------------SS----||--------------SSS---
-----------------g-----------------------------------------S--------------------------------------------------------------------||----------oo--------
-----------------#-------------------------------------------------------1------------------------------------------------------||--------------------
----------S-----##--------------------%%-TT---SU--QQ--QQQ--------%%%--T---------SS------------------SU----!--!---------------SS-||SS--------SS--------
---------------###---------------------|-TT-----------------------|---T----TT---------TT-----------------------#----------------||K---#----B----------
--------------####---------------------|-TT-----------------------|---T----TT---------TT-----------------------#----------------||----#----b----------
-M-----------#####-------------%%%%%%%-|-TT------k----------------|---T---kTT---------TT-----------g------k----#----ggg---------||----#----B----------
XXXXXXXXXXXXXXXXXXXXXXXXX--XXX--|||||--|XXXXXXXXXXXXXXXXX---%%%%%-|---XXXXXXXXXXXXXXXXXXXX-XXXXXXXXXXXXXXXXXXX-XXXXXXXXX%%-----%%%XXXXXXXXXX----------
XXXXXXXXXXXXXXXXXXXXXXXXX--XXX--|||||--|XXXXXXXXXXXXXXXXX----|||--|---XXXXXXXXXXXXXXXXXXXX-XXXXXXXXXXXXXXXXXXX-XXXXXXXXX|-------||XXXXXXXXXX----------
