------------------------------------------------------------------------------------------------------------------------------------------------------
------------------------------------------------------------------------------------------------------------------------------------------------------
------------------------------------------------------------------------------------------------------------------------------------------------------
--------------------SSSSSSSSSS------------------------------------------------------------------------------------------------------------------------
------------------------------------------------------------------------------------------------------------------------------------------------------
-------------------------------------------------------oooo---g---------------------------------------------------------------------------------------
------------------Q---------------------------QQQQ-----%%%%---SSSSS-----------------y------------------------R-----oo-----------------------SS--------
--------------------------------o----ooo----------------||------------------------#SSS---------------r------------------------------------------------
--------------------------------------------------------||---------------------g-##-----------------%%%%%%%-------------------------------------------
-----------------------------C------------------k-SSS---||----------------------###1-------o--------||||||--------------------------------------------
------------------?----#-#------------%%T-----?QQQ------||-------------------S@S###--------------TT-||||||-----%%%%--%%%-------------------#SS--------
--------------TT-----#-#-#-#-----------|T-------------U-||----------------------###--SSS---------TT-||||||------||----||------------------##------#-TT
--------------TT-----#-#-#-#-----------|T---------------||----TT-----t----------###--------------TT-||||||------||----||-----------------###-----##-TT
-M------------TT-----#-#-#-#-E-%%%%%%%-|T---------------||----TT-----t----------###--------------TT-||||||--ooo-||----||-k----ggg----y--####----###-TT
XXXXXXXXXXXXXXXXXXXXXXXXXXXXXX--|||||--|XXXXXXXXXX----%%%%%-XXXXXXXXXX-XXXXXXXXXXXXXXX---XXXXXXXXXXX||||||--%%%-||----||XXXXXXXXXXXXXXXXXXXXXXXXXXX-XX
XXXXXXXXXXXXXXXXXXXXXXXXXXXXXX--|||||--|XXXXXXXXXX-----|||--XXXXXXXXXX-XXXXXXXXXXXXXXX---XXXXXXXXXXX||||||---|--||----||XXXXXXXXXXXXXXXXXXXXXXXXXXX-XX
