------------------------------------------------------------------------------------------------------------------------------------------------------
------------------------------------------------------------------------------------------------------------------------------------------------------
------------------------------------------------------------------------------------------------------------------------------------------------------
--------------------------------------------------------------------------------ooo-----------------SSSSSSSSSSSS-------S------------------------------
--------------------------------------------------------------------------------%%%-------------------------------------------------------------------
---------------------------------------------------------------------------------|----------oo--------------------------------------------------------
----------------------------------------------QQQQ------------USSS---------------|-------------------------------------S------------------------------
---------------------------------------------------------------------------------|----------------------------------------------oo-------------y------
---------------------------------------------------------B-----------------------|-----------------%---------------SSS-----------------------#SS--o---
-----------------------------------oo-----------k--------b-----------------------|---%%%%---------------------------------------------------##--------
---------Q------------------------o--o--T-----?QQQ-----SS#CS-S-----TT------------|----||--SS---------------TT----------S-----TT-------------##--SC----
----------------------------------------T--------------------------TT-----------%%%%%%||----------------#--TT--##------------TT------TT-----##--------
----------------------------------------T------------------K-------TT------------||||-||-----%%%%------##--TT--##------------TT------TT-----##---SSS--
----------k---ggg--------ggg------------T--------------------ggg---TT-gg---------||||-||------||----kk-##--TT--##--------y---TT------TT-----##--------
XXXXXXXXXXXXXXXXXXXXXXXXXXXXXXXXXXXXXXXXXXXXXXXXXXXXXXXXXXXXXXXXXXXXXXXXXXXXXXXX-||||-||%%----||----XXXXX--XX--XX------XXXXXXXXXXXXXXXXXXXXXXX------XX
XXXXXXXXXXXXXXXXXXXXXXXXXXXXXXXXXXXXXXXXXXXXXXXXXXXXXXXXXXXXXXXXXXXXXXXXXXXXXXXX-||||-||-|----||----XXXXX--XX--XX------XXXXXXXXXXXXXXXXXXXXXXX------XX
