------------------------------------------------------------------------------------------------------------------------------------------------------
------------------------------------------------------------------------------------------------------------------------------------------------------
------------------------------------------------------------------------------------------------------------------------------------------------------
--------------------------------oo------------------------------------------------------------------SSSSSSSSSS----------------------------------U-----
---------------------------------------g-g------------------------------------------------------------------------------------------------------------
-----------------------------------%%%%%%%----------------------------------------------oo------------------------------------------------------------
------------------Q-----------------|||||----------------Q-Q------------SSSSS---oo---------------------------------oo-----oo---%%%--------------------
------------------------------------|||||----oo---------------------------------------------------------------------------SS----||----------------SS--
------------------------------------|||||---------------------------------------------------------------------------------------||--------------------
------------------------------%%%%%-|||||----------------------------------------SS---------------------------------------------||------------SS------
------------------?------------|||--|||||----------------Q-Q-----------------2-----------S-------tt--------TT--%%%%--%%%-----SS-||-------------------#
--------------TT---------------|||--|||||----------------------------T-----TT-------------T------tt-----#--TT---||----||--------||------------------##
--------------TT---------------|||--|||||--------------------B-------Tt----TT--T----------T------tt----##--TT---||----||--------||-----------------###
-M------------TT---------ggg---|||--|||||--------------------b-------Tt----TT--T----------T------tt-kk-##--TT-o-||----||--------||----------------####
XXXXXXXXXXXXXXXXXXXXXXXXXXXXXX-|||--|||||----%%%%-XXXXXXXXXXXXXXXX--XXXXXXXXXXXX----------XXXXXXXXXXXXXXX--XX-%-||----||%%-----%%%XXXXXXXXXXXXXXX-XXXX
XXXXXXXXXXXXXXXXXXXXXXXXXXXXXX-|||--|||||-----||--XXXXXXXXXXXXXXXX--XXXXXXXXXXXX----------XXXXXXXXXXXXXXX--XX---||----|||-------||XXXXXXXXXXXXXXX-XXXX
