------------------------------------------------------------------------------------------------------------------------------------------------------
------------------------------------------------------------------------------------------------------------------------------------------------------
------------------------------------------------------------------------------------------------------------------------------------------------------
-----------------------oo-------------------------------------------------------SSSSSSSSSL------------------------------SSS-----SS--------------------
------------------------------------------------------------------------------------------------------------------------------------------------------
------------------------------------------------------------------------------------------------------------------------------------------------------
----------------------SSSS-------------------------------------------------1--------oooooo-SSS!--------------R----------US-------------------QQQQ-----
-----------------------------------------------------------------------------------------------------r----------------------------oo------------------
------------------------------------------------------------------------------------SSSSSS----------%%%%%%%-----------------SSS-----------------------
---------------------------------------------------------------------------ggg------SSSSSS----------||||||-------------------------------------y------
----------------!---------%%%%-------------------------ooo------------#########---------------C-----||||||--------------SSS----------------QQ?SSQQQ---
---------------------------|||---------T--------------------------------------#---------------------||||||-----#--------------------------------------
---------------------------|||---------T--------------------------------------#---------------------||||||-----#--------------------------------------
---M-----------------------|||-------kkT-------y------------gg-------g--------#----------------g-g--||||||--oo-#----ggg-------------------------------
XXXXXXXXXXXXXXXXXXXX%%%----|||XXXXXXXXXXXXXXXXXXXX--XXXXXXXXXXXXXXXXXX--------X----XXXXXXXXXXXXXXXXX||||||--%%-XXXXXXXXXXXX------XXXXXXXXXXXXX--XXXXXX
XXXXXXXXXXXXXXXXXXXX||-----|||XXXXXXXXXXXXXXXXXXXX--XXXXXXXXXXXXXXXXXX--------X----XXXXXXXXXXXXXXXXX||||||---|-XXXXXXXXXXXX------XXXXXXXXXXXXX--XXXXXX
