------------------------------------------------------------------------------------------------------------------------------------------------------
------------------------------------------------------------------------------------------------------------------------------------------------------
------------------------------------------------------------------------------------------------------------------------------------------------------
----------SSSSSSSSSS------------------------------SSSSSSSSSS----------SSSSSSSSSS--------------------------------------------------SSSSSSSSSS----------
--------------------------------------------?---------SS--SS----------------SSSS----------------------------------------------------------------------
------------------------------------------------------SS--SS-------------g--SSSS--------oo------------------------------------------------------------
--------------------USS-------S---------------------SS--------USSS------SS------oo---------------------------R-----oo-----------------------SSS-------
----------------------------------------------r-----SS------------------SS---------------------------r--------------------------oo--------------------
------------------------------------------%%%%%%----SS------------------SS--------------------------%%%%%%%-------------------------------------------
-------------------------------------------||||-----SS----oo------------SC--g-g--SS-------------g---||||||---------------------------------------SSSSS
----------@QQQQ---------------##--SSC---%%-||||ooo--SSSS--SS-S-----TT---SS--SSSS---------S------TT--||||||-----%%%%--%%%-----TT-----------------------
---------------------B------------------|--||||--r----SS-----------TT---------------------------TT--||||||------||----||-----TT-----------TT----------
-----------------g-#-b-------B----------|%%%%%%%%%----SS-----------TT---------------------------TT--||||||------||----||-----TT----tt-----TTSSS-------
----------------g#-#-B-------b----------|-||||||||-----------ggg---TT---------------------------TT--||||||--ooo-||----||-y---TT----tt----kTT-------r--
XXXXXXXXXXXXXXXXXXXXXXXXXXXXXXXX--XXXXXX|-||||||||XXXXXXXXXXXXXXXXXXXXXXXXXXXXXX----------XXXXXXXXX-||||||--%%%-||----||XXXXXXXXXXXXXXXXXXXX-----XXXXX
XXXXXXXXXXXXXXXXXXXXXXXXXXXXXXXX--XXXXXX|-||||||||XXXXXXXXXXXXXXXXXXXXXXXXXXXXXX----------XXXXXXXXX-||||||---|--||----||XXXXXXXXXXXXXXXXXXXX-----XXXXX
