------------------------------------------------------------------------------------------------------------------------------------------------------
------------------------------------------------------------------------------------------------------------------------------------------------------
------------------------------------------------------------------------------------------------------------------------------------------------------
------------------------------SSSSSSSSSS------------------------------------------------------------SSSSSSSSSS----------------------------------------
--------------------------------------------?---------------------------------------------------------------------------------------------------------
--------------------------------------------------------------------------------------------oo--------------------------------------------------------
--------------------S---------------------------------------------SSoo----SS-------USS----------------------------------SS-------------US-------------
---------------------------TT-----------------r-------------------------------------------------------------------------------------------------------
---------------------------TT----------S--%%%%%%---------TT----------------------------------------%-------------------y------------------------------
---------------------------XX----------S---||||----TT----TT------------------------------------------------------------X---TT--------SS---------------
-----SSS---------------TT--------------S%%-||||ooo-TT----XX-%%%%%%----SS-----SS---#-------S----------------TT---------XX---TT--------------S--#LSS----
-----------------------TT------#--------|--||||--r-TT--------||||-----------------#---------------------#--TT--------XXXt--TT-----------------#-------
-----------------------TT------#-#------|%%%%%%%%%-TT--------||||-----------------##---------%%%%------##--TT-------XXXXt--TT-----TT----------#-------
--------------k-ggg-k--TT------#-#------|-||||||||-TT--------||||-----------------##--gg------||----kk-##--TT------XXXXXt--TT-----TT--------kk#-------
XXXXXXXXXXXXXXXXXXXXXXXXXXXXXXXXXXXXXXXX|-||||||||XXXXXXXXXX-||||-----------------XXXXXXXX----||----XXXXX--XX-XXXXXXXXXXXXXXXXXXXXXXXXXX-X-XXXXXXXX---
XXXXXXXXXXXXXXXXXXXXXXXXXXXXXXXXXXXXXXXX|-||||||||XXXXXXXXXX-||||-----------------XXXXXXXX----||----XXXXX--XX-XXXXXXXXXXXXXXXXXXXXXXXXXX-X-XXXXXXXX---
