------------------------------------------------------------------------------------------------------------------------------------------------------
------------------------------------------------------------------------------------------------------------------------------------------------------
------------------------------------------------------------------------------------------------------------------------------------------------------
--------------------------------------------------------------------------------SSSSSSSSSS--------------------SS-------S------------------------------
------------------------------------------------------------------------------------------------------------------------------------------------------
-----------------------SSS----------------------------------------------------------------------------------------------------------------------------
---------------------------------------------------------------------------g----------------------------SSQSSS---------S---------------US---SSS-------
---------------------g-------------------------------------------------%%%%%%---------------------------------------------------oo--------------------
-----------------g--%%%-------------------------------------------------||||---------------------------------------SSS--------------------------------
-----------------#--||----SSS-------------------------------------------||||-----------S----------oo------K--------------------------SS----------SSSSS
--------SUS-----##--||----------QQQQ------------------------------------||||----SU----------------------SSSSSS---------S-----TT------------S----------
---------------###--||---------------K-B-----K---B--K----------------T--||||--------TT---t-----TT--------------##------------TT-----------------------
--------------####--||-----------------b---------b-----------B-------T--||||--------TT---t-----TT--------------##------------TT---TT--------SSS-------
--M----------#####--||----oo-----------b---------B---------g-b-------T--||||-------kTT--kt--y--TT--------------##--------y---TT---TT---------------r--
XXXXXXXXXXXXXXXXXXXX||---%%%--XXXXXXXXXXXXXXXXXXXXXXXXXXXXXXXXXXXX--XX--||||----XXXXXXXXXXXXXXXXXXXXXXXXXXXXXX-XX------XXXXXXXXXXXXXXXXX-X-X-----XXXXX
XXXXXXXXXXXXXXXXXXXX||----|---XXXXXXXXXXXXXXXXXXXXXXXXXXXXXXXXXXXX--XX--||||----XXXXXXXXXXXXXXXXXXXXXXXXXXXXXX-XX------XXXXXXXXXXXXXXXXX-X-X-----XXXXX
