------------------------------------------------------------------------------------------------------------------------------------------------------
------------------------------------------------------------------------------------------------------------------------------------------------------
------------------------------------------------------------------------------------------------------------------------------------------------------
----------SSSSSSSSSS--------------------SSSSSSSSSS----------------------------------------------------------------------------------------------------
------------------------------------------------------------------------------------------------------------------------------------------------------
-------------------------------------------------------oooo---------------------------------oo---------------------k----------------------------------
--------------------S--------------------oooo----------%%%%-------SSoo----SSCSS----USS--------------------2---S---SSSSSS--------------------SS--------
---------------------------TT---------------------------||--------------------------------------------------------------------------------------------
---------------------------TT------------SSSS-U---------||-----------------------------------------%--------------------------SSS---------------------
---------------------------XX-----------oS--SoS---SSS---||------------------------------------------o-------------------------------------------------
----------@QQQQ--------TT--------------TSS--SSS---------||--%%%%%%------QQQQ--QQ--#-------S---------------2-------------%-------------------SS--------
-----------------------TT--------------T--------------U-||---||||-----------------#---------------------------------------------------------------#-TT
-----------------g-#---TT--------------T----------------||---||||-----------------##---------%%%%-------------TT---------------------------------##-TT
-M--------------g#-#k--TT-------gg-----T--kk------------||---||||-----------------##--gg------||--------y--y--TT-----------------r--------------###-TT
XXXXXXXXXXXXXXXXXXXXXXXXXXXXXXXXXXXXXXXXXXXXXXXXXX----%%%%%--||||-----XXXXXXXXXX--XXXXXXXX----||----XXXXXXXXXXXXXXXXXX------XXXXXXXXXXXXXXXXXXXXXXX-XX
XXXXXXXXXXXXXXXXXXXXXXXXXXXXXXXXXXXXXXXXXXXXXXXXXX-----|||---||||-----XXXXXXXXXX--XXXXXXXX----||----XXXXXXXXXXXXXXXXXX------XXXXXXXXXXXXXXXXXXXXXXX-XX
