------------------------------------------------------------------------------------------------------------------------------------------------------
------------------------------------------------------------------------------------------------------------------------------------------------------
------------------------------------------------------------------------------------------------------------------------------------------------------
----------------------------------------------------------------------------------------------------SSSSSSSSSS------------------------------SSSSSSSSSS
-----------------------------------------g------------------------------------------------------------------------------------------------------------
-----------------------SSS--------------%%------------------------------------------------------------------------------------------------------------
----------------------------------------|-----------------------------------SSSS----y-----------------------------------------------------------------
---------------------g------------------|----oo-----------------------------------#SSS---------------------------SSS----------------------------------
--------------------%%%-----------------|----------------------------------------##-------------------------------------------------------------------
--------------------||----SSS-----------|-----------------------1------------K--###1------------g------------------------------SSS--------------------
--------------------||------------------|----------------------------------SSSSS###-------------TT-----------T----------%------------------#--TT------
--------------------||----------------tt|-----------K-----------------T---------###--SSS--------TT-----TT----T----------------------------##--TT------
--------------------||----------------tt|-----------------------------T---------###-------------TT-----TT----T---------------------------###--TT------
-M--------k---ggg---||----oo----------tt|------------------g----------T---------###-------------TT--g--TT----T-------------------r---y--####--TT------
XXXXXXXXXXXXXXXXXXXX||---%%%--XXXXXXXXXX|----%%%%-XXXXXXXXXXXXXXXXXXX-XXXXXXXXXXXXXXXX---XXXXXXXXXX-XXXXXXXXXX%%%%----%%----XXXXXXXXXXXXXXXXXXXX--XXXX
XXXXXXXXXXXXXXXXXXXX||----|---XXXXXXXXXX|-----||--XXXXXXXXXXXXXXXXXXX-XXXXXXXXXXXXXXXX---XXXXXXXXXX-XXXXXXXXXX|||------|----XXXXXXXXXXXXXXXXXXXX--XXXX
