------------------------------------------------------------------------------------------------------------------------------------------------------
------------------------------------------------------------------------------------------------------------------------------------------------------
------------------------------------------------------------------------------------------------------------------------------------------------------
----------SSSSSSSSSS----------------------------------------------------------------------------------------------------------------------------------
------------------------------------------------------------------------------------------------------------------------------------------------------
-----------------------SSS----------------------------------------------------------------------------------------------------------------------k-----
------------------------------------------------------------------SSoo----SS-------o--o----SSS!--------------@?SSS--------SSC------------------SQS--SQ
---------------------g--------------------------------------------------------------------------------------------------------------------------------
--------------------%%%-------------------------------------------------------------------------------------------------------------------------------
--------------------||----SSS------------------------------------------------------SSSS-----------------------------------SSS-------------------------
--------------------||-----------------T--------------S-----%%%%%%----SS-----SS---------------C-----SU----!--!SSSSS------------------------#---SQS--S?
--------------------||-----------------T----------TT---------||||-------------------------------------------------------------------------##----------
--------------------||-----------------T----------TT---------||||---------------%%%------------------------------------------------------###----------
-M------------------||----oo----gg-----T-------y--TT------k--||||---------------||-------------g-g--------k-----K----------------#---y--####-k------gg
XXXXXXXXXXX--XX--X--||---%%%--XXXXXXXXXXXXXXXXXXXXXXXXXXXXXX-||||---------------||--------XXXXXXXXXXXXXXXXXXXXXXXXXXXXXXX----XXXXXXXXXXXXXXXXXXXXXXXXX
XXXXXXXXXXX--XX--X--||----|---XXXXXXXXXXXXXXXXXXXXXXXXXXXXXX-||||---------------||--------XXXXXXXXXXXXXXXXXXXXXXXXXXXXXXX----XXXXXXXXXXXXXXXXXXXXXXXXX
