------------------------------------------------------------------------------------------------------------------------------------------------------
------------------------------------------------------------------------------------------------------------------------------------------------------
------------------------------------------------------------------------------------------------------------------------------------------------------
------------------------------------------------------------SSSSSSSSSS--------------------SSSSSSSSSS--------------------------------------------------
------------------------------------------------------------SSSS--SSSS--------------------------------------------------------------------------------
------------------------------------------------------------SSSS--SSSS--------------------------------------------------------------------------------
--------------------S-----------------------------------------SS---S------SS-------o--o-------------------------------US----------%-------------------
---------------------------TT---------------------------------SS---S----------------------------------------------------------------------------------
---------------------------TT---------------------------------SS---S---------------------------------------------------------SSS--------SSS-----------
---------------------------XX------oo-----------------------ooSS---SoU-------------SSSS-----------------------------E---------------------------------
-------------------%---TT---------o--o----------------------SSSS---SSSSS-----SS-----------------------%%%%%%-------TT---r---------%%%%%---------------
-----------------------TT--------------------K---B--K--------------------------------------------------||||--------TT--t%%%%%%-----|||-------------#--
-----------------------TT------------------------b------------------------------%%%--------------------||||--------TT--t|||||------|||---------K---#--
-M-----------%%%%---k--TT------------------------B---------gk--g-g--------------||--------------g-g----||||-----g--TT--t|||||------|||-------------#--
XXXXXXXXXXX---||----XXXXXXXXXXXXXXXXXXXXXXXXXXXXXXXXXXXXXXXXXXXXXXXXXX----------||--------XXXXXXXXXX%%-||||-%%XXXXXXXXXX|||||-----%|||------XXXXX--XXX
XXXXXXXXXXX---||----XXXXXXXXXXXXXXXXXXXXXXXXXXXXXXXXXXXXXXXXXXXXXXXXXX----------||--------XXXXXXXXXX|--||||--|XXXXXXXXXX|||||------|||------XXXXX--XXX
