------------------------------------------------------------------------------------------------------------------------------------------------------
------------------------------------------------------------------------------------------------------------------------------------------------------
------------------------------------------------------------------------------------------------------------------------------------------------------
S-----SSSS--------------------SSSSSSSSSS----------SSSSSSS-------------SSSSSSSSSS----------------------------------------------------------------------
S-----------------------------SSSSSSSSSS--------------------------------------------------------------------------------------------------------------
S-----------------------------SSSSSSSSSS--------------------------------------------------------------------------------------------------------k-----
S-----------------------------SSSSSSSSSS----------QQ----------------------------------------------------------?SSS-------SSS----S!-------------SQS--SQ
S-----------------------------------------------------------------------------TT----------------------------------------------------------------------
S----------------------------------------------------------S------------------TT--TT------------------------------------------------------------------
S-----------------------------------------------------------------------------TT--TT------------------------------------------------------------------
S------------------%----------SSSSSSSSSS----------QQ--QQQ-------------------SCTT--TT--------------------------SSSSS--------------S---------#---SQS--S?
S-----------------------------SSSSSSSSSS-----K---B----------------------TT----TT--TT-----T------------------g-----------------------------##----------
S-----------------------------SSSSSSSSSS---------b----------------------TT----TTT-TT-----T-------B----------TT---------------------------###----------
S------------%%%%-------------SSSSSSSSSS---------B-----------y----------TT---kTTT-TT---k-T-------b----------TT--K-----------gg-g-g---y--####-k------gg
XXXXXXXXXXX---||----XXXXX--XXXXXXXXXXXXXXXXXXXXXXXXXXXXXX---XXXXXXXXXXXXXXXXXXXXXXXXXXXXXXXXXXXXXXXX--XXXXXXXXXXXXXXXXXXXXXXXXXXXXXXXXXXXXXXXXXXXXXXXX
XXXXXXXXXXX---||----XXXXX--XXXXXXXXXXXXXXXXXXXXXXXXXXXXXX---XXXXXXXXXXXXXXXXXXXXXXXXXXXXXXXXXXXXXXXX--XXXXXXXXXXXXXXXXXXXXXXXXXXXXXXXXXXXXXXXXXXXXXXXX
