------------------------------------------------------------------------------------------------------------------------------------------------------
------------------------------------------------------------------------------------------------------------------------------------------------------
------------------------------------------------------------------------------------------------------------------------------------------------------
----------------------------------------SSSSSSSSSS-oo-------------------------------------------------------------------------------------------------
--------------------------------------------------%%%%-------------------o----------------------------------------------------------------------------
---------------------------------------------------||-------------------%%%-----K---------------------------------------------------------------------
------------------------------S----------oooo------||--------------------|--o---SS----1----------------------R-----oo---SS-------------------------SSS
---------------------------------------------------||--SSS---------------|--SSSS---------------------r----------------------------oo------------------
-----------------------------------------SSSS-U----||-----------------%--|--------------------------%%%%%%%-------------------------------------------
----------------------------------------oS--SoS----||--------------------|----------------------g---||||||-----------------TT-------------------------
-----SSS-----------%SS--------##--SSC---SS--SSS----||----------------T---|------SS--------------TT--||||||-----%%%%--%%%---TT--------------Q------#---
---------------------K---TT------------------------||----------------T---|------------TT--------TT--||||||------||----||t--TT---------------------#---
-------------------------TT-----------------------%||----------------T---|-----%------TT--------TT--||||||------||----||t--TT---------------------#---
-------------%%%%--------TT---------------kk-------||---------ggg----T---|------------TT--------TT--||||||--ooo-||----||t--TT----------------ggg--#---
XXXXXXXXXXX---||----XXXXXXXXXXXX--XXXXXXXXXXXXXXXX-||-------XXXXXXXXXX%%%%%%----XXXXXXXXXXXXXXXXXXX-||||||--%%%-||----||XXXXXXXXXXXXXXXXXXXXXXXXXXXXXX
XXXXXXXXXXX---||----XXXXXXXXXXXX--XXXXXXXXXXXXXXXX-||-------XXXXXXXXXX|||||-----XXXXXXXXXXXXXXXXXXX-||||||---|--||----||XXXXXXXXXXXXXXXXXXXXXXXXXXXXXX
