------------------------------------------------------------------------------------------------------------------------------------------------------
------------------------------------------------------------------------------------------------------------------------------------------------------
------------------------------------------------------------------------------------------------------------------------------------------------------
----------------------------------------------------------------------------------------------------SSSSSSSSSS------------------------------SSSSSSSSSS
------------------------------------------------------------------------------------------------------------------------------------------------------
----------------------------------------%%-------------------------------------------------------------------------k----------------------------------
--------------------S-------------------|---------------------USSS------SSSSS--------SSSS---------------------S---SSSSSS------------------------------
---------------------------TT-----------|----oo-------------------------------------------------------------------------------------------------------
---------------------------TT-----------|--------------------------------------------------------------------------------------------g#---------------
------------Q--?-----------XX-----------|----------------o--------------------------------------------------------------------------g##---------------
-------------------S---TT---------------|--------------------S-----TT--------2--Q----------------tt----------T----------------------###-------TT------
-----------------------TT-------------K-|--------------------------TT------TT-------------T------tt----TT----T---------------------####-------TT------
-----------------------TT-----TTTT------|--------------------------TT-t----TT--T----------T------tt----TT----TTT------------------#####-------TT------
-M----------------K-k--TT-----TTTT------|-----------k--------ggg---TT-t----TT--T-ggg------T------tt-g--TT----TTT----------kkk-----#####-------TT------
XXXXXXXXXXXXXXXXXXXXXXXXXXXXXXXXXXXXXXXX|----%%%%--XXXXXXXXXXXXXXXXXXXXXXXXXXXXXXXXXX----XXXXXXXXXXXXXXXXXXXXXXXXXXXXX--XXXXXXXXXXXXXXX--XXXXXXX--XXXX
XXXXXXXXXXXXXXXXXXXXXXXXXXXXXXXXXXXXXXXX|-----||---XXXXXXXXXXXXXXXXXXXXXXXXXXXXXXXXXX----XXXXXXXXXXXXXXXXXXXXXXXXXXXXX--XXXXXXXXXXXXXXX--XXXXXXX--XXXX
