------------------------------------------------------------------------------------------------------------------------------------------------------
------------------------------------------------------------------------------------------------------------------------------------------------------
------------------------------------------------------------------------------------------------------------------------------------------------------
------------------------------------------------------------------------------------------------------------------------------------------------------
------------------------------------------------------------------------------------------------------------------------------------------------------
------------------------------------------------------------------------------------------------------------------------------------------------------
--------------------S-----------------------------------------------------SSCSS------SUS------------------------------------------%-------------------
---------------------------TT--------------------------------o---o---o----------------------------------------------------------oo--------------------
---------------------------TT----------------------------TT-%%%-%%%-%%-------------------------------------------------y----------------SSS-----------
---------------------------XX----------------------TT----TT--|---|---|-------------------------oooo--------------------X------------------------------
----------------%%%%---TT--------------T-----------TT----XX--|---|---|--QQQQ--QQ----#####-----------------------------XX-----TT---%%%%%-----#---------
-----------------||----TT--------------TT-----TT---TT--------|---|---|--------------#-----------------------g--------XXX-----TT----|||------##--------
-----------------||----TT--------------TT-----TT---TT--------|---|---|-------------K#-----------------------TT------XXXX-----TT----|||------###------#
-M---------------||-k--TT-------gg-----TT-----TT---TT--------|---|-r-|--------------#-----------------------TT-----XXXXX-y---TT----|||------####----##
XXXXXXXXXXX--%%%%||%XXXXXXXXXXXXXXXXXXXXXXXX--XXXXXXXXXXXXXX%%%%%%%%%%XXXXXXXXXXXXXXXXX---%%%%%%%-%%--XXXXXXXXXXXXXXXXXXXXXXXXXXXX%|||------XXXXXXXXXX
XXXXXXXXXXX---||-||-XXXXXXXXXXXXXXXXXXXXXXXX--XXXXXXXXXXXXXX-|||||||||XXXXXXXXXXXXXXXXX---||||||---|--XXXXXXXXXXXXXXXXXXXXXXXXXXXX-|||------XXXXXXXXXX
