------------------------------------------------------------------------------------------------------------------------------------------------------
------------------------------------------------------------------------------------------------------------------------------------------------------
------------------------------------------------------------------------------------------------------------------------------------------------------
--------------------------------oo-----------------oo-------------------------------------------------------------------------------------------------
-------------------------------------g-g----------%%%%------------------------------------------------------------------------------------------------
-----------------------------------%%%%%-----------||-------------------------------------------------------------------------------------------------
---------------------LSSS-----------||||-----------||-----------------------SSSS---o--o----------------------R--------US-------SSSSS------------------
------------------------------------||||-----------||--SSS-------------------------------------------r------------------------------------------------
------------------------------------||||-----------||-----------------------------------------------%%%%%%%-------------------------------------------
------------------------------%%%%%-||||-----------||------------------------K-----SSSS--------oooo-||||||----------E-----------K---------------------
---------------------2-----#---|||--||||-----------||----------------------SSSSS--------------------||||||---------TT----------SSSSS--------#---------
-----------------K---------#---|||--||||-----------||----------------TT-----------------------------||||||---------TT--t----------K---#----B##--------
------------B--------------##--|||--||||----------%||--------B-------TT---------%%%-----------------||||||---------TT--t-TT-----------#----b###------#
------------b---------kk---##--|||--||||-------ggg-||--------b-------TT---------||------------------||||||--oo--g--TT--t-TT-----------#----B####----##
XXXXXXXXXXXXXXXXXXXXXXXXXXXXXX-|||--||||-XXXXXXXXX-||-------XXXXXX--XXXXXXXXXXXX||--------%%%%%%%-%%||||||--%%XXXXXXXXXXXXXXXXXXXXXXXXXXXXXXXXXXXXXXXX
XXXXXXXXXXXXXXXXXXXXXXXXXXXXXX-|||--||||-XXXXXXXXX-||-------XXXXXX--XXXXXXXXXXXX||--------||||||---|||||||---|XXXXXXXXXXXXXXXXXXXXXXXXXXXXXXXXXXXXXXXX
