------------------------------------------------------------------------------------------------------------------------------------------------------
------------------------------------------------------------------------------------------------------------------------------------------------------
------------------------------------------------------------------------------------------------------------------------------------------------------
------------------------------------------------------------------------------------------------------------------------------------------------------
------------------------------------------------------------------------------------------------------------------------------------------------------
------------------------------------------------------------------------------------------------------oo----------------------------------------------
------------------Q---------------------------QQQQ-------Q-Q--USSS------SSSSS--------1--------------------------------------------!S--------SS--------
----------------------------------------------------------------------------------------------------------------oooo----------------------------------
------------------------------------------------------------------------------------------------------------------------------------------------------
------------------------------------------------k------------------------------------------------------------------------------SSS--------------------
------------------?---------TT---------TT-----?QQQ-------Q-Q-S-----TT--------2-----QQQQ-----------------------T---------%---------S------#--SS--------
--------------TT------------TT---------TT--------------------------TT------TT---------------------------------T-------------------------##--------#-TT
--------------TT------------TT---------TT--------------------------TT-t----TT--T----------------------------ttT------------------------###-------##-TT
-M------------TT--------ggg-TT--gg-----TT--------------------ggg---TT-t----TT--T----yy-------------g--ggg---ttT---y--------------r----####------###-TT
XXXXXXXXXXXXXXXXXXXXXXXXXXXXXXXXXXXXXXXXXXXXXXXXXXXXXXXXXXXXXXXXXXXXXXXXXXXXXXXXXXXXXXXXXX-XXXXXXXXXXXXXXXXXXXXXXXXXXXXX----XXXXXXXXXXXXXXXXXXXXXXX-XX
XXXXXXXXXXXXXXXXXXXXXXXXXXXXXXXXXXXXXXXXXXXXXXXXXXXXXXXXXXXXXXXXXXXXXXXXXXXXXXXXXXXXXXXXXX-XXXXXXXXXXXXXXXXXXXXXXXXXXXXX----XXXXXXXXXXXXXXXXXXXXXXX-XX
