------------------------------------------------------------------------------------------------------------------------------------------------------
------------------------------------------------------------------------------------------------------------------------------------------------------
------------------------------------------------------------------------------------------------------------------------------------------------------
------------------------------------------------------------SSSSSSSSSSSSSSSSSSSS----------------------------------------------------------------------
-----------------------------------------g------------------SSSS--SSSS------SSSS----------------------------------------------------------------------
----------------------------------------%%------------------SSSS--SSSS---g--SSSS----------------------------------------------------------------------
----------------------------------------|---------------------SS---S----SS-----------1-----------------------R--------------------SS------------------
----------------------------------------|----oo---------------SS---S----SS---------------------------r--------------------------oo--------------------
----------------------------------------|---------------------SS---S----SS--------------------------%%%%%%%-------------------------------------------
-----------------------------------oo---|----------------o--ooSS---SoU--SC--g-g---------------------||||||--------------------------------------------
--------SU------------------------o--o--|-------------------SSSS---SSS--SS--SSSS---QQQQ---------TT--||||||------!-----S------TT---SS------------------
----------------------------------------|-------------------------------------------------------TT--||||||-------------------TT---K---#----B----------
----------------------------------------|-------------------------------------------------------TT--||||||-------------------TT-------#----b-------F--
--M-------k---ggg--------ggg------------|-----------k-------k--g-g------------------yy------k---TT--||||||--oo-----------y---TT-------#----B-------#--
XXXXXXXXXXXXXXXXXXXXXXXXXXXXXXXXXXXXXXXX|----%%%%--XXXXXXXXXXXXXXXXXXXXXXXXXXXXXXXXXXXXXXXXXXXXXXXXX||||||--%%XXXXXXXXXXXXXXXXXXXXXXXXXXXXXXXXXXXXXXXX
XXXXXXXXXXXXXXXXXXXXXXXXXXXXXXXXXXXXXXXX|-----||---XXXXXXXXXXXXXXXXXXXXXXXXXXXXXXXXXXXXXXXXXXXXXXXXX||||||---|XXXXXXXXXXXXXXXXXXXXXXXXXXXXXXXXXXXXXXXX
