------------------------------------------------------------------------------------------------------------------------------------------------------
------------------------------------------------------------------------------------------------------------------------------------------------------
------------------------------------------------------------------------------------------------------------------------------------------------------
S-----SSSS----------------------oo--------------------------------------------------------------------------------------------------------------------
S------------------------------------g-g--------------------------------------------------------------------------------------------------------------
S----------------------------------%%%%%---------------oooo-------------------------------------------------------------------------------------------
S--------------------LSSS-----------||||---------------%%%%--------------------------------------------------R----------SSS--------------##-SS--------
S-----------------------------------||||----------------||----------------------------------------oo-r----------oooo---------------------##-----------
S-----------------------------------||||----------------||------------o-----------TT----------------%%%%%%%----------------------------####-----------
S-----------------------------%%%%%-||||----------SSS---||------------------------TT----------------||||||-----------------------------####-----------
S---------------%%%%-2-----#---|||--||||-TT---SU--------||------------------------TT----------------||||||----T----------------------######-SS--------
S----------------||--------#---|||--||||-TT-----------U-||--------------------#---TT-----T------#---||||||----T----------------------######-------#-TT
S----------------||--------##--|||--||||-TT-------------||-------------------##-T-TT-----T------#---||||||----T---------------TT-----######------##-TT
S--M-------------||---kk---##--|||--||||-TT------k------||--gg-------g----------T-TT---k-T------#---||||||--ooT---y-----------TT-----######-----###-TT
XXXXXXXXXXX--%%%%||%XXXXXXXXXX-|||--||||XXXXXXXXXX----%%%%%-XXXXXXXXXXXXXXXXXXXXXXXXXXXXXXXXXXXXXXXX||||||--%%XXXXXXXXXX----XXXXXXXXXXXXXXXXXXXXXXX-XX
XXXXXXXXXXX---||-||-XXXXXXXXXX-|||--||||XXXXXXXXXX-----|||--XXXXXXXXXXXXXXXXXXXXXXXXXXXXXXXXXXXXXXXX||||||---|XXXXXXXXXX----XXXXXXXXXXXXXXXXXXXXXXX-XX
