------------------------------------------------------------------------------------------------------------------------------------------------------
------------------------------------------------------------------------------------------------------------------------------------------------------
------------------------------------------------------------------------------------------------------------------------------------------------------
----------------------------------------SSSSSSSSSS----------------------------------------------------------------------------------------------U-----
----------------------------------------SSSSSSSS------------------------------------------------------------------------------------------------------
----------------------------------------SSSCSSSS--------------------------------K---------------------oo----------------------------------------------
--------------------USS-----------------SSSSSSSS--------------------------------SS----1---SSS------%---------------oo---------------------------------
--------------------------------------------------------------------------------------------------------------------------------------------------SS--
---------------------------------------------------------------------o---------g---------------------------------------------SSS-----g#---------------
------------Q--?---------------------------ggg-----------o-------y------------------------------------------------------------------g##-------SS------
-------------------S--------------------SSSSSSSS-----------------##----------S@SSS----------%%%----------------%%%%--%%%r-----------###--------------#
---------------------B----------------K-SSSSSSSS----------------###-------------------TT-----|------------------||----||%%%%%%-----####-------------##
---------------------b-------BTTTT------SSSSSSSS---------------####-------------------TT-----|--------------tt--||----|||||||-----#####------------###
-M----------------K--B-------bTTTT------SSSSSSSS----k---------#####-------------------TT-----|--------ggg---tto-||----|||||||-----#####-----------####
XXXXXXXXXXXXXXXXXXXXXXXXXXXXXXXXXXXXXXXXXXXXXXXXXX-XXXXXXXXXXXXXXXX----XXXXXXXXXXXXXXXXXXX---|------XXXXXXXXXX%-||----|||||||-----XXXXX--XXXXXXXX-XXXX
XXXXXXXXXXXXXXXXXXXXXXXXXXXXXXXXXXXXXXXXXXXXXXXXXX-XXXXXXXXXXXXXXXX----XXXXXXXXXXXXXXXXXXX---|------XXXXXXXXXX--||----|||||||-----XXXXX--XXXXXXXX-XXXX
