------------------------------------------------------------------------------------------------------------------------------------------------------
------------------------------------------------------------------------------------------------------------------------------------------------------
------------------------------------------------------------------------------------------------------------------------------------------------------
--------------------SSSSSSSSSS--oo---------------------------------SSS--------------------SSSSSSSSSS--------------------------------------------------
---------------------------------------g--------------------------------------------------------------------------------------------------------------
-----------------------------------%%%%%--------------------------------------------------------------------------------------------------------------
------------------SC----------------||||----------Q-------------CSS--------1---------SSSS-----------------2-------------SS--------SS------------------
------------------------------------||||--------------------------------------------------------------------------------------------------------------
------------------------------------||||--------------------SS--2-------------------------------------------------------------------------------------
-----------------------------C%%%%%-||||-----------------------2-2---------ggg----------------------o----------------------TT-------------------------
--------------TT---2---#-#-----|||--||||----------Q---------------2---#########-Q-------------------------2-----------r----TT-----SS------------------
--------------TT-----#-#-#-#---|||--||||-----K---B----------------------------#-----------------------------------%%%%%%t--TT-----K---#----B----------
--------------TT-----#-#-#-#---|||--||||---------b----------------------------#------------------------------------|||||t--TT---------#----b-------F--
-M------------TT-----#-#-#-#-E-|||--||||---------B---gg----k------------------#--ggg------------g-g-----y--y-------|||||t--TT---------#----B-------#--
XXXXXXXXXXXXXXXXXXXXXXXXXXXXXX-|||--||||XXXXXXXXXXXXXXXXXXXX---XXXXXXX--------X-XXXXX----XXXXXXXXXXXXXXXXXXXXX-%%%-|||||XXXXXXXXXXXXXXXXXXXXXXXXXXXXXX
XXXXXXXXXXXXXXXXXXXXXXXXXXXXXX-|||--||||XXXXXXXXXXXXXXXXXXXX---XXXXXXX--------X-XXXXX----XXXXXXXXXXXXXXXXXXXXX--|--|||||XXXXXXXXXXXXXXXXXXXXXXXXXXXXXX
