------------------------------------------------------------------------------------------------------------------------------------------------------
------------------------------------------------------------------------------------------------------------------------------------------------------
------------------------------------------------------------------------------------------------------------------------------------------------------
----------------------------------------------------------------------------------------------------SSSSSSSSSS------------------------------SSSSSSSSSS
------------------------------------------------------------------------------------------------------------------------------------------------------
----------------------ooor-------------------------------------------R------------------oo------------------------------------------------------------
---------------------%%%%%------------------------------------------------------oo---------SSS!-----------------------------------SS------------------
----------------------|||-------o----ooo--------------------------------------------------------------------------------------------------------------
-----------------g----|||------------------------------------------------------g---------------------------------------y------------------------------
-----------------#----|||--------------------------------------------------------SS------------------------------------XSS-?Q-------------------------
----------S-----##--%%%%%%%-----------%%-------------------------%%%---------S@S---------S----C--------------T--------XX----------SS----------TT------
---------------###--||||||-------------|------------K-------------|------------------------------------TT----T-------XXX----------K---#----B--TT------
--------------####--||||||--o----------|--------------------------|------------------------------------TT----T------XXXX-------y------#----b--TT------
-M-----------#####--||||||-%%%-%%%%%%%-|-------y-----------g------|----------------------------g-g--g--TT----T-----XXXXX---SSSSS------#----B--TT------
XXXXXXXXXXXXXXXXXXXX||||||--|---|||||--|XXXXXXXXXXXXXXXXXXXX%%%%%-|----XXXXXXXXX----------XXXXXXXXXXXXXXXXXXXXXXXXXXXXXX-------XX-XXXXXXXXXXXXXX--XXXX
XXXXXXXXXXXXXXXXXXXX||||||--|---|||||--|XXXXXXXXXXXXXXXXXXXX-|||--|----XXXXXXXXX----------XXXXXXXXXXXXXXXXXXXXXXXXXXXXXX-------XX-XXXXXXXXXXXXXX--XXXX
