------------------------------------------------------------------------------------------------------------------------------------------------------
------------------------------------------------------------------------------------------------------------------------------------------------------
------------------------------------------------------------------------------------------------------------------------------------------------------
S-----SSSS--------------------------------------------------SSSSSSSSSS----------------------------------------SS-------S------------------------------
S-----------------------------------------------------------SSSS--SSSS--------------------------------------------------------------------------------
S-----------------------------------------------------------SSSS--SSSS------------------oo------------------------------------------------------------
S-----------------SCUSS---------------------------Q-----------SS---S------------oo---------------------------@---------SSSS--------SSSS---------------
S-------------------------------------------------------------SS---S---------------------------------------------------------------------------y------
S-------------------------------------------------------------SS---S-----------------------------------------------SSS-----------------------#SS--o---
S-----------------------------------------------------------ooSS---SoU---1-------SS----------------------------------------------------SSSS-##--------
S-------------TT---2--------------------------tt--Q---------SSSS---SSST------------------S------TT--SU----!--!---------S--------------------##--SC----
S-------------TT-----B----------------K-------tt----------------------T----TT-------------------TT-------------##---------------------------##--------
S-------------TT-----b-------BTTTT------------tt----------------------T----TT-------------------TT-------------##-------------TT------------##---SSS--
S--M----------TT-----B-------bTTTT-------g----tt-----gg----kk--g-g----T---kTT---------------k---TT--------k----##-------------TT------------##--------
XXXXXXXXXXXXXXXXXXXXXXXXXXXXXXXXXXXXXXXXXXXXXXXXXXXXXXXXXXXXXXXXXXXXXXXXXXXXXXXX----------XXXXXXXXXXXXXXXXXXXX-XX------X----XXXXXX---------XXX------XX
XXXXXXXXXXXXXXXXXXXXXXXXXXXXXXXXXXXXXXXXXXXXXXXXXXXXXXXXXXXXXXXXXXXXXXXXXXXXXXXX----------XXXXXXXXXXXXXXXXXXXX-XX------X----XXXXXX---------XXX------XX
