------------------------------------------------------------------------------------------------------------------------------------------------------
------------------------------------------------------------------------------------------------------------------------------------------------------
------------------------------------------------------------------------------------------------------------------------------------------------------
------------------------------SSSSSSSSSSSSSSSSSSSS--------------------------------------------------SSSSSSSSSSSS-------S------------------------------
------------------------------SSSSSSSSSS--------------------------------------------------------------------------------------------------------------
------------------------------SSSSSSSSSS------------------------------------------------oo--oo--------------------------------------------------------
---------------------LSSS-----SSSSSSSSSS-oooo-----------------------------------oo-------------------------------------S-------SSS-------##-----------
-----------------------------------------------------------------------------------------------------------------------------------------##-----------
-----------------------------------------SSSS-U----------------------------------------------------%---------------SSS-----------------####-----------
----------------------------------------oS--SoS--------------------------1-------SS---------------------------------------------K------####-----------
----------------%%%%-2-----#--SSSSSSSSSSSS--SSS-----------------------T------------------SSS-----------------T---------S-------SSS---######-----------
-----------------||--------#--SSSSSSSSSS------------K----------------TT----TT--------------------------TT----T-##--------------------######--------#--
-----------------||--------##-SSSSSSSSSS---------------------B-------TT----TT----------------%%%%------TT----T-##--------TT----------######----K---#--
-M---------------||---kk---##-SSSSSSSSSS--kk---------------g-b-------TT---kTT-----------------||----g--TT----T-##--------TT----------######--------#--
XXXXXXXXXXX--%%%%||%XXXXXXXXXXXXXXXXXXXXXXXXXXXXXXXXXXXXXXXXXXXXXX--XXXXXXXXXXXX--------------||----XXXXXXXXXX-XX------XXXXXXXXXXXXXXXXXXXXXXXXXX--XXX
XXXXXXXXXXX---||-||-XXXXXXXXXXXXXXXXXXXXXXXXXXXXXXXXXXXXXXXXXXXXXX--XXXXXXXXXXXX--------------||----XXXXXXXXXX-XX------XXXXXXXXXXXXXXXXXXXXXXXXXX--XXX
