------------------------------------------------------------------------------------------------------------------------------------------------------
------------------------------------------------------------------------------------------------------------------------------------------------------
------------------------------------------------------------------------------------------------------------------------------------------------------
-----------------------oo-----SSSSSSSSSS------------------------------------------------------------SSSSSSSSSS--------------------SSSSSSSSSS----U-----
------------------------------SSSSSSSSSS---------------------------------o----------------------------------------------------------------------------
------------------------------SSSSSSSSSS--------------------------------%%%-----------------oo--------------------------------------------------------
------------------Q---SSSS----SSSSSSSSSS---------------------------------|--o------o--o-------------------------------US-SSS----S!--------------------
-------------------------------------------------------------------------|--SSSS------------------------------------------------------------------SS--
----------------------------------------------------------------------%--|-------------------------%--------------------------------------------------
-------------------------------------------------------------------------|---------SSSS-----------------------------E-------------------------SS------
------------------?-------%%%%SSSSSSSSSS---------------------------------|----------------S------------------T-----TT------------S-------------------#
--------------TT-----------|||SSSSSSSSSS------------K--------------------|-----------------------------TT----T-----TT--t------------------TT--------##
--------------TT-----------|||SSSSSSSSSS---------------------------------|-----%%%%----------%%%%------TT----T-----TT--t-----------tt-----TT-------###
-M------------TT-----------|||SSSSSSSSSS----y-y------------g-y-----------|------||------------||----g--TT----T--g--TT--t----gg-g-g-tt----kTT------####
XXXXXXXXXXXXXXXXXXXX%%%----|||XXXXXXXXXXXXXXXXXXXXXXXXXXXXXXXXXXXXXXXX%%%%%%----||------------||----XXXXXXXXXXXXXXXXXXXXXXXXXXXXXXXXXXXXXXXXXXXXX-XXXX
XXXXXXXXXXXXXXXXXXXX||-----|||XXXXXXXXXXXXXXXXXXXXXXXXXXXXXXXXXXXXXXXX|||||-----||------------||----XXXXXXXXXXXXXXXXXXXXXXXXXXXXXXXXXXXXXXXXXXXXX-XXXX
