------------------------------------------------------------------------------------------------------------------------------------------------------
------------------------------------------------------------------------------------------------------------------------------------------------------
------------------------------------------------------------------------------------------------------------------------------------------------------
--------------------------------------------------------------------------------------------------------------------------------------------SSSSSSSSSS
--------------------------------------------?---------------------------------------------------------------------------------------------------------
----------------------------------------------------------------------------------g---------oo---------------------k----------------------------------
--------------------------------------------------------------------------------SSSSSSSS----------------------S---SSSSSSSS-------------US-------------
----------------------------------------------r-------------------------------------------------------------------------------------------------------
-----------------%%%----------------------%%%%%%---------B-----------------------------------------%--------------------------------------------------
------------------||-----------------------||||----------b---------------1-------------------------------------------------TT--------SS---------------
------------------||SS------------------%%-||||ooo-----SS#CS---------#T-------------------SS-------------------------------TT--------------S--TT------
-------------%%%%%||-K---TT-----------K-|--||||--r------------------##T----TT-------------------------TT----------------t--TT-----------------TT------
--------------|||-||-----TT---TTTT------|%%%%%%%%%---------KTT-----###T----TT----------------%%%%-----TT----TTTT--------t--TT-----TT----------TT------
---M----------|||-||-----TT---TTTT------|-||||||||----------TT----####T---kTT-----------------||------TT-k--TTTT--------t--TT-----TT----------TT------
XXXXXXXXXXX---|||-||XXXXXXXXXXXXXXXXXXXX|-||||||||XXXXXXXXXXXXXXXXXXXXXXXXXXXXXXXXXXXX---X----||----XXXXXXXXXXXXXXXXXX--XXXXXXXXXXXXXXXX-X-XXXXX--XXXX
XXXXXXXXXXX---|||-||XXXXXXXXXXXXXXXXXXXX|-||||||||XXXXXXXXXXXXXXXXXXXXXXXXXXXXXXXXXXXX---X----||----XXXXXXXXXXXXXXXXXX--XXXXXXXXXXXXXXXX-X-XXXXX--XXXX
