------------------------------------------------------------------------------------------------------------------------------------------------------
------------------------------------------------------------------------------------------------------------------------------------------------------
------------------------------------------------------------------------------------------------------------------------------------------------------
S-----SSSS----------------------oo--------------------------------------------------------------------------------------------------------------------
S--------------------------------------g-------------------------------------------------------------------------------------------------------------o
S----------------------------------%%%%%---------------oooo-----------------------------------------oo------------------------------------------------
S-----------------------------------||||------QQQQ-----%%%%---------------SSCSS------SSSS-SSS------%%%%---------------US------------------------------
S-----------------------------------||||----------SSSS--||------------------------------------------||--o----R--------------------oo------------SSS---
S-----------------------------------||||----------------||------------------------------------------||-%%%----------------------------------oo--------
S-----------------------------%%%%%-||||--------k-------||------------------------------------------||--|-----------E---------------------------------
S---------------!--------------|||--||||T-----?QQQ------||--------------QQQQ--QQQ-----------%%%-----||--|----------TT----------------------QSS--------
S------------------------------|||--||||T-------------U-||-----------------------------------|------||-o|----------TT--t------------------------------
S------------------------------|||--||||T---------------||-----------------------------------|------||%%%%%--------TT--t------------------------------
S--M---------------------------|||--||||T---------------||--gg-------g-----------ggg---------|------||-|||------g--TT--t--kkk-------------------------
XXXXXXXXXXXXXXXXXXXXXXXXX--XXX-|||--||||XXXXXXXXXX----%%%%%-XXXXXXXXXXXXXXXXXXXXXXXXX----X---|------||-|||----XXXXXXXXXXXXXXXXXXXXXXXXXXXXXX----------
XXXXXXXXXXXXXXXXXXXXXXXXX--XXX-|||--||||XXXXXXXXXX-----|||--XXXXXXXXXXXXXXXXXXXXXXXXX----X---|------||-|||----XXXXXXXXXXXXXXXXXXXXXXXXXXXXXX----------
