------------------------------------------------------------------------------------------------------------------------------------------------------
------------------------------------------------------------------------------------------------------------------------------------------------------
------------------------------------------------------------------------------------------------------------------------------------------------------
----------------------------------------------------------------------SSSSSSSSSS----------------------------------------------------------------------
--------------------------------------------------?-------------------------SSSS----------------------------------------------------------------------
--------------------------------------oo---------------------------------g--SSSS------------oo--------------------------------------------------------
-----------------------------U-----SSSS-------QQQQ----------------------SS---------USS-------------------------------------------------US-------------
--------------------------------------------------SS--------------------SS----------------------------------------------------------------------------
------------------------------------------------------------------------SS-------------------------%-------------------y------SSS---------------------
------------------------------------------------k-----------------------SC--g-g----------------------------------------X-------------SS---------------
-------------------%--------##%---------T-----?QQQ----------------------SS--SSSS--#-------SS--------------------------XX%------------------S--#LSS----
-----------------------y-#####----------T--------------SSS------------------------#----------------------------------XXX----------------------#-------
--------------------y-######------------T-----------------------------------------##---------%%%%---------*---------XXXX----------TT----------#-------
-M-----------%%%%---######--------------T-------------------gg-------g------------##--gg------||----gg----*--------XXXXX---------rTT--------kk#-------
XXXXXXXXXXX---||----XXXX--------%%%%--%%XXXXXXXXXX----------XXXXXXXXXXXXXXXXXXXX--XXXXXXXX----||----XXXXXXXXX-XXXXXXXXXX----XXXXXXXXXXXX-X-XXXXXXXX---
XXXXXXXXXXX---||----XXXX---------||----|XXXXXXXXXX----------XXXXXXXXXXXXXXXXXXXX--XXXXXXXX----||----XXXXXXXXX-XXXXXXXXXX----XXXXXXXXXXXX-X-XXXXXXXX---
