------------------------------------------------------------------------------------------------------------------------------------------------------
------------------------------------------------------------------------------------------------------------------------------------------------------
------------------------------------------------------------------------------------------------------------------------------------------------------
------------------------------------------------------------------------------------------SSSSSSSSSSSSSSSSSSSS----------SSS-----SSSSSSSSSSSSSSSSSSSSSS
------------------------------------------------------------------------------------------------------------------------------------------------------
----------------------------------------------------------------------------------------oo------------------------------------------------------------
--------------------S-----------------------------------------------------------oo--------------------------------------US----------------------------
---------------------------TT---o----ooo--------------------------------------------------------------------------------------------------------------
---------------------------TT-----------------------------------------o-----------------------------------------------------SSS-----------------------
---------------------------XX----------------------------------------------------SS-------------------------------------------------------------------
---------QQ------------TT-------------%%--------------S----------------------------------S-------------------T----------SSS-------------------TT------
-----------------------TT--------------|----------TT--------------------------#-----------t------------TT----T----------------------------TT--TT------
-----------------------TT--------------|----------TT-------------------------##-----------t------------TT----T-----B---------------tt-----TT--TT------
-------------------#k--TT------%%%%%%%-|----y-y---TT------k--y----------------------------t---------g--TT----T-----b---------------tt----kTT--TT------
XXXXXXXXXXXXX--XXXXXXXXXXXXXXX--|||||--|XXXXXXXXXXXXXXXXXXXXXXXXXXXXXXXXXXXXXXXX----------XXXXXXXXXXXXXXXXXXXXXXXXXXXXXXXXX------XXXXXXXXXXXXXXX--XXXX
XXXXXXXXXXXXX--XXXXXXXXXXXXXXX--|||||--|XXXXXXXXXXXXXXXXXXXXXXXXXXXXXXXXXXXXXXXX----------XXXXXXXXXXXXXXXXXXXXXXXXXXXXXXXXX------XXXXXXXXXXXXXXX--XXXX
