------------------------------------------------------------------------------------------------------------------------------------------------------
------------------------------------------------------------------------------------------------------------------------------------------------------
------------------------------------------------------------------------------------------------------------------------------------------------------
----------------------------------------SSSSSSSSSS------------------------------ooo---------------------------SSSSSSSSSS------------------------------
----------------------------------------SSSSSSSS--------------------------------%%%-------------------------------------------------------------------
----------------------------------------SSSCSSSS-------oooo----------------------|--------------------------------------------------------------------
------------------Q----------U----------SSSSSSSS-------%%%%-------SSoo----SSCSS--|----------------------------------------------------------SSS-------
--------------------------------------------------SSSS--||-----------------------|----------------------------------------------oooo------------------
--------------------------------------------------------||-----------------------|--------------------------------------------------------------------
-------------------------------------------ggg----------||-----------------------|---%%%%--o-----------------------------------------------------SSSSS
------------------?---------##--QQQQ----SSSSSSSS--------||--%%%%%%------QQQQ--QQ-|----||---------TT---%%%%%%--T--------------TT------------Q----------
--------------TT-------y-#####-------K-BSSSSSSSS------U-||---||||---------------%%%%%%||---------TT----||||---T--------------TT-----------------------
--------------TT----y-######-----------bSSSSSSSS--------||---||||----------------||||-||---------TT----||||---T----TT--------TT-------------SSS-------
---M----------TT----######-------------bSSSSSSSS--------||---||||----------------||||-||---------TT----||||---T--g-TT----y---TT--------------------r--
XXXXXXXXXXXXXXXXXXXXXXXX------XXXXXXXXXXXXXXXXXXXX----%%%%%--||||-----XXXXXXXXXX-||||-||%%XXXXXXXXXX%%-||||-%%XXXXXXXXXXXXXXXXXXXXXXXXXXXXXX-----XXXXX
XXXXXXXXXXXXXXXXXXXXXXXX------XXXXXXXXXXXXXXXXXXXX-----|||---||||-----XXXXXXXXXX-||||-||-|XXXXXXXXXX|--||||--|XXXXXXXXXXXXXXXXXXXXXXXXXXXXXX-----XXXXX
