------------------------------------------------------------------------------------------------------------------------------------------------------
------------------------------------------------------------------------------------------------------------------------------------------------------
------------------------------------------------------------------------------------------------------------------------------------------------------
S-----SSSS------------------------------SSSSSSSSSS----------------------------------------------------------------------------------------------------
S-----------------------------------------------------------------------------------------------------------------------------------------------------
S--------------------------------------------------------------------R----------------------oo--------------------------------------------------------
S-------------------USS-------S----------oooo----------------------------------------1-----------------------R---------------------SSSS-----SSS-------
S----------------------------------------------------------------------------------------------------r------------------------------------------------
S----------------------------------------SSSS-U-----------------------o----------------------------%%%%%%%%------------y------------------------------
S---------------------------------------oS--SoS-----------------------------------------------------||||||-------------XSS-?Q----------SSSS------SSSSS
S-----------------------------##--SSC---SS--SSS-------S----------%%%---------------QQQQ---SS--------||||||------------XX------------------------------
S----------------K---B----------------------------TT--------------|-----------#---------------------||||||-----------XXX------------------------------
S-----------B--------b-------B--------------------TT--------------|----------##--------------%%%%---||||||----------XXXX-------y------------SSS-------
S-----------b--------B-------b------------kk------TT------k-------|-----------------yy--------||----||||||--oo-----XXXXX---SSSSS-------------------r--
XXXXXXXXXXXXXXXXXXXXXXXXXXXXXXXX--XXXXXXXXXXXXXXXXXXXXXXXXXX%%%%%-|---XXXXXXXXXXXXXXXXXXXX----||----||||||--%%XXXXXXXXXX-------XX----------X-----XXXXX
XXXXXXXXXXXXXXXXXXXXXXXXXXXXXXXX--XXXXXXXXXXXXXXXXXXXXXXXXXX-|||--|---XXXXXXXXXXXXXXXXXXXX----||----||||||---|XXXXXXXXXX-------XX----------X-----XXXXX
