------------------------------------------------------------------------------------------------------------------------------------------------------
------------------------------------------------------------------------------------------------------------------------------------------------------
------------------------------------------------------------------------------------------------------------------------------------------------------
------------------------------------------------------------------------------------------------------------------------------------------------------
------------------------------------------------------------------------------------------------------------------------------------------------------
----------------------ooor-------------------------------------------R----------------------oo--------------------------------------------------------
---------------------%%%%%--------------------QQQQ-----------------------------------SUS------------------------------US-------SSS!S------------------
----------------------|||-------o----ooo------------------------------------------------------------oo------------------------------------------------
----------------------|||---------------------------------------------o----------------------------%--------------------------------------------------
----------------------|||-----------------------k--------o----------------------------------------------------------E-----------K---------------------
-----SSS------------%%%%%%%-----------%%T-----?QQQ---------------%%%----------------#####-S------------------T-----TT----------SSSS------#------------
-----------------K--||||||-------------|T-------------------------|-----------#-----#------------------------T-----TT--t----------------##------------
------------B-------||||||--o----------|T-------------------------|----------##----K#--------%%%%------------T-----TT--t-TT------------###---------F--
------------b-------||||||-%%%-%%%%%%%-|T-----------k-------------|-----------------#---------||----------y--T--g--TT--t-TT-----------####---------#--
XXXXXXXXXXXXXXXXXXXX||||||--|---|||||--|XXXXXXXXXX-XXXXXXXXX%%%%%-|---XXXXXXXXXXXXXXXXX-------||----XXXXXXXXXXXXXXXXXXXXXXXXXXXXXXXXXXXXXXXXXXXXXXXXXX
XXXXXXXXXXXXXXXXXXXX||||||--|---|||||--|XXXXXXXXXX-XXXXXXXXX-|||--|---XXXXXXXXXXXXXXXXX-------||----XXXXXXXXXXXXXXXXXXXXXXXXXXXXXXXXXXXXXXXXXXXXXXXXXX
