------------------------------------------------------------------------------------------------------------------------------------------------------
------------------------------------------------------------------------------------------------------------------------------------------------------
------------------------------------------------------------------------------------------------------------------------------------------------------
--------------------------------------------------------------------------------------------------------------SSSSSSSSSS----------SSSSSSSS------------
------------------------------------------------------------------------------------------------------------------------------------------------------
------------------------------------------------------------------------------------------------------------------------------------------------------
---------------------------------------------------------Q-Q------SSoo------SSSS-----SUS---------------------@----------------------------------------
--------------------------------o----ooo----------------------------------------------------------------------------------------oo--------------------
------------------------------------------------------------------------------------------------------------------------------------------------------
-----------------------------------------------------------------------------K------------------------------------------------------------------------
----------------!---SS----------------%%-TT---SU---------Q-Q%%%%%%---------SSSSS----#####-----------SU----!--!T--------------TT--------g##------------
---------------------K---TT------------|-TT------------------||||-----T-------------#-------------------------T--------------TT--------###------------
-------------------------TT------------|-TT------------------||||-----T------------K#------------B------------T----TT--------TT------g####---------F--
-M-----------------------TT----%%%%%%%-|-TT------k-----------||||-----T-------------#------------b--------k---T--g-TT----y---TT------#####---------#--
XXXXXXXXXXXXXXXXXXXXXXXXXXXXXX--|||||--|XXXXXXXXXXXXXXXXXXXX-||||-----XXXXXXXXXXXXXXXXX---XXXXXXXXXXXXXXXXXXXXXXXXXXXXXXXXXXXXXXXXXXXXXXXX--XXXXXXXXXX
XXXXXXXXXXXXXXXXXXXXXXXXXXXXXX--|||||--|XXXXXXXXXXXXXXXXXXXX-||||-----XXXXXXXXXXXXXXXXX---XXXXXXXXXXXXXXXXXXXXXXXXXXXXXXXXXXXXXXXXXXXXXXXX--XXXXXXXXXX
