------------------------------------------------------------------------------------------------------------------------------------------------------
------------------------------------------------------------------------------------------------------------------------------------------------------
------------------------------------------------------------------------------------------------------------------------------------------------------
----------SSSSSSSSSS----------------------------------------------------------------------------------------------------------------------------------
------------------------------------------------------------------------------------------------------------------------------------------------------
--------------------------------------oo----------------------g-------------------------------------oo------------------------------------------------
-----------------------------------SSSS-----------------------SSSSS------------------SSSS-----------%%%-------------------oo---%%%--------------------
----------------------------------------------------------------------------------------------------||--o----R------------SS----||--------------------
----------------------------------------------------------------------------------------------------||-%%%----------------------||--------------------
-------------------------------------------------------------------------------------------o--------||--|-----------------------||--------------------
-----SSS--@QQQQ---------------%-------------------------------------------------Q----------------TT-||--|--------------------SS-||---------##---------
----------------------------------------T-----TT----K--------------------------------------------TT-||-o|-----------------------||--------####--------
-----------------g-#--------------------T-----TT--------------TT-----t---------------------------TT-||%%%%%--------B------------||-------######------#
----------------g#-#-----ggg------------T-----TT-----------g--TT-----tgg---------ggg-------------TT-||-|||---------b------------||---y--########----##
XXXXXXXXXXXXXXXXXXXXXXXXXXXXXX--%%%%--%%XXXX--XXXXXXXXXXXXXXXXXXXXXXXXXXXXXXXXXXXXXXX----XXXXXXXXXXX||-|||----XXXXXXXXXX%%-----%%%XXXXXXXXXXXXXXXXXXXX
XXXXXXXXXXXXXXXXXXXXXXXXXXXXXX---||----|XXXX--XXXXXXXXXXXXXXXXXXXXXXXXXXXXXXXXXXXXXXX----XXXXXXXXXXX||-|||----XXXXXXXXXX|-------||XXXXXXXXXXXXXXXXXXXX
