------------------------------------------------------------------------------------------------------------------------------------------------------
------------------------------------------------------------------------------------------------------------------------------------------------------
------------------------------------------------------------------------------------------------------------------------------------------------------
------------------------------SSSSSSSSSS-----------oo-----------------SSSSSSSSSS--------------------SSSSSSSSSSSS-------S------------------------------
------------------------------SSSSSSSSSS----------%%%%----------------------SSSS----------------------------------------------------------------------
------------------------------SSSSSSSSSS-----------||--------------------g--SSSS------------oo--------------------------------------------------------
------------------------------SSSSSSSSSS-----------||-------------------SS---------------------------------------------S-----------------##-----------
---------------------------------------------------||--SSS--------------SS---------------------------------------------------------------##-----------
---------------------------------------------------||-------------------SS-------------------------%---------------SSS--------SSS------####-----------
---------------------------------------------------||-------------------SC--g-g---o----------------------------------------------------####-----------
------------------------------SSSSSSSSSS-----------||----------------T--SS--SSSS-------TT-S----------------TT----------S%------------######---#LSS----
------------------------------SSSSSSSSSS-----------||----------------T-----------------TT---------------#--TT--##--------------------######---#-------
------------------------------SSSSSSSSSS----------%||----------------T-----------------TT----%%%%------##--TT--##--------------------######---#-------
-M--------k---ggg--------ggg--SSSSSSSSSS-------ggg-||---------ggg----T-----------------TT-----||----kk-##--TT--##----------------r---######-kk#-------
XXXXXXXXXXXXXXXXXXXXXXXXXXXXXXXXXXXXXXXX-XXXXXXXXX-||-------XXXXXXXXXXXXXXXXXXXXXXXXXXXXXX----||----XXXXX--XX--XX------X----XXXXXXXXXXXXXXXXXXXXXXX---
XXXXXXXXXXXXXXXXXXXXXXXXXXXXXXXXXXXXXXXX-XXXXXXXXX-||-------XXXXXXXXXXXXXXXXXXXXXXXXXXXXXX----||----XXXXX--XX--XX------X----XXXXXXXXXXXXXXXXXXXXXXX---
