------------------------------------------------------------------------------------------------------------------------------------------------------
------------------------------------------------------------------------------------------------------------------------------------------------------
------------------------------------------------------------------------------------------------------------------------------------------------------
----------SSSSSSSSSS----------------------------------------------------------------------SSSSSSSSSS--------------------------------------------------
------------------------------------------------------------------------------------------------------------------------------------------------------
---------------------------------------------------------------------R--------------------------------------------------------------------------------
--------------------------------------------------Q------------------------g--------y------------------------------oo--------------------##-----------
-----------------------------------------------------------------------%%%%%%-----#SSS---------------------------------------------------##-----------
------------------------------------------------------------------------||||-----##------------------------------------------SSS-------####-----------
-----------------------------------oo-----------------------------------||||----###1---------------------------------------------------####-----------
----------------------------------o--o---TT---SU--Q--------------%%%----||||----###----------------------------%%%%--%%%r------------######-----------
-----------------------------------------TT-----------------------|-----||||----###--SSS------------------------||----||%%%%%%-------######-----------
-----------------------------------------TT-----------------------|-----||||----###-----------------------*-----||----|||||||--------######--------F--
-----------------------------------------TT------k---gg----k------|-----||||----###-------------g-g-gg----*---o-||----|||||||--------######--------#--
XXXXXXXXXXX--XX--X--XXXXX--XXXXXXXXXXXXXXXXXXXXXXXXXXXXXXXXX%%%%%-|-----||||----XXXXXX---XXXXXXXXXXXXXXXXXXXX-%-||----|||||||-----XXXXXXXXXXXXXXXXXXXX
XXXXXXXXXXX--XX--X--XXXXX--XXXXXXXXXXXXXXXXXXXXXXXXXXXXXXXXX-|||--|-----||||----XXXXXX---XXXXXXXXXXXXXXXXXXXX---||----|||||||-----XXXXXXXXXXXXXXXXXXXX
