------------------------------------------------------------------------------------------------------------------------------------------------------
------------------------------------------------------------------------------------------------------------------------------------------------------
------------------------------------------------------------------------------------------------------------------------------------------------------
--------------------SSSSSSSSSS--oo--------------------------------------------------------SSSSSSSSSS--------------------------------------------------
--------------------SSSSSSSSSS---------g--------------------------------------------------------------------------------------------------------------
--------------------SSSSSSSSSS-----%%%%%--------------------------------------------------------------------------------------------------------------
--------------------SSSSSSSSSS------||||-------------------------------------------o--o----------------------R---------------------SSSS---------------
------------------------------------||||-----------------------------------------------------------------r------oooo------------oo--------------------
------------------------------------||||------------------------------------------------------------%%%%%%%-------------------------------------------
------------------------------%%%%%-||||-------------------------------------------SSSS-------------||||||-----------------------------SSSS-----------
---------Q---------%--SSSSSS?--|||--||||-----------------------------#------------------------------||||||----T--------------TT-----------------------
----------------------SSSSS----|||--||||------------K---------------##--------------------t---------||||||----T--------------TT-----------------------
----------------------SSSSS----|||--||||--------------------TT-----###----------%%%-------t---------||||||----T--------------TT--------------------F--
-M-----------%%%%----------ooo-|||--||||-------y-----------gTT----####----------||--------t---------||||||--ooT---y------y---TT--------------------#--
XXXXXXXXXXX---||-----XXXXXXXXX-|||--||||XXXXXXXXXXXXXXXXXXXXXXXXXXXXXXX----XXXXX||--------XXXXXXXXXX||||||--%%XXXXXXXXXXXXXXXXXXXX---------XXXXXXXXXXX
XXXXXXXXXXX---||-----XXXXXXXXX-|||--||||XXXXXXXXXXXXXXXXXXXXXXXXXXXXXXX----XXXXX||--------XXXXXXXXXX||||||---|XXXXXXXXXXXXXXXXXXXX---------XXXXXXXXXXX
