------------------------------------------------------------------------------------------------------------------------------------------------------
------------------------------------------------------------------------------------------------------------------------------------------------------
------------------------------------------------------------------------------------------------------------------------------------------------------
--------------------------------oo------SSSSSSSSSS----------------------------------------------------------------------------------------------------
---------------------------------------gSSSSSSSS------------------------------------------------------------------------------------------------------
-----------------------------------%%%%%SSSCSSSS-------oooo---------------------K---------------------------------------------------------------------
------------------------------------||||SSSSSSSS-------%%%%-----------------SSSSSS----1----SSS!--------------------oo-----------------------SSS-------
------------------------------------||||----------SSSS--||---o---o---o----------------------------------------------------------oo--------------------
------------------------------------||||----------------||--%%%-%%%-%%--------------------------------------------------------------------------------
------------------------------%%%%%-||||---ggg----------||---|---|---|-------K-------------------------------------------------------------------SSSSS
-------------------%-----------|||--||||SSSSSSSS--------||---|---|---|-----SSSSSSS------------C----------------%%%%--%%%-----TT-----------------------
-------------------------------|||--||||SSSSSSSS------U-||---|---|---|T---------------TT--------------TT--------||----||-----TT-----------------------
-------------------------------|||--||||SSSSSSSS--------||---|---|---|T---------------TT--------------TT----TT--||----||-----TT-------------SSS-------
-------------%%%%--------------|||--||||SSSSSSSS--------||---|---|-r-|T---------------TT-------g-g----TT-k--TTo-||----||-y---TT---k----------------r--
XXXXXXXXXXX---||----XXXXX--XXX-|||--||||XXXXXXXXXX----%%%%%-%%%%%%%%%%XXXXXXXXXXXXXXXXXXXXXXXXXXXXXXXXXXXXXXXX%-||----||XXXXXXXXXXXX---XXXXX-----XXXXX
XXXXXXXXXXX---||----XXXXX--XXX-|||--||||XXXXXXXXXX-----|||---|||||||||XXXXXXXXXXXXXXXXXXXXXXXXXXXXXXXXXXXXXXXX--||----||XXXXXXXXXXXX---XXXXX-----XXXXX
