------------------------------------------------------------------------------------------------------------------------------------------------------
------------------------------------------------------------------------------------------------------------------------------------------------------
------------------------------------------------------------------------------------------------------------------------------------------------------
--------------------SSSSSSSSSS------------------------------------------------------------------------------------------------------------------------
------------------------------------------------------------------------------------------------------------------------------------------------------
---------------------------------------------------------------------R---------------------------------------------k----------------------------------
--------------------------------------------------------------------------------------------------------SSQSSSS---SSSSSS-----------SSSS---------------
--------------------------------------------------------------------------------------------------oo--------------------------------------------------
-----------------%%%--------------------------------------------------------------TT------------------------------------------------------------------
------------------||---------C----------------------------------------------------TT----------------------K----------------------------SSSS-----------
------------------||---#-#-------------T--------------S----------%%%--------------TT--------------------SSSSSS----------------------------------------
-------------%%%%%||-#-#-#-#-----------T----------TT--------------|---------------TT-----T------#-----------------------------------------------------
--------------|||-||-#-#-#-#-----------T----------TT--------------|-------------T-TT-----T------#-------------TT-----------------------------------F--
--------------|||-||-#-#-#-#-E--gg-----T-------y--TT------k-------|---gg--------T-TT---k-T------#-------------TT---------k----ggg------------------#--
XXXXXXXXXXX---|||-||XXXXXXXXXXXXXXXXXXXXXXXXXXXXXXXXXXXXXXXX%%%%%-|---XXXXXXXXXXXXXXXXXXXXXXXXXXXXXXXXXXXXXXXXXXXXXXXX--XXXXXXXXXX---------XXXXXXXXXXX
XXXXXXXXXXX---|||-||XXXXXXXXXXXXXXXXXXXXXXXXXXXXXXXXXXXXXXXX-|||--|---XXXXXXXXXXXXXXXXXXXXXXXXXXXXXXXXXXXXXXXXXXXXXXXX--XXXXXXXXXX---------XXXXXXXXXXX
