------------------------------------------------------------------------------------------------------------------------------------------------------
------------------------------------------------------------------------------------------------------------------------------------------------------
------------------------------------------------------------------------------------------------------------------------------------------------------
--------------------------------------------------------------------------------SSSSSSSSSSSSSSSSSSSS----------SSSSSSSSSSSSS-----SS--------------------
------------------------------------------------------------------------------------------------------------------------------------------------------
----------------------------------------%%-------------oooo-------------------------------------------------------------------------------------------
----------------------------------------|--------------%%%%-------------------------------------------------------------US------------------SS--------
----------------------------------------|----oo---------||--------------------------------------------------------------------------------------------
----------------------------------------|---------------||------------------------------------------------------------------SSS-----------------------
----------------------------------------|---------SSS---||---------------1-------------S--------------------------------------------------------------
-------------------%--------TT---------T|---------------||-----------TT---------SU----------------------------T---------SSS-----------------SS--------
----------------------------TT---------T|-------------U-||-----------TT----TT-------TT---tt-------------------T-----------------------------------#-TT
----------------------------TT---------T|---------------||-----------TT----TT-------TT---tt---------------*---T----TT----------------------------##-TT
-M-----------%%%%-------ggg-TT--gg-----T|---------------||----ggg----TT---kTT------kTT--ktt---------gg----*---T--g-TT---------------------------###-TT
XXXXXXXXXXX---||----XXXXXXXXXXXXXXXXXXXX|----%%%%-----%%%%%-XXXXXXXXXXXXXXXXXXXXXXXXXXXXXXXXXXXXXXXXXXXXXXXXX-XXXXXXXXXXXXX------XXXXXXXXXXXXXXXXXX-XX
XXXXXXXXXXX---||----XXXXXXXXXXXXXXXXXXXX|-----||-------|||--XXXXXXXXXXXXXXXXXXXXXXXXXXXXXXXXXXXXXXXXXXXXXXXXX-XXXXXXXXXXXXX------XXXXXXXXXXXXXXXXXX-XX
