------------------------------------------------------------------------------------------------------------------------------------------------------
------------------------------------------------------------------------------------------------------------------------------------------------------
------------------------------------------------------------------------------------------------------------------------------------------------------
----------------------------------------SSSSSSSSSS----------------------------------------SSSSSSSSSS----------SS-------S------------------------------
------------------------------------------------------------------------------------------------------------------------------------------------------
----------------------ooor----------------------------------------------------------------------------------------------------------------------------
---------------------%%%%%---------------oooo------------Q-Q--USSS---------1---------1-----------------------R---------S-SSS----S!SS--------SS--------
----------------------|||----------------------------------------------------------------------------r------------------------------------------------
----------------------|||----------------SSSS-U-----------------------------------------------------%%%%%%%--------SSS--------------------------------
------------Q--?------|||---------------oS--SoS----------------------------ggg----------------------||||||--------------------------------------------
-------------------S%%%%%%%-----QQQQ----SS--SSS----------Q-Q-S-----TT-#########----QQQQ-------------||||||-------------S---------SSS--------SS--------
--------------------||||||-----------K-B---------------------------TT---------#---------------------||||||-----##-----------------K---#----B------#-TT
--------------------||||||--o----------b---------------------------TT---------#---------------------||||||-----##---------------------#----b-----##-TT
-M----------------K-||||||-%%%---------b--kk-----------------ggg---TT---------#-----yy----------g-g-||||||--oo-##-----------gg-g-g----#----B----###-TT
XXXXXXXXXXXXXXXXXXXX||||||--|-XXXXXXXXXXXXXXXXXXXXXXXXXXXXXXXXXXXXXXXX--------X-XXXXXXXXXXXXXXXXXXXX||||||--%%-XX------XXXXXXXXXXXXXXXXXXXXXXXXXXXX-XX
XXXXXXXXXXXXXXXXXXXX||||||--|-XXXXXXXXXXXXXXXXXXXXXXXXXXXXXXXXXXXXXXXX--------X-XXXXXXXXXXXXXXXXXXXX||||||---|-XX------XXXXXXXXXXXXXXXXXXXXXXXXXXXX-XX
