------------------------------------------------------------------------------------------------------------------------------------------------------
------------------------------------------------------------------------------------------------------------------------------------------------------
------------------------------------------------------------------------------------------------------------------------------------------------------
S-----SSSS--------------------------------------------------------------------------------------------------------------------------------------U-----
S-------------------------------------------------?---------------------------------------------------------------------------------------------------
S----------------------SSS-------------------------------------------R------------------oo------------------------------------------------------------
S-------------------------------------------------------------------------SSCSS-oo----------------------------------------SSC-------------------------
S--------------------g----------o----ooo----------SS------------------------------------------------------TT-----SSS------------------------------SS--
S-------------------%%%-----------------------------------------------------------------------------------TT-------------------------g#---------------
S-------------------||----SSS----------------------------------------------------SS--------o--------------TT--------------SSS-------g##-------SS------
S------------------%||----------------%%-------------------------%%%----QQQQ--QQ---------S-------TT------SXXS-----------------------###--------------#
S-------------------||-----------------|-----K---B-----SSS--------|------------------------------TT--------------------------------####-------------##
S-------------------||-----------------|---------b----------------|------------------------------TT-TT----------------------------#####------------###
S------------%%%%---||----oo---%%%%%%%-|---------B----------------|------------------------------TT-TT---------------------------######-----------####
XXXXXXXXXXX---||----||---%%%----|||||--|XXXXXXXXXX----------%%%%%-|---XXXXXXXXXX----------XXXXXXXXXXXXXXXXXXXX%%%%----%%X----XXXXXXXXXX--XXXXXXXX-XXXX
XXXXXXXXXXX---||----||----|-----|||||--|XXXXXXXXXX-----------|||--|---XXXXXXXXXX----------XXXXXXXXXXXXXXXXXXXX|||------|X----XXXXXXXXXX--XXXXXXXX-XXXX
