------------------------------------------------------------------------------------------------------------------------------------------------------
------------------------------------------------------------------------------------------------------------------------------------------------------
------------------------------------------------------------------------------------------------------------------------------------------------------
--------------------SSSSSSSSSS------------------------------------------------------------------------------------------------------------------------
-------------------------------------------------------------------------o----------------------------------------------------------------------------
----------------------------------------ooooo---------------------------%%%-------------oo--oo--------------------------------------------------------
-------------------------------------------------------------------------|--o---oo---------------------------@--------------------%---------SS--------
------------------------------------------------SS-----------------------|--SSSS----------------------------------------------------------------------
-----------------g-----------------------SSSS-------------------------%--|-------------------------%------------------------------------SSS-----------
-----------------#-----------C---------------------------o------1--------|-------SS-------------------------------------------------------------------
----------S-----##-----#-#-----------------------------------------------|---------------SS---------SU----!--!--------------------%%%%%-----SS--------
---------------###---#-#-#-#----------tt---------------------------------|---------------------------------------------------------|||------------#-TT
--------------####---#-#-#-#----------tt----%%%%%------------------------|-----%-------------%%%%------------------B---------------|||-----------##-TT
---M---------#####---#-#-#-#-E--------tt-----|||----k--------------------|--------------------||----------k--------b------kkk------|||----------###-TT
XXXXXXXXXXXXXXXXXXXXXXXXXXXXXXXXXXXXXXXX%%---|||---XXXXXXXXXXXXXXXXXX-%%%%%%------------------||----XXXXXXXXXXXXXXXXXXXXXXXXXXXXXX%|||------XXXXXXX-XX
XXXXXXXXXXXXXXXXXXXXXXXXXXXXXXXXXXXXXXXX|----|||---XXXXXXXXXXXXXXXXXX-|||||-------------------||----XXXXXXXXXXXXXXXXXXXXXXXXXXXXXX-|||------XXXXXXX-XX
