------------------------------------------------------------------------------------------------------------------------------------------------------
------------------------------------------------------------------------------------------------------------------------------------------------------
------------------------------------------------------------------------------------------------------------------------------------------------------
--------------------------------------------------SSSSSSSSSS----------SSSSSSSSSS----------------------------------------SSSSSSSSSS--------------------
------------------------------------------------------SS--SS------------------------------------------------------------------------------------------
--------------------------------------oo--------------SS--SS--------------------------------oo--------------------------------------------------------
-----------------------------------SSSS-------------SS-----------------------------o--o-----------------SSQSSS--------US------------------------------
----------------------------------------------------SS------------------------TT----------------------------------------------------------------------
----------------------------------------------------SS------------------------TT-------------------%--------------------------------------------------
----------------------------------------------------SS----oo------------------TT---SSSS-------------------K---------E---------------------------------
----------Q---------SS--------%---------------------SSSS--SS----------------SCTT----------S-------------SSSSSS-----TT-----------------------#---------
---------------------K---TT---------------------------SS----------------TT----TT-----------------------------------TT--t--SS---------TT-----##--------
-------------------------TT---------------------------SS----------------TT----TT%%%----------%%%%------------------TT--t--SS---------TT-----###------#
-M-----------------#-----TT---------------------------------gg-------g--TT---kTT||------------||----------------g--TT--t--SS---------TT-----####----##
XXXXXXXXXXXXX--XXXXXXXXXXXXXXX--%%%%--%%X-XX-XX-XXXXXXXXXXXXXXXXXXXXXXXXXXXXXXXX||------------||----XXXXXXXXXXXXXXXXXXXX--XX--XXXXXXXXXXXXXXXXXXXXXXXX
XXXXXXXXXXXXX--XXXXXXXXXXXXXXX---||----|X-XX-XX-XXXXXXXXXXXXXXXXXXXXXXXXXXXXXXXX||------------||----XXXXXXXXXXXXXXXXXXXX--XX--XXXXXXXXXXXXXXXXXXXXXXXX
