------------------------------------------------------------------------------------------------------------------------------------------------------
------------------------------------------------------------------------------------------------------------------------------------------------------
------------------------------------------------------------------------------------------------------------------------------------------------------
------------------------------SSSSSSSSSS--------------------------------------------------------------------------------SSSSSSSSSSSSSSSSSSSS----------
------------------------------SSSSSSSSSS----------?---------------------------------------------------------------------------------------------------
------------------------------SSSSSSSSSS----------------------g-------------------g-------------------------------------------------------------------
---------------------LSSS-----SSSSSSSSSS----------------------SSSSS-----SSSSS---SSSSSSSS------------------2-----------US--------------------SSS-------
--------------------------------------------------SS--------------------------------------------------------------------------------------------------
------------------------------------------------------------------------------------------------------------------------------------------------------
------------------------------------------------------------------------------------------------g---o---------------E----------------------------SSSSS
----------------%%%%-2-----#--SSSSSSSSSS-------------------------------------2------------------TT--------2--------TT---------------------------------
-----------------||--------#--SSSSSSSSSS---------------SSS-----------------TT-------------------TT-----------------TT--t--SS--------------TT----------
-----------------||--------##-SSSSSSSSSS----------------------TT-----tt----TT--T----------------TT-----------------TT--t--SS-------tt-----TTSSS-------
---M-------------||---kk---##-SSSSSSSSSS-------y--------------TT-----tt----TT--T----------------TT------y--y----g--TT--t--SS-------tt----kTT-------r--
XXXXXXXXXXX--%%%%||%XXXXXXXXXXXXXXXXXXXXXXXXXXXXXX----------XXXXXXXXXXXXXXXXXXXXXXXXXX---XXXXXXXXXX-XXXXXXXXXXXXXXXXXXXX--XX--XXXXXXXXXXXXXX-----XXXXX
XXXXXXXXXXX---||-||-XXXXXXXXXXXXXXXXXXXXXXXXXXXXXX----------XXXXXXXXXXXXXXXXXXXXXXXXXX---XXXXXXXXXX-XXXXXXXXXXXXXXXXXXXX--XX--XXXXXXXXXXXXXX-----XXXXX
