------------------------------------------------------------------------------------------------------------------------------------------------------
------------------------------------------------------------------------------------------------------------------------------------------------------
------------------------------------------------------------------------------------------------------------------------------------------------------
----------------------------------------SSSSSSSSSS----------------------------------------------------------------------------------------------------
------------------------------------------------------------------------------------------------------------------------------------------------------
------------------------------------------------------------------------------------------------------------------------------------------------------
---------------------LSSS----------------oooo-------------------------------SSSS-----1-----------------------------------SSS----S!--------------------
------------------------------------------------------------------------------------------------------------------------------------------------------
-----------------------------------------SSSS-U----------B--------------------------------------------------------------------------------------------
----------------------------------------oS--SoS----------b-------------------K-----------------oooo---------------------------------------------------
----------Q----------2-----#-----------TSS--SSS--------SS#CS---------T-----SSSSS---QQQQ---------------%%%%%%---------------------S--------------------
---------------------------#-----------T-----------------------------TT--------------------------------||||-------------------------------------------
---------------------------##----------T-------------------K---------TT--------------------------------||||--------B-------------------------------F--
-------------------#--kk---##---gg-----T--kk------------------ggg----TT-------------yy-----------------||||--------b--------gg-g-g-----------------#--
XXXXXXXXXXXXX--XXXXXXXXXXXXXXXXXXXXXXXXXXXXXXXXXXXXXXXXXXXXXXXXXXXXXXXXXXXXXXXXXXXXXXXXXXX%%%%%%%-%%%%-||||-%%XXXXXXXXXXXXXXXXXXXXXXXXXXXXXXXXXXXXXXXX
XXXXXXXXXXXXX--XXXXXXXXXXXXXXXXXXXXXXXXXXXXXXXXXXXXXXXXXXXXXXXXXXXXXXXXXXXXXXXXXXXXXXXXXXX||||||---||--||||--|XXXXXXXXXXXXXXXXXXXXXXXXXXXXXXXXXXXXXXXX
