------------------------------------------------------------------------------------------------------------------------------------------------------
------------------------------------------------------------------------------------------------------------------------------------------------------
------------------------------------------------------------------------------------------------------------------------------------------------------
------------------------------------------------------------------------------------------SSSSSSSSSS----------------------------------------SSSSSSSSSS
------------------------------------------------------------------------------------------------------------------------------------------------------
-------------------------------------------------------------------------------------------------------------------k----------------------------------
-------------------------------------------------------------------------------------SSSS---------------------S---SSSSSS--SSC-----!S------------------
------------------------------------------------------------------------------------------------------------------------------------------------------
------------------------------------------------------------------------------------------------------------------------------------------------------
-----------------------------------oo-------------------------------------------------------------------------------------SSS-------------------------
--------SU---------%--------------o--o--------tt--------------------------------Q-------------------------------------------------S------#----TT------
----------------------------------------------tt----K-------------------------------------t-----------------g---------------------------##----TT------
----------------------------------------------tt------------------------------------------t-----------------TTTT-----------------------###----TT------
--M----------%%%%------------------------g----tt-----------g-y-------------------ggg------t-----------------TTTT-----------------#----####----TT------
XXXXXXXXXXX---||----XXXXX--XXXXXXXXXXXXXXXXXXXXXXXXXXXXXXXXXXXXXXXXXXXX----XXXXXXXXXX----XXXXXXXXXXX--XXXXXXXXXXXXXXXX--X----XXXXXXXXXXXXXXXXXXX--XXXX
XXXXXXXXXXX---||----XXXXX--XXXXXXXXXXXXXXXXXXXXXXXXXXXXXXXXXXXXXXXXXXXX----XXXXXXXXXX----XXXXXXXXXXX--XXXXXXXXXXXXXXXX--X----XXXXXXXXXXXXXXXXXXX--XXXX
