------------------------------------------------------------------------------------------------------------------------------------------------------
------------------------------------------------------------------------------------------------------------------------------------------------------
------------------------------------------------------------------------------------------------------------------------------------------------------
-------------------------------------------------------------------SSS----------SSSSSSSSSL------------------------------------------------------------
--------------------------------------------?---------------------------------------------------------------------------------------------------------
----------------------ooor-----------------------------oooo---------------------------------oo--------------------------------------------------------
---------------------%%%%%-----------------------------%%%%-----CSS-----------------oooooo------------------------------SSS------------US----------SSS
----------------------|||---------------------r---------||--------------------------------------------------------------------------------------------
----------------------|||-----------------%%%%%%--------||--SS--2-------------------SSSSSS---------%--------------------------------------------------
----------------------|||------------------||||---SSS---||-----2-2------------------SSSSSS-------------------------------------------SS---------------
-------------------%%%%%%%%----TT-------%%-||||ooo------||--------2-----------------------S------------------------------------------------S------#---
--------------------||||||-----TT-------|--||||--r----U-||--------------------------------------------TT------------------------------------------#---
--------------------||||||--o--TT-------|%%%%%%%%%------||-----------------------------------%%%%-----TT----TT-----B----------TT--TT--------------#---
---M---------%%%%---||||||-%%%gTT-------|-||||||||------||------------gg----------------------||------TT-k--TT-----b----------TT--TT---------ggg--#---
XXXXXXXXXXX---||----||||||--|-XXXXXXXX--|-||||||||----%%%%%----XXXXXXXXXXXXXXXXX---XXXXXXX----||----XXXXXXXXXXXXXXXXXXXX----XXXXXXXXXXXX-X-XXXXXXXXXXX
XXXXXXXXXXX---||----||||||--|-XXXXXXXX--|-||||||||-----|||-----XXXXXXXXXXXXXXXXX---XXXXXXX----||----XXXXXXXXXXXXXXXXXXXX----XXXXXXXXXXXX-X-XXXXXXXXXXX
