------------------------------------------------------------------------------------------------------------------------------------------------------
------------------------------------------------------------------------------------------------------------------------------------------------------
------------------------------------------------------------------------------------------------------------------------------------------------------
----------------------------------------------------------------------SSSSSSSSSS------------------------------SS-------S----------SSSSSSSSSS----------
--------------------------------------------?---------------------------------------------------------------------------------------------------------
-------------------------------------------------------oooo-------------------------------------------------------------------------------------------
--------------------USS--------------------------------%%%%--------------------------SSSS------------------------------S-SSS----S!--------------------
----------------------------------------------r---SSSS--||--------------------TT--------------------oo------------------------------------------------
------------------------------------------%%%%%%--------||--------------------TT-----------------------------------SSS--------------------------------
------------Q--?---------------------------||||---------||--------------------TT----------------------------------------------------------------------
-------------------S------------QQQQ----%%-||||ooo------||-----------T------SCTTQ----------------------------T---------S---------S--------------------
---------------------B---------------K-B|--||||--r----U-||-----------T--TT----TT-----------------------------T-##-------------------------TT-------#--
---------------------b-------B---------b|%%%%%%%%%------||-----------T--TT----TT-----------------------------T-##------------------tt-----TT---K---#--
-M----------------K--B-------b---------b|-||||||||------||----ggg----T--TT---kTT-ggg---------------g------y--T-##-----------gg-g-g-tt----kTT-------#--
XXXXXXXXXXXXXXXXXXXXXXXXXXXXXXXXXXXXXXXX|-||||||||----%%%%%-XXXXXXXXXXXXXXXXXXXXXXXXX----X-XXXXXXXXXXXXXXXXXXX-XX------XXXXXXXXXXXXXXXXXXXXXXXXXX--XXX
XXXXXXXXXXXXXXXXXXXXXXXXXXXXXXXXXXXXXXXX|-||||||||-----|||--XXXXXXXXXXXXXXXXXXXXXXXXX----X-XXXXXXXXXXXXXXXXXXX-XX------XXXXXXXXXXXXXXXXXXXXXXXXXX--XXX
