------------------------------------------------------------------------------------------------------------------------------------------------------
------------------------------------------------------------------------------------------------------------------------------------------------------
------------------------------------------------------------------------------------------------------------------------------------------------------
----------SSSSSSSSSS--------------------SSSSSSSSSS--------------------SSSSSSSSSS------------------------------SS-------S------------------------------
----------------------------------------SSSSSSSS------------------------------------------------------------------------------------------------------
----------------------------------------SSSCSSSS------------------------------------------------------------------------------------------------------
-----------------------------U----------SSSSSSSS-------------------------------------------------------------R---------S--oo---%%%SS------------------
------------------------------------------------------------------------------TT------------------oo-----r----------------SS----||--------------------
------------------------------------------------------------------------------TT--TT----------------%%%%%%%--------SSS----------||--------------------
-------------------------------------------ggg--------------------------------TT--TT----------------||||||----------------------||--------------------
---------Q------------------##----------SSSSSSSS------S---------------------SCTT--TT----------------||||||-------------S-----SS-||SS------------------
-----------------------y-#####---------TSSSSSSSS--TT--------------------TT----TT--TT-----T------#---||||||-----##---------------||K---#----B----------
--------------------y-######-----------TSSSSSSSS--TT--------------------TT----TTT-TT-----T------#---||||||-----##---------------||----#----b-------F--
--------------------######-----------kkTSSSSSSSS--TT------k--y----------TT---kTTT-TT---k-T------#---||||||--oo-##---------------||----#----B-------#--
XXXXXXXXXXX--XX--X--XXXX------XXXXXXXXXXXXXXXXXXXXXXXXXXXXXXXXXXXXXXXXXXXXXXXXXXXXXXXXXXXXXXXXXXXXXX||||||--%%-XX------X%%-----%%%XXXXXXXXXXXXXXXXXXXX
XXXXXXXXXXX--XX--X--XXXX------XXXXXXXXXXXXXXXXXXXXXXXXXXXXXXXXXXXXXXXXXXXXXXXXXXXXXXXXXXXXXXXXXXXXXX||||||---|-XX------X|-------||XXXXXXXXXXXXXXXXXXXX
