------------------------------------------------------------------------------------------------------------------------------------------------------
------------------------------------------------------------------------------------------------------------------------------------------------------
------------------------------------------------------------------------------------------------------------------------------------------------------
------------------------------SSSSSSSSSS----------SSSSSSS-------------------------------------------SSSSSSSSSS----------------------------------------
------------------------------------------------------------------------------------------------------------------------------------------------------
------------------------------------------------------------------------------------------------------------------------------------------------------
----------------------!---------------------------QQ---------------------------------SUS--SSS------%-------------------------------SSSS---------------
------------------------------------------------------------------------------------------------------------------------------------------------------
-----------------%%%-------------------S-------------------S---------o-------------------------------------------------------SSS----------------------
------------------||-------------------S-------------------------y-------1-------------------------------------------------------------SSSS-----------
------------------||S@S!S--------------S-TT---SU--QQ--QQQ--------##---T-------------#####---%%%--------------T----------r-------------------#---------
-------------%%%%%||-----------#---------TT---------------------###---T----TT-------#--------|---------TT----T----------%%%%%%--------------##--------
--------------|||-||--------tt-#-#-------TT--------------------####---T----TT------K#--------|---------TT----T----------|||||---------------###------#
-M------------|||-||-g------tt-#-#-------TT------k------------#####---T---kTT-------#--------|------g--TT----T-k----kkk-|||||---------------####----##
XXXXXXXXXXX---|||-||XXXXXXXXXXXXXXXXXXXXXXXXXXXXXXXXXXXXX---XXXXXXX---XXXXXXXXXXXXXXXXX------|------XXXXXXXXXXXXXXXXXXXX|||||--------------XXXXXXXXXXX
XXXXXXXXXXX---|||-||XXXXXXXXXXXXXXXXXXXXXXXXXXXXXXXXXXXXX---XXXXXXX---XXXXXXXXXXXXXXXXX------|------XXXXXXXXXXXXXXXXXXXX|||||--------------XXXXXXXXXXX
