------------------------------------------------------------------------------------------------------------------------------------------------------
------------------------------------------------------------------------------------------------------------------------------------------------------
------------------------------------------------------------------------------------------------------------------------------------------------------
----------------------------------------------------------------------SSSSSSSSSS----------------------------------------------------------------------
------------------------------------------------------------------------------------------------------------------------------------------------------
----------------------------------------%%---------------------------R------------g-------------------------------------------------------------------
--------------------USS-----------------|----------------Q-Q--------------------SSSSSSSS------------------------------------------!S------------------
----------------------------------------|----oo-------------------------------TT----------------------------------------------------------------------
----------------------------------------|-------------------------------------TT----------------------------------------------SSS---------------------
----------------------------------------|-------------------------------------TT-----------o----------------------------------------------------------
---------Q---------%--------------------|----------------Q-Q-----%%%--------SCTT-----------------TT-------------------r-%---------S------#----#LSS----
---------------------B----------------K-|-------------------------|-----TT----TT-----------------TT---TT----------%%%%%%----------------##----#-------
---------------------b-------BTTTT------|-------------------------|-----TT----TT-----------------TT---TT----TT-----|||||---------------###----#-------
-M-----------%%%%----B-------bTTTT------|-------------------------|-----TT---kTT-----------------TT---TT-k--TT-----|||||---------r----####--kk#-------
XXXXXXXXXXX---||----XXXXXXXXXXXXXXXXXXXX|----%%%%-XXXXXXXXXX%%%%%-|---XXXXXXXXXXXXXXXX---XXXXXXXXXXXXXXXXXXXXX-%%%-|||||----XXXXXXXXXXXXXXXXXXXXXXX---
XXXXXXXXXXX---||----XXXXXXXXXXXXXXXXXXXX|-----||--XXXXXXXXXX-|||--|---XXXXXXXXXXXXXXXX---XXXXXXXXXXXXXXXXXXXXX--|--|||||----XXXXXXXXXXXXXXXXXXXXXXX---
