------------------------------------------------------------------------------------------------------------------------------------------------------
------------------------------------------------------------------------------------------------------------------------------------------------------
------------------------------------------------------------------------------------------------------------------------------------------------------
----------------------------------------------------------------------------------------------------SSSSSSSSSS----------------------------------------
------------------------------------------------------------------------------------------------------------------------------------------------------
--------------------------------------------------------------g---------------------------------------------------------------------------------------
------------------SC------------------------------------------SSSSS-------SSCSS------------------------------------oo---------------------------------
--------------------------------------------------------------------------------------------------oo------------------------------oo-----------y------
----------------------------------------------------------------------------------TT---------------------------------------------------------#SS--o---
----------------------------------------------------------------------------------TT--------------------------------------------------------##--------
--------------TT---2--------TT---------T-----------------tt-------------QQQQ--QQ--TT-----------------------TT--%%%%--%%%-------------------Q##--SC----
--------------TT------------TT---------T-----------------tt-----------------------TT-----T------#-------#--TT---||----||--------------------##--------
--------------TT------------TT---------T-----------------tt---TT-----t----------T-TT-----T------#------##--TT---||----||--------------------##---SSS--
-M------------TT--------ggg-TT--gg-----T----y-y------g-g-tt---TT-----t----------T-TT---k-T------#---kk-##--TT-o-||----||--kkk---------------##--------
XXXXXXXXXXXXXXXXXXXXXXXXXXXXXXXXXXXXXXXXXXXXXXXXXXXXXXXXXXXXXXXXXXXXXXXXXXXXXXXXXXXXXXXXXXXXXXXXXXXXXXXXX--XX-%-||----||XXXXXXXXXXXXXXXXXXXXXX------XX
XXXXXXXXXXXXXXXXXXXXXXXXXXXXXXXXXXXXXXXXXXXXXXXXXXXXXXXXXXXXXXXXXXXXXXXXXXXXXXXXXXXXXXXXXXXXXXXXXXXXXXXXX--XX---||----||XXXXXXXXXXXXXXXXXXXXXX------XX
