------------------------------------------------------------------------------------------------------------------------------------------------------
------------------------------------------------------------------------------------------------------------------------------------------------------
------------------------------------------------------------------------------------------------------------------------------------------------------
--------------------------------------------------------------------------------SSSSSSSSSS------------------------------SSSSSSSSSS--------------------
------------------------------------------------------------------------------------------------------------------------------------------------------
-----------------------SSS----------------------------------------------------------------------------------------------------------------------------
---------------------------------------------------------------------------g---------------------------------@---------------------------##-----------
---------------------g-------------------------------------------------%%%%%%------------------------------------------------------------##-----------
--------------------%%%----------------------------------TT-------------||||-----------------------------------------------------------####-----------
--------------------||----SSS----------------------TT----TT-------------||||-----------S----------oo-----------------------------------####-----------
--------------------||-----------------------------TT----XX----------#--||||----SU------------------SU----!--!-----------------------######-----------
--------------------||-----------------T-----------TT---------------##--||||--------TT---t-----TT--------------#----------SS---------######--------#--
--------------------||-----------------T-----------TT-------TT-----###--||||--------TT---t-----TT--------------#----------SS---------######----K---#--
-M------------k-ggg-||----oo---------kkT-----------TT-------TT----####--||||-------kTT--kt--y--TT---------k----#----ggg---SS---------######--------#--
XXXXXXXXXXXXXXXXXXXX||---%%%--XXXXXXXXXXX-XX-XX-XXXXXXXXXXXXXXXXXXXXXX--||||----XXXXXXXXXXXXXXXXXXXXXXXXXXXXXX-XXXXXXXXX--XX--XXXXXXXXXXXXXXXXXXX--XXX
XXXXXXXXXXXXXXXXXXXX||----|---XXXXXXXXXXX-XX-XX-XXXXXXXXXXXXXXXXXXXXXX--||||----XXXXXXXXXXXXXXXXXXXXXXXXXXXXXX-XXXXXXXXX--XX--XXXXXXXXXXXXXXXXXXX--XXX
