------------------------------------------------------------------------------------------------------------------------------------------------------
------------------------------------------------------------------------------------------------------------------------------------------------------
------------------------------------------------------------------------------------------------------------------------------------------------------
------------------------------SSSSSSSSSS------------------------------------------------------------SSSSSSSSSS----------------------------------------
------------------------------SSSSSSSSSS--------------------------------------------------------------------------------------------------------------
------------------------------SSSSSSSSSSooooo---------------------------------------------------------------------------------------------------------
-----------------------------USSSSSSSSSS--------------------------SSoo----------------------------------------------------------------------SSS-------
------------------------------------------------SS------------------------------------------------oo----------------------------oooo------------------
-----------------------------------------SSSS-------------------------o-----------TT------------------------------------------------------------------
----------------------------------------------------------------------------------TT-------------------------------------------------------------SSSSS
-------------------%--------##SSSSSSSSSS-----------------tt-%%%%%%----------------TT-----------------------TT---------r------TT------------Q----------
-----------------------y-#####SSSSSSSSSS-----------------tt--||||-------------#---TT-----T------#-------#--TT-----%%%%%%-----TT-----------------------
--------------------y-######--SSSSSSSSSS----%%%%%--------tt--||||------------##-T-TT-----T------#------##--TT------|||||-----TT-------------SSS-------
-M-----------%%%%---######----SSSSSSSSSS-----|||-----g-g-tt--||||---------------T-TT---k-T------#---kk-##--TT------|||||-y---TT--------------------r--
XXXXXXXXXXX---||----XXXX------XXXXXXXXXX%%---|||--XXXXXXXXXX-||||-----XXXXXXXXXXXXXXXXXXXXXXXXXXXXXXXXXXX--XX--%%%-|||||XXXXXXXXXXXXXXXXXXXX-----XXXXX
XXXXXXXXXXX---||----XXXX------XXXXXXXXXX|----|||--XXXXXXXXXX-||||-----XXXXXXXXXXXXXXXXXXXXXXXXXXXXXXXXXXX--XX---|--|||||XXXXXXXXXXXXXXXXXXXX-----XXXXX
