------------------------------------------------------------------------------------------------------------------------------------------------------
------------------------------------------------------------------------------------------------------------------------------------------------------
------------------------------------------------------------------------------------------------------------------------------------------------------
----------------------------------------------------------------------SSSSSSSSSS----------------------------------------------------------------------
------------------------------------------------------------------------------------------------------------------------------------------------------
--------------------------------------------------------------------------------------------oo--------------------------------------------------------
------------------------------------------------------------------------------------y------------------------@------------------------------SSS-------
------------------------------------------------------------------------------TT--#SSS----------------------------------------------------------------
------------------------------------------------------------------------------TT-##----------------%---------------------------------g#---------------
------------------------------------------------------------------------------TT###1------------------------------------------------g##----------SSSSS
-------------------%-------------------------------------tt----------T------SCTT###-------S---------SU----!--!----------------------###---------------
--------------------------------------K------------------tt----------T--TT----TT###--SSS-------------------------------------------####---------------
------------------------------TTTT-----------------------tt----------T--TT----TT###----------%%%%------------------B--------------#####-----SSS-------
-M-----------%%%%--------ggg--TTTT-------------y-----g-g-tt---ggg----T--TT---kTT###-----------||----------k--------b------kkk-----#####------------r--
XXXXXXXXXXX---||----XXXXXXXXXXXXXXXXXXXXXXXXXXXXXXXXXXXXXXXXXXXXXXXXXXXXXXXXXXXXXXXXXX---X----||----XXXXXXXXXXXXXXXXXXXXXXXXXXXXXXXXXXX--XXX-----XXXXX
XXXXXXXXXXX---||----XXXXXXXXXXXXXXXXXXXXXXXXXXXXXXXXXXXXXXXXXXXXXXXXXXXXXXXXXXXXXXXXXX---X----||----XXXXXXXXXXXXXXXXXXXXXXXXXXXXXXXXXXX--XXX-----XXXXX
