------------------------------------------------------------------------------------------------------------------------------------------------------
------------------------------------------------------------------------------------------------------------------------------------------------------
------------------------------------------------------------------------------------------------------------------------------------------------------
--------------------SSSSSSSSSS----------SSSSSSSSSSSSSSSSS---------------------------------------------------------------------------------------------
--------------------SSSSSSSSSS----------SSSSSSSS------------------------------------------------------------------------------------------------------
--------------------SSSSSSSSSS----------SSSCSSSS---------------------R--------------------------------------------------------------------------------
--------------------SSSSSSSSSS----------SSSSSSSS--QQ--------------------SSSSS--------------------------------R--------------------SS------------------
---------------------------------------------------------------------------------------------------------r------oooo----------------------------------
-----------------%%%---------------------------------------S----------------------TT----------------%%%%%%%-------------------------------------------
------------------||-----------------------ggg------------------------------------TT-----------oooo-||||||--------------SS-?Q-------------------------
------------------||--SSSSSS?-----------SSSSSSSS--QQ--QQQ--------%%%---------2----TT----------------||||||----T-------------------SS------------------
-------------%%%%%||--SSSSS-----------ttSSSSSSSS------------------|--------TT-----TT-----T----------||||||----T-------------------K---#----B----------
--------------|||-||--SSSSS-----------ttSSSSSSSS------------------|---t----TT--TT-TT-----T----------||||||----T----------------y------#----b-------F--
---M----------|||-||-------ooo--------ttSSSSSSSS------------------|---t----TT--TT-TT---k-T----------||||||--ooT---y--------SSSSS------#----B-------#--
XXXXXXXXXXX---|||-||-XXXXXXXXXXXXXXXXXXXXXXXXXXXXXXXXXXXX---%%%%%-|---XXXXXXXXXXXXXXXXXXXX%%%%%%%-%%||||||--%%XXXXXXXXXX-------XX-XXXXXXXXXXXXXXXXXXXX
XXXXXXXXXXX---|||-||-XXXXXXXXXXXXXXXXXXXXXXXXXXXXXXXXXXXX----|||--|---XXXXXXXXXXXXXXXXXXXX||||||---|||||||---|XXXXXXXXXX-------XX-XXXXXXXXXXXXXXXXXXXX
