------------------------------------------------------------------------------------------------------------------------------------------------------
------------------------------------------------------------------------------------------------------------------------------------------------------
------------------------------------------------------------------------------------------------------------------------------------------------------
----------------------------------------------------------------------SSSSSSSSSSSSSSSSSSSL------------------------------------------------------------
----------------------------------------------------------------------------SSSS----------------------------------------------------------------------
----------------------ooor-----------------------------------------------g--SSSS----------------------------------------------------------------------
---------------------%%%%%----S---------------QQQQ-------Q-Q------------SS----------oooooo----------------2--------------------SSS!S---------QQQQ-----
----------------------|||-----------------------------------------------SS----------------------------------------------------------------------------
----------------------|||-----------------------------------------------SS----------SSSSSS------------------------------------------------------------
----------------------|||-----------------------k-----------------------SC--g-g-----SSSSSS-o--------o---------------------------K--------------y------
--------------------%%%%%%%---##--SSC---T-----?QQQ-------Q-Q------------SS--SSSS-----------------TT-------2--------------------SSSS------#--Q?SSQQQ---
-----------------K--||||||--------------T--------------------------------------------------------TT------------#------------------------##------------
------------B-------||||||--o-----------T--------------------------------------------------------TT------------#---------TT------------###------------
-M----------b-------||||||-%%%----------T--------------------y-----------------------------------TT-----y--y---#----ggg--TT-----------####------------
XXXXXXXXXXXXXXXXXXXX||||||--|-XX--XXXXXXXXXXXXXXXXXXXXXXXXXXXXXXXXXXXXXXXXXXXXXX---XXXXXXXXXXXXXXXXXXXXXXXXXXX-XXXXXXXXXXXXXXXXXXXXXXXXXXXXXXX--XXXXXX
XXXXXXXXXXXXXXXXXXXX||||||--|-XX--XXXXXXXXXXXXXXXXXXXXXXXXXXXXXXXXXXXXXXXXXXXXXX---XXXXXXXXXXXXXXXXXXXXXXXXXXX-XXXXXXXXXXXXXXXXXXXXXXXXXXXXXXX--XXXXXX
