------------------------------------------------------------------------------------------------------------------------------------------------------
------------------------------------------------------------------------------------------------------------------------------------------------------
------------------------------------------------------------------------------------------------------------------------------------------------------
---------------------------------------------------oo-------------------------------------------------------------------SSSSSSSSSS--------------------
--------------------------------------------------%%%%------------------------------------------------------------------------------------------------
----------------------ooor-------------------------||-----------------------------------oo-------------------------k----------------------------------
---------------------%%%%%-------------------------||----------------------g----oo----------------------------S---SSSSSS----------%-------------------
----------------------|||--------------------------||--SSS-------------%%%%%%---------------------oo--------------------------------------------------
----------------------|||--------------------------||-------------------||||------------------------------------------------------------SSS-----------
----------------------|||--------------------------||-------------------||||-----SSS------------------------------------------------------------------
---------Q----------%%%%%%%------------------------||-------------------||||-------------S----------------------------------------%%%%%---------------
-----------------K--||||||-------------------------||-------------------||||--------------------#-------------------------SS-------|||----------------
------------B-------||||||--o---------------------%||-------------------||||--------------------#---------*---TT----------SS-------|||-------------F--
------------b-------||||||-%%%----k-k----------y---||-------gg-------g--||||--------------------#---gg----*---TT----------SS-------|||-------------#--
XXXXXXXXXXXXXXXXXXXX||||||--|-XXXXXXXXX-XXXXXXXXXX-||-------XXXXXXXXXX--||||--------------XXXXXXXXXXXXXXXXXXX-XXXXXXXX----XX--XXXX%|||------XXXXXXXXXX
XXXXXXXXXXXXXXXXXXXX||||||--|-XXXXXXXXX-XXXXXXXXXX-||-------XXXXXXXXXX--||||--------------XXXXXXXXXXXXXXXXXXX-XXXXXXXX----XX--XXXX-|||------XXXXXXXXXX
