------------------------------------------------------------------------------------------------------------------------------------------------------
------------------------------------------------------------------------------------------------------------------------------------------------------
------------------------------------------------------------------------------------------------------------------------------------------------------
----------SSSSSSSSSS--------------------------------------------------------------------------------------------------------------SSSSSSSSSS----------
------------------------------------------------------------------------------------------------------------------------------------------------------
-------------------------------------------------------oooo-------------------------------------------------------------------------------------k-----
----------------------!--------------------------------%%%%-------------SSSSS--------SSSS---------------SSQSSS?SSS------SS---------------------SQS--SQ
--------------------------------------------------------||--------------------------------------------------------------------------------------------
--------------------------------------------------------||-----------o--------------------------------------------------------------------------------
--------------------------------------------------SSS---||-------y--------------------------------oo------K----------------TT-------------------------
---------Q----------S@S!S-------------------------------||-------##----------2--Q-----------------------SSSSSSSSSSS--------TT------------------SQS--S?
--------------------------------------tt-----K---B----U-||------###--------TT------------------TT-----------------------t--TT-------------TT----------
----------------------------tt--------tt---------b------||-----####---t----TT--T---------------TT-----------------------t--TT------tt-----TT----------
-M-------------------g------tt--------tt---------B------||----#####---t----TT--T-ggg--------y--TT---------------K-------t--TT------tt----kTT-k------gg
XXXXXXXXXXX--XX--X--XXXXXXXXXXXXXXXXXXXXXXXXXXXXXX----%%%%%-XXXXXXX---XXXXXXXXXXXXXXX----XXXXXXXXXXXXXXXXXXXXXXXXXXXXXXXXXXXXXXXXXXXXXXXXXXXXXXXXXXXXX
XXXXXXXXXXX--XX--X--XXXXXXXXXXXXXXXXXXXXXXXXXXXXXX-----|||--XXXXXXX---XXXXXXXXXXXXXXX----XXXXXXXXXXXXXXXXXXXXXXXXXXXXXXXXXXXXXXXXXXXXXXXXXXXXXXXXXXXXX
