------------------------------------------------------------------------------------------------------------------------------------------------------
------------------------------------------------------------------------------------------------------------------------------------------------------
------------------------------------------------------------------------------------------------------------------------------------------------------
----------SSSSSSSSSS--------------------------------------------------------------------------------SSSSSSSSSS----------------------------------------
------------------------------------------------------------------------------------------------------------------------------------------------------
------------------------------------------------------------------------------------------------------------------------------------------------------
----------------------!-------S-------------------------------USSS------------------y-----SSS------%------------------US--SSC------------##-SS--------
----------------------------------------------------------------------------------#SSS---------------------------------------------------##-----------
---------------------------------------------------------TT----------------------##----------------------------------------------------####-----------
---------------------------------------------------TT----TT---------------------###1--------------------------------E-----SSS----------####-----------
--------------------S@S!S-----##--SSC--------------TT----XX--S-----TT-----------###---------%%%------------TT------TT----------------######-SS--------
---------------------------------------------------TT--------------TT-----------###--SSS-----|----------#--TT------TT--t-------------######-------#-TT
----------------------------tt---------------------TT--------------TT-----------###----------|---------##--TT------TT--t-------------######------##-TT
-M-------------------g------tt-----------------ggg-TT--------ggg---TT-gg--------###----------|------kk-##--TT---g--TT--t---------#---######-----###-TT
XXXXXXXXXXX--XX--X--XXXXXXXXXXXX--XXXXXX-XXXXXXXXXXXXXXXXXXXXXXXXXXXXXXXXXXXXXXXXXXXXX---X---|------XXXXX--XX-XXXXXXXXXXX----XXXXXXXXXXXXXXXXXXXXXX-XX
XXXXXXXXXXX--XX--X--XXXXXXXXXXXX--XXXXXX-XXXXXXXXXXXXXXXXXXXXXXXXXXXXXXXXXXXXXXXXXXXXX---X---|------XXXXX--XX-XXXXXXXXXXX----XXXXXXXXXXXXXXXXXXXXXX-XX
