------------------------------------------------------------------------------------------------------------------------------------------------------
------------------------------------------------------------------------------------------------------------------------------------------------------
------------------------------------------------------------------------------------------------------------------------------------------------------
S-----SSSS----------SSSSSSSSSS------------------------------------------------------------------------------------------------------------------------
S-----------------------------------------------------------------------------------------------------------------------------------------------------
S-----------------------------------------------------------------------------------------------------------------------------------------------------
S----------------------------------------------------------------------------------USS------------------------------------oo---%%%-SSSS---------------
S-------------------------------------------------------------------------------------------------oo-------------SSS------SS----||--------------------
S----------------g----------------------------------------------------o---------------------------------------------------------||--------------------
S----------------#-----------C---------------------------o----------------------------------------------------------------------||-----SSSS-----------
S---------S-----##-----#-#-----TT------------------------------------#------------#------------------------------------------SS-||--------------------
S--------------###---#-#-#-#---TT-----------------------------------##--------#---#-------------#-----TT------------------------||--------------------
S-------------####---#-#-#-#---TT---------------------------TT-----###-------##---##------------#-----TT----TT------------------||-----------------F--
S--M---------#####---#-#-#-#-EgTT--------------y----k-------TT----####------------##--gg--------#-----TT-k--TT------------------||-----------------#--
XXXXXXXXXXXXXXXXXXXXXXXXXXXXXXXXXXXXXX--XXXXXXXXXX-XXXXXXXXXXXXXXXXXXXXXXXXXXXXX--XXXXXXXXXXXXXXXXXXXXXXXXXXXX%%%%----%%%%-----%%%---------XXXXXXXXXXX
XXXXXXXXXXXXXXXXXXXXXXXXXXXXXXXXXXXXXX--XXXXXXXXXX-XXXXXXXXXXXXXXXXXXXXXXXXXXXXX--XXXXXXXXXXXXXXXXXXXXXXXXXXXX|||------||-------||---------XXXXXXXXXXX
