------------------------------------------------------------------------------------------------------------------------------------------------------
------------------------------------------------------------------------------------------------------------------------------------------------------
------------------------------------------------------------------------------------------------------------------------------------------------------
----------------------------------------------------------------------SSSSSSSSSSSSSSSSSSSL------------------------------------------------------------
----------------------------------------------------------------------------SSSS----------------------------------------------------------------------
-------------------------------------------------------oooo--------------g--SSSS------------oo--------oo----------------------------------------------
---------------------LSSS------------------------------%%%%-------------SS----------oooooo-------------------------oo------------------US-------------
--------------------------------------------------SSSS--||--------------SS------------------------------------------------------oo--------------------
--------------------------------------------------------||-----------o--SS----------SSSSSS---------%--------------------------------------------------
--------------------------------------------------------||-------y------SC--g-g-----SSSSSS-------------------------------------------SS---------------
---------QQ----------2-----#---TT-----------------------||-------##-----SS--SSSS----------SS-------------------%%%%--%%%-----TT------------S--#LSS----
---------------------------#---TT---------------------U-||------###---------------------------------------------||----||-----TT---------------#-------
---------------------------##--TT-----------------------||-----####--------------------------%%%%-----------tt--||----||-----TT---TT----------#-------
-------------------#--kk---##-gTT--------------y--------||----#####---------------------------||------ggg---tto-||----||-y---TT---TT--------kk#-------
XXXXXXXXXXXXX--XXXXXXXXXXXXXXXXXXXXXXX--XXXXXXXXXX----%%%%%-XXXXXXX---XXXXXXXXXX---XXXXXXX----||----XXXXXXXXXX%-||----||XXXXXXXXXXXXXXXX-X-XXXXXXXX---
XXXXXXXXXXXXX--XXXXXXXXXXXXXXXXXXXXXXX--XXXXXXXXXX-----|||--XXXXXXX---XXXXXXXXXX---XXXXXXX----||----XXXXXXXXXX--||----||XXXXXXXXXXXXXXXX-X-XXXXXXXX---
