------------------------------------------------------------------------------------------------------------------------------------------------------
------------------------------------------------------------------------------------------------------------------------------------------------------
------------------------------------------------------------------------------------------------------------------------------------------------------
--------------------------------oo----------------------------------------------------------------------------SS-------S------------------------------
---------------------------------------g--------------------------------------------------------------------------------------------------------------
-----------------------------------%%%%%--------------------------------------------------------------------------------------------------------------
--------------------S---------------||||------QQQQ-------------------------g-------o--o--------------------------------S------------------------------
---------------------------TT-------||||-------------------------------%%%%%%---------------------oo--------------------------------------------------
-----------------g---------TT-------||||--------------------------------||||---------------------------------------SSS-------SSS----------------------
-----------------#---------XX-%%%%%-||||--------k-----------------------||||-------SSSS---------------------------------------------------------------
----------S-----##-----TT------|||--||||T-----?QQQ----S-----------------||||-------------------------------------------Sr-----------------------------
---------------###-----TT------|||--||||T---------TT-----------------T--||||--------------------#-----------g--##-------%%%%%%-------TT---------------
--------------####-----TT------|||--||||T---------TT---------B-------T--||||----%%%-------------#-----------TT-##-------|||||--------TT------------F--
-M-----------#####--k--TT------|||--||||T---------TT------k--b-------T--||||----||--------------#-----------TT-##-------|||||--------TT------------#--
XXXXXXXXXXXXXXXXXXXXXXXXXXXXXX-|||--||||XXXXXXXXXXXXXXXXXXXXXXXXXX--XX--||||----||--------XXXXXXXXXX--XXXXXXXX-XX------X|||||-----XXXXXXXXXXXXXXXXXXXX
XXXXXXXXXXXXXXXXXXXXXXXXXXXXXX-|||--||||XXXXXXXXXXXXXXXXXXXXXXXXXX--XX--||||----||--------XXXXXXXXXX--XXXXXXXX-XX------X|||||-----XXXXXXXXXXXXXXXXXXXX
