------------------------------------------------------------------------------------------------------------------------------------------------------
------------------------------------------------------------------------------------------------------------------------------------------------------
------------------------------------------------------------------------------------------------------------------------------------------------------
----------SSSSSSSSSS--------------------SSSSSSSSSS------------------------------ooo-------------------------------------------------------------U-----
----------------------------------------SSSSSSSS--------------------------------%%%-------------------------------------------------------------------
----------------------------------------SSSCSSSS---------------------------------|--------------------------------------------------------------------
--------------------USS-----------------SSSSSSSS---------------------------------|----------------------------?SSS-----------------SSSS---------------
-------------------------------------------------------------o---o---o-----------|------------------oo--------------------------------------------SS--
---------------------------------------------------------B--%%%-%%%-%%o----------|--------------------------------------------------------------------
-------------------------------------------ggg-----------b---|---|---|-----------|---%%%%------oooo------------------------------------SSSS---SS------
----------@QQQQ-------------------------SSSSSSSS-------SS#CS-|---|---|-----------|----||---------------------TSSSSS----------------------------------#
---------------------B----------------ttSSSSSSSS-------------|---|---|--------#-%%%%%%||---------------------T--------------------------------------##
-----------------g-#-b-------B--------ttSSSSSSSS-----------K-|---|---|-------##--||||-||---------------------T-------------------------------------###
-M--------------g#-#-B-------b--------ttSSSSSSSS-------------|---|-r-|-----------||||-||------------------y--T--K--------k----ggg-----------------####
XXXXXXXXXXXXXXXXXXXXXXXXXXXXXXXXXXXXXXXXXXXXXXXXXXXXXXXXXXXX%%%%%%%%%%XXXXXXXXXX-||||-||%%%%%%%%%-%%XXXXXXXXXXXXXXXXXXXXXXXXXXXXXX---------XXXXXX-XXXX
XXXXXXXXXXXXXXXXXXXXXXXXXXXXXXXXXXXXXXXXXXXXXXXXXXXXXXXXXXXX-|||||||||XXXXXXXXXX-||||-||-|||||||---|XXXXXXXXXXXXXXXXXXXXXXXXXXXXXX---------XXXXXX-XXXX
