------------------------------------------------------------------------------------------------------------------------------------------------------
------------------------------------------------------------------------------------------------------------------------------------------------------
------------------------------------------------------------------------------------------------------------------------------------------------------
----------SSSSSSSSSS---oo-------oo--------------------------------------------------------SSSSSSSSSS--------------------------------------------------
-------------------------------------g-g--------------------------------------------------------------------------------------------------------------
-----------------------------------%%%%%%%-------------oooo----------R------------g-------------------------------------------------------------k-----
----------------------SSSS----------|||||--------------%%%%---------------------SSSSSSSS----------------SSQSSS--------US----------SS-----------SQS--SQ
------------------------------------|||||----oo---------||--------------------------------------------------------------------------------------------
------------------------------------|||||---------------||--------------------------------------------------------------------SSS---------------------
------------------------------%%%%%-|||||---------SSS---||------------------------------------------------K---------E---------------------------------
--------------------------%%%%-|||--|||||---------------||-------%%%------------------------------------SSSSSS-----TT---%---------SS-----------SQS--S?
---------------------------|||-|||--|||||-------------U-||--------|------------------------------------------------TT--t----------K---#----B----------
---------------------------|||-|||--|||||---------------||--------|------------------------------------------------TT--t--------------#----b----------
-M-------------------------|||-|||--|||||---------------||--------|---gg------------------------g-g-------------g--TT--t---------r----#----B-k------gg
XXXXXXXXXXX--XX--X--%%%----|||-|||--|||||----%%%%-----%%%%%-%%%%%-|---XXXXXXXXXXXXXXXX---XXXXXXXXXXXXXXXXXXXXXXXXXXXXXXX----XXXXXXXXXXXXXXXXXXXXXXXXXX
XXXXXXXXXXX--XX--X--||-----|||-|||--|||||-----||-------|||---|||--|---XXXXXXXXXXXXXXXX---XXXXXXXXXXXXXXXXXXXXXXXXXXXXXXX----XXXXXXXXXXXXXXXXXXXXXXXXXX
