------------------------------------------------------------------------------------------------------------------------------------------------------
------------------------------------------------------------------------------------------------------------------------------------------------------
------------------------------------------------------------------------------------------------------------------------------------------------------
------------------------------------------------------------------------------------------------------------------------------------------------------
------------------------------------------------------------------------------------------------------------------------------------------------------
----------------------------------------ooooo-------------------------------------g-------------------------------------------------------------------
--------------------USS---------------------------------------------------SSCSS-SSSSSSSS----------------------------------SSC-----!S------------------
------------------------------------------------SS------------------------------------------------oo------TT------------------------------------------
-----------------------------------------SSSS------------------------o------------------------------------TT-----------y------------------------------
-----------------------------------oo----------------------------y----------------------------------------TT-----------X--SSS-------------------------
----------------------------------o--o----------------S----------##-----QQQQ--QQ-------------------------SXXS---------XX----------S------#----#LSS----
---------------------B----------------------------TT------------###-----------------------------#--------------------XXX----------------##----#-------
---------------------b-------B--------------%%%%%-TT-----------####-----------------------------#---TT--------------XXXX---------------###----#-------
-M--------k---ggg----B-------b---------------|||--TT------k---#####-----------------------------#---TT-------------XXXXX---------#----####--kk#-------
XXXXXXXXXXXXXXXXXXXXXXXXXXXXXXXXXXXXXXXX%%---|||--XXXXXXXXXXXXXXXXX---XXXXXXXXXXXXXXXX---XXXXXXXXXXXXXXXXXXXXXXXXXXXXXXXX----XXXXXXXXXXXXXXXXXXXXXX---
XXXXXXXXXXXXXXXXXXXXXXXXXXXXXXXXXXXXXXXX|----|||--XXXXXXXXXXXXXXXXX---XXXXXXXXXXXXXXXX---XXXXXXXXXXXXXXXXXXXXXXXXXXXXXXXX----XXXXXXXXXXXXXXXXXXXXXX---
