------------------------------------------------------------------------------------------------------------------------------------------------------
------------------------------------------------------------------------------------------------------------------------------------------------------
------------------------------------------------------------------------------------------------------------------------------------------------------
----------------------------------------------------------------------SSSSSSSSSS----------------------------------------------------------------------
------------------------------------------------------------------------------------------------------------------------------------------------------
-------------------------------------------------------oooo-------------------------------------------------------------------------------------------
------------------------------S------------------------%%%%--------------------------1----------------------------------------------------------------
--------------------------------------------------SSSS--||--------------------TT---------------------------------SSS---------------------------y------
--------------------------------------------------------||--------------------TT-------------------------------------------------------------#SS--o---
--------------------------------------------------------||------1-------------TT-----------------------------------------------SSS----------##--------
----------Q-----------------TT##--SSC-------------------||------------------SCTT---QQQQ----------tt---%%%%%%------------%-------------------##--SC----
----------------------------TT------------------------U-||--------------TT----TT----------T------tt----||||---------------------------------##--------
----------------------------TT--------------------------||--------------TT----TT----------T------tt----||||---------------------------------##---SSS--
-M-----------------#----ggg-TT-----------------y--------||--------------TT---kTT----yy----T------tt----||||----------------------rk---------##--------
XXXXXXXXXXXXX--XXXXXXXXXXXXXXXXX--XXXXXXXXXXXXXXXX----%%%%%-XXXXXXXXX-XXXXXXXXXXXXXXXXXXXXXXXXXXXXXX%%-||||-%%%%%%----%%----XXXXXXXX---XXXXXXX------XX
XXXXXXXXXXXXX--XXXXXXXXXXXXXXXXX--XXXXXXXXXXXXXXXX-----|||--XXXXXXXXX-XXXXXXXXXXXXXXXXXXXXXXXXXXXXXX|--||||--||||------|----XXXXXXXX---XXXXXXX------XX
