------------------------------------------------------------------------------------------------------------------------------------------------------
------------------------------------------------------------------------------------------------------------------------------------------------------
------------------------------------------------------------------------------------------------------------------------------------------------------
------------------------------------------------------------------------------------------------------------------------------------------------------
------------------------------------------------------------------------------------------------------------------------------------------------------
----------------------ooor----------------------------------------------------------------------------------------------------------------------------
---------------------%%%%%------------------------------------------------------------------------------------?SSS-----------------SSSS------QQQQ-----
----------------------|||---------------------------------------------------------------------------------TT------------------------------------------
-----------------g----|||--------------------------------------------o------------------------------------TT-----------------SSS----------------------
-----------------#----|||----------------------------------------y-------1--------o--------o--------------TT---------------------------SSSS----y------
--------SUS-----##--%%%%%%%-------------------tt-----------------##---T----------------TT--------TT------SXXS-SSSSS-----r-------------------Q?SSQQQ---
---------------###--||||||-------------T------tt----K-----------###---T----TT----------TT--------TT---------------------%%%%%%------------------------
--------------####--||||||--o----------T------tt---------------####---T----TT----------TT--------TT-TT------------------|||||-------------------------
--M----------#####--||||||-%%%-------kkT-g----tt-----------g--#####---T---kTT----------TT--------TT-TT----------K-------|||||-------------------------
XXXXXXXXXXXXXXXXXXXX||||||--|-XXXXXXXXXXXXXXXXXXXXXXXXXXXXXXXXXXXXX---XXXXXXXXXXXXXXXXXXXXXXXXXXXXXXXXXXXXXXXXXXXXXXXXXX|||||--------------XXX--XXXXXX
XXXXXXXXXXXXXXXXXXXX||||||--|-XXXXXXXXXXXXXXXXXXXXXXXXXXXXXXXXXXXXX---XXXXXXXXXXXXXXXXXXXXXXXXXXXXXXXXXXXXXXXXXXXXXXXXXX|||||--------------XXX--XXXXXX
