------------------------------------------------------------------------------------------------------------------------------------------------------
------------------------------------------------------------------------------------------------------------------------------------------------------
------------------------------------------------------------------------------------------------------------------------------------------------------
--------------------SSSSSSSSSS------------------------------------------------------------SSSSSSSSSS--------------------------------------------------
--------------------SSSSSSSSSS------------------------------------------------------------------------------------------------------------------------
--------------------SSSSSSSSSS-------------------------------------------------------------------------------------k----------------------------------
--------------------SSSSSSSSSS----------------QQQQQ--------------------------------o--o-----------------------S---SSSSSS----------SS---------QQQQ-----
------------------------------------------------------------------------------------------------------------------------------------------------------
-----------------------------------------------------------------------------------------------------------------------------SSS----------------------
------------------------------------------------k----------------------------------SSSS--------------------------------------------------------y------
-----SSS--------------SSSSSS?-----------T-----?QQQQ------------------#--------------------------------%%%%%%------------r---------SS--------Q?SSQQQ---
----------------------SSSSS-----------ttT---------------------------##---------------------------------||||-------------%%%%%%----K---#----B----------
----------------------SSSSS-----------ttT-------------------TT-----###----------%%%--------------------||||---TT--------|||||---------#----b----------
--------------k-ggg--------ooo--------ttT------------gg----kTT----####----------||--------------g-g----||||---TT--------|||||---------#----B----------
XXXXXXXXXXXXXXXXXXXX-XXXXXXXXXXXXXXXXXXXXXXXXXXXXXXXXXXXXXXXXXXXXXXXXXX----XXXXX||--------XXXXXXXXXX%%-||||-%%XXXXXXXX--|||||-----XXXXXXXXXXXX--XXXXXX
XXXXXXXXXXXXXXXXXXXX-XXXXXXXXXXXXXXXXXXXXXXXXXXXXXXXXXXXXXXXXXXXXXXXXXX----XXXXX||--------XXXXXXXXXX|--||||--|XXXXXXXX--|||||-----XXXXXXXXXXXX--XXXXXX
