------------------------------------------------------------------------------------------------------------------------------------------------------
------------------------------------------------------------------------------------------------------------------------------------------------------
------------------------------------------------------------------------------------------------------------------------------------------------------
----------SSSSSSSSSS------------oo--------------------------------------------------------------------------------------------------------------------
---------------------------------------g--------------------------------------------------------------------------------------------------------------
-----------------------------------%%%%%------------------------------------------------oo------------------------------------------------------------
------------------------------------||||------QQQQ------------------------------oo----------------------------------------------------------SSS-------
------------------------------------||||------------------------------------------------------------oo------------------------------------------------
------------------------------------||||-----------------TT-------------------------------------------------------------------------------------------
------------------------------%%%%%-||||--------k--TT----TT----------------------SS---------------oo---------------------------------------------SSSSS
--------------------SS---------|||--||||T-----?QQQ-TT----XX------------------------------S-------------------T----------------------------------------
---------------------K---TT----|||--||||T----------TT----------------T-------------------------TT------------T----------------------------------------
-------------------------TT----|||--||||T----------TT--------B-------T-------------------------TT------------T------------------------------SSS-------
---M---------------------TT----|||--||||T----------TT--------b-------T----------------------y--TT---------y--T-k----kkk---kkk-----k----------------r--
XXXXXXXXXXX--XX--X--XXXXXXXXXX-|||--||||XXXXXXXXXXXXXXXXXXXXXXXXXX--XXX----XXXXX----------XXXXXXXXXXXXXXXXXXXXXXXXXXXXXXXXXXXXXXXXXX---XXXXX-----XXXXX
XXXXXXXXXXX--XX--X--XXXXXXXXXX-|||--||||XXXXXXXXXXXXXXXXXXXXXXXXXX--XXX----XXXXX----------XXXXXXXXXXXXXXXXXXXXXXXXXXXXXXXXXXXXXXXXXX---XXXXX-----XXXXX
