------------------------------------------------------------------------------------------------------------------------------------------------------
------------------------------------------------------------------------------------------------------------------------------------------------------
------------------------------------------------------------------------------------------------------------------------------------------------------
S-----SSSS-------------oo---------------------------------------------------------------------------------------------------------SSSSSSSSSS----------
S-----------------------------------------------------------------------------------------------------------------------------------------------------
S------------------------------------------------------oooo--------------------------------------------------------k----------------------------------
S---------------------SSSS-----------------------------%%%%-------SSoo------SSSS-----1------------------SSQSSSS---SSSSSSSSS---------------------------
S-------------------------------o----ooo----------SSSS--||--------------------------------------------------------------------------------------------
S-------------------------------------------------------||--------------------------------------------------------------------------------------------
S-----------Q--?----------------------------------------||-------------------K----------------------------K-------------------------------------------
S------------------S------%%%%--------%%----------------||--%%%%%%---------SSSSS---QQQQ---------TT------SSSSSS----------------------------------------
S--------------------------|||---------|--------------U-||---||||-----T-------------------------TT----------------------------------------TT----------
S--------------------------|||---------|----------------||---||||-----T-------------------------TT------------TT--------------TT---tt-----TT-------F--
S--M--------------K--------|||-%%%%%%%-|----------------||---||||-----T-------------yy------k---TT------------TT--------------TT---tt----kTT-------#--
XXXXXXXXXXXXXXXXXXXX%%%----|||--|||||--|X-XX-XX-XX----%%%%%--||||-----XXXXXXXXXXXXXXXXXXXXXXXXXXXXXXXXXXXXXXXXXXXXXXXX------XXXXXXXXXXXXXXXXXXXXXXXXXX
XXXXXXXXXXXXXXXXXXXX||-----|||--|||||--|X-XX-XX-XX-----|||---||||-----XXXXXXXXXXXXXXXXXXXXXXXXXXXXXXXXXXXXXXXXXXXXXXXX------XXXXXXXXXXXXXXXXXXXXXXXXXX
