------------------------------------------------------------------------------------------------------------------------------------------------------
------------------------------------------------------------------------------------------------------------------------------------------------------
------------------------------------------------------------------------------------------------------------------------------------------------------
------------------------------------------------------------SSSSSSSSSS------------------------------------------------------------SSSSSSSSSS----------
------------------------------------------------------------SSSS--SSSS---o----------------------------------------------------------------------------
------------------------------------------------------------SSSS--SSSS--%%%-----K---------------------------------------------------------------------
------------------SC-------------------------------------Q-Q--SS---S-----|--o---SS----1-------------------2-------------------------------------------
--------------------------------------------------------------SS---S-----|--SSSS------------------oo--------------------------------------------------
--------------------------------------------------------------SS---S--%--|---------------------------------------------y------------------------------
------------------------------------------------------------ooSS---SoU---|--------------------------o------------------X------------------------------
--------------TT---2--------TT-TT------------------------Q-QSSSS---SSS---|------SS------------------------2-----------XX------------------------------
--------------TT------------TT-TT----------------------------------------|------------TT--------#--------------------XXX------------------TT----------
--------------TT------------TT-TT----------------------------------------|-----%------TT--------#-------------------XXXX-----------tt-----TT-------F--
-M------------TT--------ggg-TTgTT--------------y------------k--g-g-------|------------TT--------#-------y--y-------XXXXX--kkk------tt----kTT-------#--
XXXXXXXXXXXXXXXXXXXXXXXXXXXXXXXXXXXXXX--XXXXXXXXXXXXXXXXXXXXXXXXXXXXXX%%%%%%----XXXXXXXXXXXXXXXXXXXXXXXXXXXXXXXXXXXXXXXXXXXXXXXXXXXXXXXXXXXXXXXXXXXXXX
XXXXXXXXXXXXXXXXXXXXXXXXXXXXXXXXXXXXXX--XXXXXXXXXXXXXXXXXXXXXXXXXXXXXX|||||-----XXXXXXXXXXXXXXXXXXXXXXXXXXXXXXXXXXXXXXXXXXXXXXXXXXXXXXXXXXXXXXXXXXXXXX
