------------------------------------------------------------------------------------------------------------------------------------------------------
------------------------------------------------------------------------------------------------------------------------------------------------------
------------------------------------------------------------------------------------------------------------------------------------------------------
----------SSSSSSSSSS----------------------------------------------------------------------------------------------------SSSSSSSSSS--------------------
------------------------------------------------------------------------------------------------------------------------------------------------------
------------------------------------------------------------------------------------------------------------------------------------------------------
----------------------!--------------------------------------------------------------SSSS------------------------------------------------##-SS--------
-----------------------------------------------------------------------------------------------------------------------------------------##-----------
---------------------------------------------------------------------o-----------------------------------------------------------------####-----------
-----------------------------------------------------------------y---------------------------------------------------------------------####-----------
--------SU----------S@S!S-----------------------------S----------##-------------Q----------------------------------------------------######-SS--------
--------------------------------------tt----------TT------------###--------------------------------------------#----------SS---------######-------#-TT
----------------------------tt--------tt----------TT-----------####------------------------------B--------*----#----------SS---------######------##-TT
--M------------------g------tt--------tt-------gggTT------k---#####---gg---------ggg-------------b--gg----*----#----ggg---SS---------######-----###-TT
XXXXXXXXXXX--XX--X--XXXXXXXXXXXXXXXXXXXX-XXXXXXXXXXXXXXXXXXXXXXXXXX---XXXXXXXXXXXXXXX----XXXXXXXXXXXXXXXXXXXX--XXXXXXXXX--XX--XXXXXXXXXXXXXXXXXXXXX-XX
XXXXXXXXXXX--XX--X--XXXXXXXXXXXXXXXXXXXX-XXXXXXXXXXXXXXXXXXXXXXXXXX---XXXXXXXXXXXXXXX----XXXXXXXXXXXXXXXXXXXX--XXXXXXXXX--XX--XXXXXXXXXXXXXXXXXXXXX-XX
