------------------------------------------------------------------------------------------------------------------------------------------------------
------------------------------------------------------------------------------------------------------------------------------------------------------
------------------------------------------------------------------------------------------------------------------------------------------------------
S-----SSSS------------------------------SSSSSSSSSS-----------------SSSSSSSSSSSSS----------------------------------------------------------------U-----
S---------------------------------------------------------------------------SSSS----------------------------------------------------------------------
S-------------------------------------oo---------------------------------g--SSSS--g-------------------------------------------------------------------
S-----------------Q----------------SSSS--oooo-------------------CSS-----SS------SSSSSSSS----------------SSQSSS------------SSC-------------------------
S-----------------------------------------------------------------------SS------------------------------------------------------------------------SS--
S----------------------------------------SSSS-U-------------SS--2-------SS----------------------------------------------------------------------------
S---------------------------------------oS--SoS----------o-----2-2------SC--g-g---------------------------K---------------SSS-----------------SS------
S-----------------?-----------%---------SS--SSS-------------------2-----SS--SSSS----------------TT------SSSSSS---------------------------------------#
S-------------TT--------------------------------------------------------------------------------TT--------------------------------------------------##
S-------------TT--------------------------------------------------------------------------------TT-------------------------------------------------###
S-------------TT---------ggg--------------kk--------k---------------------------------------k---TT-------------k----kkk----------#----------------####
XXXXXXXXXXXXXXXXXXXXXXXXXXXXXX--%%%%--%%XXXXXXXXXX-XXXXXXXXX---XXXXXXXXXXXXXXXXXXXXXXX---XXXXXXXXXXXXXXXXXXXXXXXXXXXXXXXX----XXXXXXXXXXXXXXXXXXXX-XXXX
XXXXXXXXXXXXXXXXXXXXXXXXXXXXXX---||----|XXXXXXXXXX-XXXXXXXXX---XXXXXXXXXXXXXXXXXXXXXXX---XXXXXXXXXXXXXXXXXXXXXXXXXXXXXXXX----XXXXXXXXXXXXXXXXXXXX-XXXX
