------------------------------------------------------------------------------------------------------------------------------------------------------
------------------------------------------------------------------------------------------------------------------------------------------------------
------------------------------------------------------------------------------------------------------------------------------------------------------
--------------------SSSSSSSSSS------------------------------------------------------------------------------------------------------------------------
------------------------------------------------------------------------------------------------------------------------------------------------------
----------------------------------------------------------------------------------------oo------------------------------------------------------------
--------------------------------------------------Q---------------------SSSSS---oo-------------------------------------------------------##-SS--------
----------------------------------------------------------------------------------------------------------TT-----------------------------##-----------
-----------------%%%--------------------------------------------------------------------------------------TT---------------------------####-----------
------------------||---------C----------------------------------1----------------SSS-------o--------------TT-------------------SSS-----####-----------
--------SU--------||---#-#-----TT-------------tt--Q--------------------------2-----------S-------TT------SXXS-----------%------------######-SS--------
-------------%%%%%||-#-#-#-#---TT-------------tt---------------------------TT--------------------TT------------#---------------------######-------#-TT
--------------|||-||-#-#-#-#---TT-------------tt----------------------t----TT--T-----------------TT-TT---------#---------------------######------##-TT
--M-----------|||-||-#-#-#-#-EgTT--------g----tt-----gg----k----------t----TT--T-----------------TT-TT---------#----ggg----------r---######-----###-TT
XXXXXXXXXXX---|||-||XXXXXXXXXXXXXXXXXX--XXXXXXXXXXXXXXXXXXXXXXXXXXXXX-XXXXXXXXXX----------XXXXXXXXXXXXXXXXXXXX-XXXXXXXXX----XXXXXXXXXXXXXXXXXXXXXXX-XX
XXXXXXXXXXX---|||-||XXXXXXXXXXXXXXXXXX--XXXXXXXXXXXXXXXXXXXXXXXXXXXXX-XXXXXXXXXX----------XXXXXXXXXXXXXXXXXXXX-XXXXXXXXX----XXXXXXXXXXXXXXXXXXXXXXX-XX
