------------------------------------------------------------------------------------------------------------------------------------------------------
------------------------------------------------------------------------------------------------------------------------------------------------------
------------------------------------------------------------------------------------------------------------------------------------------------------
--------------------------------oo--------------------------------------------------------------------------------------------------------------U-----
-------------------------------------g-g--------------------------------------------------------------------------------------------------------------
----------------------ooor---------%%%%%%%------------------------------------------------------------oo----------------------------------------------
------------------Q--%%%%%----------|||||-------------------------SSoo----SS-------o--o-----------------------?SSS--------oo---%%%--------------------
----------------------|||-----------|||||----oo---------------------------------------------------------------------------SS----||----------------SS--
----------------------|||-----------|||||----------------B----------------------------------------------------------------------||--------------------
----------------------|||-----%%%%%-|||||----------------b-------------------------SSSS-----------------------------------------||------------SS------
-----SSS----------?-%%%%%%%----|||--|||||--------------SS#CS%%%%%%----SS-----SS-------------------------------SSSSS----------SS-||-------------------#
--------------TT----||||||-----|||--|||||--------------------||||---------------------------------------------------------------||------------------##
--------------TT----||||||--o--|||--|||||------------------K-||||---------------%%%-------------------------tt------------------||-----------------###
--------------TT----||||||-%%%-|||--|||||--------------------||||---------------||-----------------g--ggg---tt--K---------------||k---------------####
XXXXXXXXXXXXXXXXXXXX||||||--|--|||--|||||----%%%%-XXXXXXXXXX-||||---------------||---------XXXXXXXXXXXXXXXXXXXXXXXXXXXXX%%-----%%%XX---XXXXXXXXXX-XXXX
XXXXXXXXXXXXXXXXXXXX||||||--|--|||--|||||-----||--XXXXXXXXXX-||||---------------||---------XXXXXXXXXXXXXXXXXXXXXXXXXXXXX|-------||XX---XXXXXXXXXX-XXXX
