------------------------------------------------------------------------------------------------------------------------------------------------------
------------------------------------------------------------------------------------------------------------------------------------------------------
------------------------------------------------------------------------------------------------------------------------------------------------------
---------------------------------------------------oo-----------------SSSSSSSSSSooo-------SSSSSSSSSS--------------------------------------------------
--------------------------------------------------%%%%--------------------------%%%------------------------------------------------------------------o
----------------------------------------ooooo------||---------g------------------|--------------------------------------------------------------------
---------------------------------------------------||---------SSSSS--------------|--------------------------------------------------------------------
------------------------------------------------SS-||--SSS--------------------TT-|------------------oo----------------------------oo------------SSS---
-----------------------------------------SSSS------||-------------------------TT-|----------------------------------------------------------oo--------
---------------------------------------------------||-------------------------TT-|---%%%%-------------------------------SS-?Q-------------------------
---------Q---------%-------------------------------||-----------------------SCTT-|----||---------------------T-----------------------------QSS--------
---------------------------------------------------||-------------------TT----TT%%%%%%||---------------------T----------------------------------------
--------------------------------------------%%%%%-%||---------TT-----t--TT----TT-||||-||---------------------T-----------------y----------------------
-------------%%%%--------ggg------k-k--------|||---||---------TT-----t--TT---kTT-||||-||--------g-g-------y--T-k----kkk----SSSSS----------------------
XXXXXXXXXXX---||----XXXXXXXXXXXXXXXXXXX-%%---|||---||-------XXXXXXXXXXXXXXXXXXXX-||||-||%%XXXXXXXXXXXXXXXXXXXXXXXXXXXXXX-------XX-XXXXXXXXXX----------
XXXXXXXXXXX---||----XXXXXXXXXXXXXXXXXXX-|----|||---||-------XXXXXXXXXXXXXXXXXXXX-||||-||-|XXXXXXXXXXXXXXXXXXXXXXXXXXXXXX-------XX-XXXXXXXXXX----------
