------------------------------------------------------------------------------------------------------------------------------------------------------
------------------------------------------------------------------------------------------------------------------------------------------------------
------------------------------------------------------------------------------------------------------------------------------------------------------
--------------------SSSSSSSSSS--oo------SSSSSSSSSS--------------------------------------------------------------------------------SSSSSSSSSS----------
-------------------------------------g-gSSSSSSSS--?---------------------------------------------------------------------------------------------------
-----------------------------------%%%%%SSSCSSSS--------------------------------K---------------------------------------------------------------------
------------------Q-----------------||||SSSSSSSS------------------SSoo----------SS----1-----------------SSQSSS----------------------------------------
------------------------------------||||----------SS--------------------------------------------------------------------------------------------------
------------------------------------||||---------------------------------------g----------------------------------------------------------------------
-----------------------------C%%%%%-||||---ggg------------------------------------------------------------K-------------------------------------------
------------------?----#-#-----|||--||||SSSSSSSS------------%%%%%%-----------S@SSS----------------------SSSSSS--------r-------------------------------
--------------TT-----#-#-#-#---|||--||||SSSSSSSS-------SSS---||||---------------------TT--------------------------%%%%%%------------------TT-------#--
--------------TT-----#-#-#-#---|||--||||SSSSSSSS-------------||||---------------------TT---------B-----------------|||||-----------tt-----TT---K---#--
-M------------TT-----#-#-#-#-E-|||--||||SSSSSSSS-------------||||---------------------TT---------b-----------------|||||-k----ggg--tt----kTT-------#--
XXXXXXXXXXXXXXXXXXXXXXXXXXXXXX-|||--||||XXXXXXXXXX-----------||||------XXXXXXXXXXXXXXXXXXXXXXXXXXXXXXXXXXXXXXX-%%%-|||||XXXXXXXXXXXXXXXXXXXXXXXXX--XXX
XXXXXXXXXXXXXXXXXXXXXXXXXXXXXX-|||--||||XXXXXXXXXX-----------||||------XXXXXXXXXXXXXXXXXXXXXXXXXXXXXXXXXXXXXXX--|--|||||XXXXXXXXXXXXXXXXXXXXXXXXX--XXX
