------------------------------------------------------------------------------------------------------------------------------------------------------
------------------------------------------------------------------------------------------------------------------------------------------------------
------------------------------------------------------------------------------------------------------------------------------------------------------
--------------------------------------------------------------------------------SSSSSSSSSS------------------------------------------------------------
-----------------------------------------g------------------------------------------------------------------------------------------------------------
----------------------ooor--------------%%------------------------------------------------------------------------------------------------------------
---------------------%%%%%--------------|---------------------USSS-----------------------------------------------------------------------##--QQQQ-----
----------------------|||---------------|----oo------------------------------------------------------------------------------------------##-----------
----------------------|||---------------|----------------------------------------------------------------------------------------------####-----------
------------Q--?------|||---------------|----------------------------------------------S----------oo-----------------------------------####----y------
-------------------S%%%%%%%------------T|--------------ooo---S-----TT-----------SU---------------------------------------------------######-Q?SSQQQ---
--------------------||||||-------------T|--------------------------TT---------------TT---t-----TT------------------------------------######-----------
--------------------||||||--o----------T|--------------------------TT---------------TT---t-----TT---------*--------B-----------------######-----------
---M--------------K-||||||-%%%--gg-----T|--------------------ggg---TT--------------kTT--kt--y--TT---gg----*--------b-----k----ggg----######-----------
XXXXXXXXXXXXXXXXXXXX||||||--|-XXXXXXXXXX|----%%%%---XXXXXXXXXXXXXXXXXXX----XXXXXXXXXXXXXXXXXXXXXXXXXXXXXXXXXX-XXXXXXXXXXXXXXXXXXXXXXXXXXXXXXXX--XXXXXX
XXXXXXXXXXXXXXXXXXXX||||||--|-XXXXXXXXXX|-----||----XXXXXXXXXXXXXXXXXXX----XXXXXXXXXXXXXXXXXXXXXXXXXXXXXXXXXX-XXXXXXXXXXXXXXXXXXXXXXXXXXXXXXXX--XXXXXX
