------------------------------------------------------------------------------------------------------------------------------------------------------
------------------------------------------------------------------------------------------------------------------------------------------------------
------------------------------------------------------------------------------------------------------------------------------------------------------
--------------------------------------------------SSSSSSS----------SSS--------------------------------------------------------------------------------
------------------------------------------------------------------------------------------------------------------------------------------------------
------------------------------------------------------------------------------------------------------------------------------------------------------
--------------------USS-----------------------QQQQQQ------------CSS--------1---------SUS--SSS------%---------R-------------------------------------SSS
---------------------------------------------------------------------------------------------------------r--------------------------------------------
-----------------------------------------------------------SSS--2-----------------------------------%%%%%%%-------------------------------------------
------------------------------------------------k--------------2-2---------ggg----------------------||||||--------------------------------------------
----------------!-----------------------T-----?QQQQQ--QQQ---------2---#########-----#####---%%%-----||||||----------------------------------------#---
---------------------B-----------------TT-------------------------------------#-----#--------|------||||||----------------------------------------#---
---------------------b-------B---------TT-------------------------------------#----K#--------|------||||||---------B------------------------------#---
-M-------------------B-------b-------kkTT-------------------------------------#-----#--------|------||||||--oo-----b------kkk-----k----------ggg--#---
XXXXXXXXXXXXXXXXXXXXXXXXXXXXXXXXXXXXXXXXXXXXXXXXXXXXXXXXX------XXXXXXX--------X-XXXXXXX------|------||||||--%%XXXXXXXXXXXXXXXXXXXXXX---XXXXXXXXXXXXXXX
XXXXXXXXXXXXXXXXXXXXXXXXXXXXXXXXXXXXXXXXXXXXXXXXXXXXXXXXX------XXXXXXX--------X-XXXXXXX------|------||||||---|XXXXXXXXXXXXXXXXXXXXXX---XXXXXXXXXXXXXXX
