------------------------------------------------------------------------------------------------------------------------------------------------------
------------------------------------------------------------------------------------------------------------------------------------------------------
------------------------------------------------------------------------------------------------------------------------------------------------------
---------------------------------------------------oo---------------------------SSSSSSSSSSSSSSSSSSSS--------------------------------------------------
--------------------------------------------?-----%%%%-----------------------------------------------------------------------------------------------o
---------------------------------------------------||-------------------------------------------------------------------------------------------------
---------------------LSSS--------------------------||----------------------g--------------------------------------------------------------------------
----------------------------------------------r----||--SSS-------------%%%%%%------------------------------------SSS----------------------------SSS---
------------------------------------------%%%%%%---||-------------------||||-------------------------------------------------SSS------------oo--------
-------------------------------------------||||----||-------------------||||-----------S--------------------------------------------------------------
---------Q------%%%%-2-----#------------%%-||||ooo-||-------------------||||----SU--------------------------------------r-------------------SS--------
-----------------||--------#----------tt|--||||--r-||-------------------||||--------TT---t------------TT----------------%%%%%%------------------------
-----------------||--------##---------tt|%%%%%%%%%%||-------------------||||--------TT---t------------TT----TT----------|||||-------------------------
-----------------||---kk---##---------tt|-||||||||-||--------y----------||||-------kTT--kt------g-g---TT-k--TT----------|||||-----k-------------------
XXXXXXXXXXX--%%%%||%XXXXXXXXXXXXXXXXXXXX|-||||||||-||-------XXXXXXXXXX--||||----XXXXXXXXXXXXXXXXXXXXXXXXXXXXXX%%%%----%%|||||-----XX---XXXXX----------
XXXXXXXXXXX---||-||-XXXXXXXXXXXXXXXXXXXX|-||||||||-||-------XXXXXXXXXX--||||----XXXXXXXXXXXXXXXXXXXXXXXXXXXXXX|||------||||||-----XX---XXXXX----------
