------------------------------------------------------------------------------------------------------------------------------------------------------
------------------------------------------------------------------------------------------------------------------------------------------------------
------------------------------------------------------------------------------------------------------------------------------------------------------
----------SSSSSSSSSS--------------------SSSSSSSSSS----------------------------------------------------------------------------------------------------
----------------------------------------SSSSSSSS------------------------------------------------------------------------------------------------------
----------------------------------------SSSCSSSS--------------------------------K---------------------------------------------------------------------
----------------------------------------SSSSSSSS------------------SSoo-----g----SS----1-----------------------?SSS------SSS------------US----------SSS
-----------------------------------------------------------------------%%%%%%-------------------------------------------------------------------------
------------------------------------------------------------------------||||--------------------------------------------------------------------------
-------------------------------------------ggg--------------------------||||---------------o-----------------------------------------SS---------------
----------------------------------------SSSSSSSS------S-----%%%%%%------||||----SS---------------TT-----------SSSSS------------------------S------#---
--------------------------------------ttSSSSSSSS--TT---------||||-------||||----------TT---------TT---------g-------------------------------------#---
--------------------------------------ttSSSSSSSS--TT---------||||-------||||----------TT---------TT---------TT----------------TT--TT--------------#---
-M------------------------------------ttSSSSSSSS--TT------k--||||-------||||----------TT---------TT---------TT--K-------------TT--TT---------ggg--#---
XXXXXXXXXXX--XX--X--XXXXX--XXXXXXXXXXXXXXXXXXXXXXXXXXXXXXXXX-||||-------||||----XXXXXXXXXXXXXXXXXXXX--XXXXXXXXXXXXXXXXXX----XXXXXXXXXXXX-X-XXXXXXXXXXX
XXXXXXXXXXX--XX--X--XXXXX--XXXXXXXXXXXXXXXXXXXXXXXXXXXXXXXXX-||||-------||||----XXXXXXXXXXXXXXXXXXXX--XXXXXXXXXXXXXXXXXX----XXXXXXXXXXXX-X-XXXXXXXXXXX
