------------------------------------------------------------------------------------------------------------------------------------------------------
------------------------------------------------------------------------------------------------------------------------------------------------------
------------------------------------------------------------------------------------------------------------------------------------------------------
--------------------SSSSSSSSSS---------------------oo-------------------------------------------------------------------------------------------------
--------------------------------------------------%%%%------------------------------------------------------------------------------------------------
---------------------------------------------------||-------------------------------------------------------------------------------------------------
---------------------------------------------------||----------------------g-------o--o-----------------------------------SSC---------------SS--------
---------------------------------------------------||--SSS-------------%%%%%%-----------------------------TT------------------------------------------
---------------------------------------------------||-------------------||||------------------------------TT------------------------------------------
-----------------------------C---------------------||-------------------||||-------SSSS-------------------TT--------------SSS-------------------------
----------------!------#-#---------------TT---SU---||----------------#--||||-----------------------------SXXS------------------------------#SS--------
---------------------#-#-#-#-----------T-TT--------||---------------##--||||--------------------------------------------------------------##------#-TT
---------------------#-#-#-#-----------T-TT-------%||-------TT-----###--||||----%%%-----------------TT-----------------------------------###-----##-TT
-M-------------------#-#-#-#-E-------kkT-TT------k-||-------TT----####--||||----||-----------------gTT---------k----kkk----------#---y--####----###-TT
XXXXXXXXXXXXXXXXXXXXXXXXXXXXXXXXXXXXXXXXXXXXXXXXXX-||-------XXXXXXXXXX--||||----||---------XXXXXXXXXXXXXXXXXXXXXXXXXXXXXX----XXXXXXXXXXXXXXXXXXXXXX-XX
XXXXXXXXXXXXXXXXXXXXXXXXXXXXXXXXXXXXXXXXXXXXXXXXXX-||-------XXXXXXXXXX--||||----||---------XXXXXXXXXXXXXXXXXXXXXXXXXXXXXX----XXXXXXXXXXXXXXXXXXXXXX-XX
