------------------------------------------------------------------------------------------------------------------------------------------------------
------------------------------------------------------------------------------------------------------------------------------------------------------
------------------------------------------------------------------------------------------------------------------------------------------------------
---------------------------------------------------oo-------SSSSSSSSSS------------------------------SSSSSSSSSS----------------------------------------
--------------------------------------------------%%%%------SSSS--SSSS--------------------------------------------------------------------------------
----------------------ooor-------------------------||-------SSSS--SSSS------------------oo------------------------------------------------------------
---------------------%%%%%-------------------------||---------SS---S----SSSSS---oo--------------------------------------------------------------------
----------------------|||--------------------------||--SSS----SS---S----------------------------------------------------------------------------------
----------------------|||--------------------------||---------SS---S---------------------------------------------------y------------------------------
----------------------|||--------------------------||-------ooSS---SoU-----------SS------------------------------------X------------------------------
---------Q----------%%%%%%%------------T-TT---SU---||-------SSSS---SSS-------2-----------S------TT---------TT---------XX----------------------#LSS----
-----------------K--||||||-------------T-TT--------||----------------------TT-------------------TT------#--TT--------XXX----------------------#-------
------------B-------||||||--o----------T-TT-------%||-----------------t----TT--T----------------TT-----##--TT-------XXXX----------------------#-------
------------b-------||||||-%%%--gg-----T-TT------k-||-------k--g-g----t----TT--T------------k---TT--kk-##--TT------XXXXX-k----ggg-k---------kk#-------
XXXXXXXXXXXXXXXXXXXX||||||--|-XXXXXXXXXXXXXXXXXXXX-||-------XXXXXXXXXXXXXXXXXXXX----------XXXXXXXXXXXXXXX--XX-XXXXXXXXXXXXXXXXXXXXXX---XXXXXXXXXXXX---
XXXXXXXXXXXXXXXXXXXX||||||--|-XXXXXXXXXXXXXXXXXXXX-||-------XXXXXXXXXXXXXXXXXXXX----------XXXXXXXXXXXXXXX--XX-XXXXXXXXXXXXXXXXXXXXXX---XXXXXXXXXXXX---
