------------------------------------------------------------------------------------------------------------------------------------------------------
------------------------------------------------------------------------------------------------------------------------------------------------------
------------------------------------------------------------------------------------------------------------------------------------------------------
------------------------------------------------------------SSSSSSSSSS--------------------------------------------------------------------------U-----
------------------------------------------------------------SSSS--SSSS--------------------------------------------------------------------------------
------------------------------------------------------------SSSS--SSSS--------------------------------------------------------------------------------
---------------------------------------------------------Q-Q--SS---S-----------------SSSS--------------------@-----oo---------------------------------
--------------------------------------------------------------SS---S------------------------------oo----------------------------------------------SS--
--------------------------------------------------------------SS---S----------------------------------------------------------------------------------
------------------------------------------------------------ooSS---SoU---------------------------------------------------------SSS------------SS------
---------Q----------SS----------QQQQ---------------------Q-QSSSS---SSS----------Q-------------------SU----!--!-%%%%--%%%%----------------------------#
-----------------K---K---TT----------K-BT-----TT------------------------------------------------#---------------||----||----------------------------##
------------B------------TT------------bT-----TT------------------------------------------------#---------------||----||---------------------------###
-M----------b------------TT------------bT-----TT------------k--g-g---------------ggg------------#---------k---o-||----||---------r----------------####
XXXXXXXXXXXXXXXXXXXXXXXXXXXXXXXXXXXXXXXXXXXX--XXXXXXXXXXXXXXXXXXXXXXXXX----XXXXXXXXXX----XXXXXXXXXXXXXXXXXXXXX%-||----||----XXXXXXXXXXXXXXXXXXXXX-XXXX
XXXXXXXXXXXXXXXXXXXXXXXXXXXXXXXXXXXXXXXXXXXX--XXXXXXXXXXXXXXXXXXXXXXXXX----XXXXXXXXXX----XXXXXXXXXXXXXXXXXXXXX--||----||----XXXXXXXXXXXXXXXXXXXXX-XXXX
