------------------------------------------------------------------------------------------------------------------------------------------------------
------------------------------------------------------------------------------------------------------------------------------------------------------
------------------------------------------------------------------------------------------------------------------------------------------------------
S-----SSSSSSSSSSSSSS------------------------------SSSSSSS-----------------------------------------------------SSSSSSSSSSSSS-----SS--------------------
S-----------------------------------------------------------------------------------------------------------------------------------------------------
S-----------------------------------------------------------------------------------------------------------------------------------------------------
S---------------------!---------------------------QQ----------USSS------SSSSS-------------------------------------------US----------------------------
S---------------------------------------------------------------------------------------------------------------------------------oo------------------
S----------------------------------------------------------S----------------------------------------------------------------SSS-----------------------
S---------------------------------------------------------------------------------o---------------oo--------------------------------------------------
S---------@QQQQ-----S@S!S------TT-----------------QQ--QQQ----S-----TT--------2---------TT---------------------T---------SSS----------------Q#---------
S------------------------------TT----------------------------------TT------TT----------TT------TT-----------g-T-----------------------------##--------
S----------------g-#--------tt-TT----------------------------------TT-t----TT--T-------TT------TT-----------TTT----TT-----------------------###------#
S---------------g#-#-g------ttgTT----------------------------ggg---TT-t----TT--T-------TT---y--TT-----------TTT--g-TT-----------------------####----##
XXXXXXXXXXXXXXXXXXXXXXXXXXXXXXXXXXXXXX--X-XX-XX-XXXXXXXXX---XXXXXXXXXXXXXXXXXXXXXXXXXXXXXXXXXXXXXXXX--XXXXXXXXXXXXXXXXXXXXX------XXXXXXXXXXXXXXXXXXXXX
XXXXXXXXXXXXXXXXXXXXXXXXXXXXXXXXXXXXXX--X-XX-XX-XXXXXXXXX---XXXXXXXXXXXXXXXXXXXXXXXXXXXXXXXXXXXXXXXX--XXXXXXXXXXXXXXXXXXXXX------XXXXXXXXXXXXXXXXXXXXX
