------------------------------------------------------------------------------------------------------------------------------------------------------
------------------------------------------------------------------------------------------------------------------------------------------------------
------------------------------------------------------------------------------------------------------------------------------------------------------
--------------------SSSSSSSSSS--------------------------------------------------------------------------------SSSSSSSSSS--------------------SSSSSSSSSS
------------------------------------------------------------------------------------------------------------------------------------------------------
------------------------------------------------------------------------------------------------------------------------------------------------------
-------------------------------------------------------------------------------------------SSS!-------------------------SSS---------------------------
------------------------------------------------------------------------------------------------------------------------------------------------------
-----------------%%%-------------------------------------------------o------------TT------------------------------------------------------------------
------------------||---------C-----------------------------------y----------------TT------------------------------------------------------------------
------------------||---#-#------QQQQ-----------------------------##---------------TT----------C---------------T----------------------------#--TT------
-------------%%%%%||-#-#-#-#---------K-B------------K-----------###---------------TT-----T------------------g-T---------------------------##--TT------
--------------|||-||-#-#-#-#-----------b-----------------------####-------------T-TT-----T------------------TTT----TT---------TT---------###--TT------
-M------------|||-||-#-#-#-#-E---------b-------ggg---------g--#####-------------T-TT---k-T-----g-g----------TTT--g-TT---------TT-----y--####--TT------
XXXXXXXXXXX---|||-||XXXXXXXXXXXXXXXXXXXX-XXXXXXXXXXXXXXXXXXXXXXXXXX---X----XXXXXXXXXXXXXXXXXXXXXXXXX--XXXXXXXXXXXXXXXXXX----XXXXXXXXXXXXXXXXXXXX--XXXX
XXXXXXXXXXX---|||-||XXXXXXXXXXXXXXXXXXXX-XXXXXXXXXXXXXXXXXXXXXXXXXX---X----XXXXXXXXXXXXXXXXXXXXXXXXX--XXXXXXXXXXXXXXXXXX----XXXXXXXXXXXXXXXXXXXX--XXXX
