------------------------------------------------------------------------------------------------------------------------------------------------------
------------------------------------------------------------------------------------------------------------------------------------------------------
------------------------------------------------------------------------------------------------------------------------------------------------------
------------------------------------------------------------------------------------------------------------------------------------------------------
------------------------------------------------------------------------------------------------------------------------------------------------------
------------------------------------------------------------------------------------------------------------------------------------------------------
--------------------USS---------------------------Q---------------------SSSSS--------------SSS!-------------------------SS----------------------------
------------------------------------------------------------------------------------------------------------------------------------------------------
-------------------------------------------------------------------------------------------------------------------------------------g#---------------
----------------------------------------------------------------------------------o----------------------------------------TT-------g##---------------
-------------------%------------QQQQ--------------Q------------------#-------2---------TT-----C----------------------------TT-------###-------#LSS----
---------------------B---------------K-B-----K---B------------------##-----TT----------TT-------------TT----------------t--TT------####-------#-------
---------------------b-------B---------b---------b----------TT-----###t----TT--T-------TT-------------TT----TT----------t--TT-----#####-------#-------
-M-----------%%%%----B-------b---------b---------B---gg----kTT----####t----TT--T-------TT------g-g----TT-k--TT-k----kkk-t--TT-----#####-----kk#-------
XXXXXXXXXXX---||----XXXXXXXXXXXXXXXXXXXXXXXXXXXXXXXXXXXXXXXXXXXXXXXXXXXXXXXXXXXXXXXXXXXXXXXXXXXXXXXXXXXXXXXXXXXXXXXXXXXXXXXXXXXXXXXXXXX--XXXXXXXXXX---
XXXXXXXXXXX---||----XXXXXXXXXXXXXXXXXXXXXXXXXXXXXXXXXXXXXXXXXXXXXXXXXXXXXXXXXXXXXXXXXXXXXXXXXXXXXXXXXXXXXXXXXXXXXXXXXXXXXXXXXXXXXXXXXXX--XXXXXXXXXX---
