------------------------------------------------------------------------------------------------------------------------------------------------------
------------------------------------------------------------------------------------------------------------------------------------------------------
------------------------------------------------------------------------------------------------------------------------------------------------------
--------------------SSSSSSSSSS--------------------SSSSSSSSSS--------------------SSSSSSSSSL------------------------------------------------------------
--------------------SSSSSSSSSS------------------------SS--SS------------------------------------------------------------------------------------------
--------------------SSSSSSSSSS------------------------SS--SS------------------------------------------------------------------------------------------
--------------------SSSSSSSSSS----------------------SS------------------------------oooooo--------------------------------SSC-----SS------------------
----------------------------------------------------SS------------------------------------------------------------------------------------------------
-----------------%%%--------------------------------SS----------------o-------------SSSSSS------------------------------------------------------------
------------------||--------------------------------SS----oo----1-------------------SSSSSS--------------------------------SSS-------------------------
--------SU--------||--SSSSSS?-----------------------SSSS--SS----------------------------------------------------------------------SS------------------
-------------%%%%%||--SSSSS------------T--------------SS----------------------#-----------------------TT--------------------------K---#----B----------
--------------|||-||--SSSSS------------T--------------SS---------------------##-----------------------TT----TT------------------------#----b-------F--
--M-----------|||-||-------ooo-------kkT----y-y----------------------------------------------------g--TT-k--TT-k----kkk----------#----#----B-------#--
XXXXXXXXXXX---|||-||-XXXXXXXXXXXXXXXXXXXXXXXXXXXXXXXXXXXXXXXXXXXXXXXX-XXXXXXXXXX---XXXXXXX-XXXXXXXXXXXXXXXXXXXXXXXXXXXXXX----XXXXXXXXXXXXXXXXXXXXXXXXX
XXXXXXXXXXX---|||-||-XXXXXXXXXXXXXXXXXXXXXXXXXXXXXXXXXXXXXXXXXXXXXXXX-XXXXXXXXXX---XXXXXXX-XXXXXXXXXXXXXXXXXXXXXXXXXXXXXX----XXXXXXXXXXXXXXXXXXXXXXXXX
