------------------------------------------------------------------------------------------------------------------------------------------------------
------------------------------------------------------------------------------------------------------------------------------------------------------
------------------------------------------------------------------------------------------------------------------------------------------------------
S-----SSSS----------------------oo------SSSSSSSSSSSSSSSSS-----------------------SSSSSSSSSLSSSSSSSSSS----------SS-------S----------SSSSSSSS------------
S------------------------------------g-gSSSSSSSS------------------------------------------------------------------------------------------------------
S---------------------ooor---------%%%%%SSSCSSSS---------------------R--------------------------------------------------------------------------------
S--------------------%%%%%----------||||SSSSSSSS--QQ--------------------------------oooooo-------------------R---------S--oo---%%%--------------------
S---------------------|||-----------||||-----------------------------------------------------------------r----------------SS----||--------------------
S---------------------|||-----------||||-------------------S------------------------SSSSSS----------%%%%%%%--------SSS----------||--------------------
S-----------Q--?------|||-----%%%%%-||||---ggg--------------------------------------SSSSSS----------||||||----------------------||--------------------
S------------------S%%%%%%%----|||--||||SSSSSSSS--QQ--QQQ--------%%%--------------------------------||||||-------------S-----SS-||-----g##------------
S-------------------||||||-----|||--||||SSSSSSSS------------------|-----------------------t---------||||||-----##---------------||-----###------------
S-------------------||||||--o--|||--||||SSSSSSSS------------------|-----------------------t---------||||||-----##---------------||---g####---------F--
S--M--------------K-||||||-%%%-|||--||||SSSSSSSS------------------|---gg------------------t---------||||||--oo-##---------------||---#####---------#--
XXXXXXXXXXXXXXXXXXXX||||||--|--|||--||||XXXXXXXXXXXXXXXXX---%%%%%-|---XXXXXXXXXX---XXXXXXXXXXXXXXXXX||||||--%%-XX------X%%-----%%%XXXXXXXX--XXXXXXXXXX
XXXXXXXXXXXXXXXXXXXX||||||--|--|||--||||XXXXXXXXXXXXXXXXX----|||--|---XXXXXXXXXX---XXXXXXXXXXXXXXXXX||||||---|-XX------X|-------||XXXXXXXX--XXXXXXXXXX
