------------------------------------------------------------------------------------------------------------------------------------------------------
------------------------------------------------------------------------------------------------------------------------------------------------------
------------------------------------------------------------------------------------------------------------------------------------------------------
--------------------SSSSSSSSSS------------------------------------------------------------------------------------------------------------------------
------------------------------------------------------------------------------------------------------------------------------------------------------
--------------------------------------------------------------------------------------------oo--------------------------------------------------------
-------------------------------------------------------------------------------------SSSS-----------------2---?SSS------------------------------------
------------------------------------------------------------------------------------------------------------------------------------------------------
-----------------g---------------------------------------------------------------------------------%--------------------------------------------------
-----------------#-----------C----------------------------------1-----------------------------------o--------------------------SSS--------------------
----------S-----##-----#-#-------------------------------tt---------------------Q---------S---------------2---SSSSS-----%-----------------------------
---------------###---#-#-#-#-----------------------------tt-------------------------------------------------------------------------------------------
--------------####---#-#-#-#-----------------------------tt----------------------------------%%%%--------------------------------------------------F--
-M-----------#####---#-#-#-#-E----k-k-------y-y------g-g-tt-----------gg---------ggg----------||--------y--y----K----------------rk----------------#--
XXXXXXXXXXXXXXXXXXXXXXXXXXXXXXXXXXXXXXX-XXXXXXXXXXXXXXXXXXXXXXXXXXXXX-XXXXXXXXXXXXXXX----X----||----XXXXXXXXXXXXXXXXXXXX----XXXXXXXX---XXXXXXXXXXXXXXX
XXXXXXXXXXXXXXXXXXXXXXXXXXXXXXXXXXXXXXX-XXXXXXXXXXXXXXXXXXXXXXXXXXXXX-XXXXXXXXXXXXXXX----X----||----XXXXXXXXXXXXXXXXXXXX----XXXXXXXX---XXXXXXXXXXXXXXX
