------------------------------------------------------------------------------------------------------------------------------------------------------
------------------------------------------------------------------------------------------------------------------------------------------------------
------------------------------------------------------------------------------------------------------------------------------------------------------
----------------------------------------------------------------------------------------------------SSSSSSSSSSSSSSSSSSSS------------------------------
------------------------------------------------------------------------------------------------------------------------------------------------------
--------------------------------------------------------------g---------------------------------------------------------------------------------------
---------------------LSSS-------------------------------------SSSSS-------SSCSS------1----------------------------------------------------------------
------------------------------------------------------------------------------------------------------------------------------------------------------
------------------------------------------------------------------------------------------------------------------------------------------------------
---------------------------------------------------------o--------------------------------------g-----------------------------------------------------
--------SU-----------2-----#----QQQQ-----TT---SU------------------------QQQQ--QQ---QQQQ---------TT-----------TT---------------------------------------
---------------------------#---------K-B-TT-----------------------------------------------------TT-----TT----TT----------------------TT---------------
---------------------------##----------b-TT-------------------TT-----t--------------------------TT-----TT----TT----TT----------------TT------------F--
--M-------k---ggg-----kk---##----------b-TT------k--k---------TT-----t--------------yy----------TT--g--TT----TT--g-TT-----kkk--------TT------------#--
XXXXXXXXXXXXXXXXXXXXXXXXXXXXXXXXXXXXXXXXXXXXXXXXXX-XXXXXXXXXXXXXXXXXXXXXXXXXXXXXXXXXXXXXXXXXXXXXXXX-XXXXXXXXXXXXXXXXXXXXXXXXXXXXXXXXXXXXXXXXXXXXXXXXXX
XXXXXXXXXXXXXXXXXXXXXXXXXXXXXXXXXXXXXXXXXXXXXXXXXX-XXXXXXXXXXXXXXXXXXXXXXXXXXXXXXXXXXXXXXXXXXXXXXXX-XXXXXXXXXXXXXXXXXXXXXXXXXXXXXXXXXXXXXXXXXXXXXXXXXX
