------------------------------------------------------------------------------------------------------------------------------------------------------
------------------------------------------------------------------------------------------------------------------------------------------------------
------------------------------------------------------------------------------------------------------------------------------------------------------
--------------------SSSSSSSSSS----------------------------------------------------------------------SSSSSSSSSS--------------------SSSSSSSSSS----------
--------------------SSSSSSSSSS-----------g------------------------------------------------------------------------------------------------------------
--------------------SSSSSSSSSS----------%%---------------------------R--------------------------------------------------------------------------------
--------------------SSSSSSSSSS----------|----------------------------------g--------y-----------------------------------------------------------------
----------------------------------------|----oo------------------------%%%%%%-----#SSS---------------------------SSS----------------------------------
----------------------------------------|----------------TT-------------||||-----##-------------------------------------------------------------------
----------------------------------------|----------TT----TT-------------||||----###1-----------oooo----------------------------SSS--------------------
----------Q-----------SSSSSS?-----------|----------TT----XX------%%%----||||----###--------------------------T----------%-----------------------------
----------------------SSSSS-------------|----------TT-------------|-----||||----###--SSS---------------TT----T----------------------------TT-------#--
----------------------SSSSS-------------|----------TT-------------|-----||||----###--------------------TT----T---------------------tt-----TT---K---#--
-M-----------------#-------ooo----k-k---|----------TT-------------|-----||||----###-----------------g--TT----T-------------------r-tt----kTT-------#--
XXXXXXXXXXXXX--XXXXX-XXXXXXXXXXXXXXXXXX-|----%%%%-XXXXXXXXXX%%%%%-|-----||||----XXXXXX---X%%%%%%%-%%XXXXXXXXXX%%%%----%%----XXXXXXXXXXXXXXXXXXXXX--XXX
XXXXXXXXXXXXX--XXXXX-XXXXXXXXXXXXXXXXXX-|-----||--XXXXXXXXXX-|||--|-----||||----XXXXXX---X||||||---|XXXXXXXXXX|||------|----XXXXXXXXXXXXXXXXXXXXX--XXX
