------------------------------------------------------------------------------------------------------------------------------------------------------
------------------------------------------------------------------------------------------------------------------------------------------------------
------------------------------------------------------------------------------------------------------------------------------------------------------
S-----SSSSSSSSSSSSSS------------------------------SSSSSSSSSS------------------------------SSSSSSSSSS--------------------------------------------------
S----------------------------------------g------------SS--SS------------------------------------------------------------------------------------------
S---------------------------------------%%------------SS--SS--g---------------------------------------------------------------------------------------
S---------------------------------------|-----------SS--------SSSSS------------------SUS---------------------R---------------------------##-----------
S---------------------------------------|----oo-----SS---------------------------------------------------r----------------------oo-------##-----------
S---------------------------------------|-----------SS----------------o-----------------------------%%%%%%%------------y---------------####-----------
S---------------------------------------|-----------SS----oo----------------------------------------||||||-------------X---------------####-----------
S---------------------------------------|-----------SSSS--SS------------------------#####-----------||||||------------XX-----TT------######-----------
S-------------------------------------tt|-------------SS----------------------#-----#-----t---------||||||-----------XXX-----TT------######-----------
S-------------------------------------tt|-------------SS------TT-----t-------##----K#-----t---------||||||----------XXXX-----TT------######--------F--
S------------------------ggg----------tt|---------------------TT-----t--------------#-----t---------||||||--oo-----XXXXX-y---TT------######--------#--
XXXXXXXXXXX--XX--X--XXXXXXXXXXXXXXXXXXXX|----%%%%-XXXXXXXXXXXXXXXXXXXXXXXXXXXXXXXXXXXXX---XXXXXXXXXX||||||--%%XXXXXXXXXXXXXXXXXXXXXXXXXXXXXXXXXXXXXXXX
XXXXXXXXXXX--XX--X--XXXXXXXXXXXXXXXXXXXX|-----||--XXXXXXXXXXXXXXXXXXXXXXXXXXXXXXXXXXXXX---XXXXXXXXXX||||||---|XXXXXXXXXXXXXXXXXXXXXXXXXXXXXXXXXXXXXXXX
