------------------------------------------------------------------------------------------------------------------------------------------------------
------------------------------------------------------------------------------------------------------------------------------------------------------
------------------------------------------------------------------------------------------------------------------------------------------------------
----------SSSSSSSSSS------------------------------SSSSSSS-----------------------SSSSSSSSSL----------------------------------------SSSSSSSSSS----------
------------------------------------------------------------------------------------------------------------------------------------------------------
----------------------ooor------------------------------------g---------------------------------------------------------------------------------k-----
---------------------%%%%%------------------------QQ----------SSSSS-------SS--------oooooo-------------------------oo--------------------------SQS--SQ
----------------------|||-----------------------------------------------------------------------------------------------------------------------------
----------------------|||----------------------------------S------------------------SSSSSS------------------------------------------------------------
----------------------|||-----------------------------------------------------------SSSSSS------------------------------------------------------------
---------Q----------%%%%%%%-----------------------QQ--QQQ-------------SS-----SS-----------------------%%%%%%---%%%%--%%%-----------------------SQS--S?
--------------------||||||-------------T---------------------------------------------------------------||||-----||----||------------------TT----------
--------------------||||||--o----------T----------------------TT-----t---------------------------------||||-----||----||-----------tt-----TT----------
--------------------||||||-%%%-------kkT----y-y---------------TT-----t-----------------------------g---||||---o-||----||--kkk------tt----kTT-k------gg
XXXXXXXXXXX--XX--X--||||||--|-XXXXXXXXXXXXXXXXXXXXXXXXXXX---XXXXXXXXXX-------------XXXXXXX-XXXXXXXXX%%-||||-%%%-||----||XXXXXXXXXXXXXXXXXXXXXXXXXXXXXX
XXXXXXXXXXX--XX--X--||||||--|-XXXXXXXXXXXXXXXXXXXXXXXXXXX---XXXXXXXXXX-------------XXXXXXX-XXXXXXXXX|--||||--|--||----||XXXXXXXXXXXXXXXXXXXXXXXXXXXXXX
