------------------------------------------------------------------------------------------------------------------------------------------------------
------------------------------------------------------------------------------------------------------------------------------------------------------
------------------------------------------------------------------------------------------------------------------------------------------------------
------------------------------SSSSSSSSSS----------------------------------------ooo-----------------SSSSSSSSSS----------------------------------------
--------------------------------------------------------------------------------%%%-------------------------------------------------------------------
---------------------------------------------------------------------------------|--------------------------------------------------------------------
---------------------------------------------------------------------------1-----|-------------------------------------------------------##-----------
---------------------------------------------------------------------------------|-------------------------------------------------------##-----------
-----------------%%%-------------------S-----------------------------o-----------|-------------------------------------y---------------####-----------
------------------||-------------------S-----------------o-------y---------ggg---|---%%%%------------------------------X-------SSS-----####-----------
---------Q--------||SS-----------------S-------------------------##---#########--|----||-------------------TT---------XX%------------######-----------
-------------%%%%%||-K---TT----#--------------------------------###-----------#-%%%%%%||----------------#--TT--------XXX-------------######-----------
--------------|||-||-----TT----#-#-----------------------------####-----------#--||||-||---------------##--TT-------XXXX-------------######--------F--
--------------|||-||-----TT----#-#-------------ggg--k---------#####-----------#--||||-||-----------gkk-##--TT------XXXXX---------r---######--------#--
XXXXXXXXXXX---|||-||XXXXXXXXXXXXXXXXXXXX-XXXXXXXXX-XXXXXXXXXXXXXXXX-----------X--||||-||%%-XXXXXXXXXXXXXX--XX-XXXXXXXXXX----XXXXXXXXXXXXXXXXXXXXXXXXXX
XXXXXXXXXXX---|||-||XXXXXXXXXXXXXXXXXXXX-XXXXXXXXX-XXXXXXXXXXXXXXXX-----------X--||||-||-|-XXXXXXXXXXXXXX--XX-XXXXXXXXXX----XXXXXXXXXXXXXXXXXXXXXXXXXX
