------------------------------------------------------------------------------------------------------------------------------------------------------
------------------------------------------------------------------------------------------------------------------------------------------------------
------------------------------------------------------------------------------------------------------------------------------------------------------
S-----SSSS----------------------oo--------------------------------------------------------SSSSSSSSSS--------------------SSSSSSSSSS--------------------
S--------------------------------------g----------?---------------------------------------------------------------------------------------------------
S----------------------------------%%%%%--------------------------------------------------------------------------------------------------------------
S-----------------------------------||||---------------------------------------------SUS---------------------@?SSS---------------------US---SS--------
S-----------------------------------||||----------SS--------------------------------------------------------------------------------------------------
S-----------------------------------||||--------------------------------------------------------------------------------------------------------------
S-----------------------------%%%%%-||||---------------------------------------------------------------------------------------------SS---------------
S------------------------------|||--||||-----------------------------T--------------#####-----------SU----!--!SSSSS------------------------SSS--------
S------------------------------|||--||||---------------SSS-----------T--------------#-------------------------------------SS----------------------#-TT
S------------------------------|||--||||-----------------------------T-------------K#-------------------------------------SS------TT-------------##-TT
S---------k---ggg--------------|||--||||-------ggg------------ggg----Tgg------------#-----------g-g-------k-----K---------SS------TT------------###-TT
XXXXXXXXXXXXXXXXXXXXXXXXX--XXX-|||--||||-XXXXXXXXX----------XXXXXXXXXXXXXXXXXXXXXXXXXXX---XXXXXXXXXXXXXXXXXXXXXXXXXXXXXX--XX--XXXXXXXXXX-X-XXXXXXXX-XX
XXXXXXXXXXXXXXXXXXXXXXXXX--XXX-|||--||||-XXXXXXXXX----------XXXXXXXXXXXXXXXXXXXXXXXXXXX---XXXXXXXXXXXXXXXXXXXXXXXXXXXXXX--XX--XXXXXXXXXX-X-XXXXXXXX-XX
