------------------------------------------------------------------------------------------------------------------------------------------------------
------------------------------------------------------------------------------------------------------------------------------------------------------
------------------------------------------------------------------------------------------------------------------------------------------------------
------------------------------SSSSSSSSSS--------------------------------------------------------------------------------------------------------------
------------------------------SSSSSSSSSS--------------------------------------------------------------------------------------------------------------
------------------------------SSSSSSSSSS%%---------------------------R------------------oo------------------------------------------------------------
---------------------LSSS-----SSSSSSSSSS|---------------------------------------oo----------------------------?SSS-----------------SSSS---------------
----------------------------------------|----oo-----------------------------------------------------oo-----------------------------------------y------
----------------------------------------|--------------------------------------g-------------------------------------------------------------#SS--o---
----------------------------------------|----------------------------------------SSS---------------------------------------------------SSSS-##--------
-------------------%-2-----#--SSSSSSSSSS|----------------tt------%%%---------S@S---------S-------tt----------TSSSSS-------------------------##--SC----
---------------------------#--SSSSSSSSSS|----------------tt-------|-----------------------T------tt----------T------------------------------##--------
---------------------------##-SSSSSSSSSS|----------------tt-------|-----------------------T------tt----------T------------------------------##---SSS--
-M-----------%%%%-----kk---##-SSSSSSSSSS|------------g-g-tt-------|-----------------------T------tt-------y--T--K---------kkk---------------##--------
XXXXXXXXXXX---||----XXXXXXXXXXXXXXXXXXXX|----%%%%-XXXXXXXXXX%%%%%-|----XXXXXXXXX----------XXXXXXXXXXXXXXXXXXXXXXXXXXXXXXXXXXXXXXXX---------XXX------XX
XXXXXXXXXXX---||----XXXXXXXXXXXXXXXXXXXX|-----||--XXXXXXXXXX-|||--|----XXXXXXXXX----------XXXXXXXXXXXXXXXXXXXXXXXXXXXXXXXXXXXXXXXX---------XXX------XX
