------------------------------------------------------------------------------------------------------------------------------------------------------
------------------------------------------------------------------------------------------------------------------------------------------------------
------------------------------------------------------------------------------------------------------------------------------------------------------
-----------------------oo------------------------------------------SSS----------------------------------------SS-------S------------------------------
------------------------------------------------------------------------------------------------------------------------------------------------------
----------------------------------------%%------------------------------------------------------------oo----------------------------------------------
------------------Q---SSSS--------------|-----------------------CSS-------SSCSS------1---------------------------------S--SSC-------------------------
----------------------------------------|----oo-------------------------------------------------------------------------------------------------------
----------------------------------------|-------------------SS--2--------------------------------------------------SSS--------------------------------
----------------------------------------|----------------------2-2--------------------------------------------------------SSS-------------------------
------------------?-------%%%%--QQQQ----|----------------tt-------2-----QQQQ--QQ---QQQQ--------------------------------S------------------------------
--------------TT-----------|||-------K-B|----------------tt----------------------------------------------------##--------------------TT------------#--
--------------TT-----------|||---------b|----------------tt-------------------------------------------------tt-##--------------------TT--------K---#--
---M----------TT-----------|||---------b|------------g-g-tt-------------------------yy-------------g--ggg---tt-##----------------#---TT------------#--
XXXXXXXXXXXXXXXXXXXX%%%----|||XXXXXXXXXX|----%%%%-XXXXXXXXXX---XXXXXXXXXXXXXXXXXXXXXXXXXXX-XXXXXXXXXXXXXXXXXXX-XX------XX----XXXXXXXXXXXXXXXXXXXX--XXX
XXXXXXXXXXXXXXXXXXXX||-----|||XXXXXXXXXX|-----||--XXXXXXXXXX---XXXXXXXXXXXXXXXXXXXXXXXXXXX-XXXXXXXXXXXXXXXXXXX-XX------XX----XXXXXXXXXXXXXXXXXXXX--XXX
