------------------------------------------------------------------------------------------------------------------------------------------------------
------------------------------------------------------------------------------------------------------------------------------------------------------
------------------------------------------------------------------------------------------------------------------------------------------------------
S-----SSSS--------------------SSSSSSSSSS--------------------------------------------------------------------------------SSS-----SS--------------------
S-----------------------------SSSSSSSSSS--------------------------------------------------------------------------------------------------------------
S-----------------------------SSSSSSSSSS----------------------------------------------------oo--------------------------------------------------------
S-------------------USS-------SSSSSSSSSS-----------------------------------1-------o--o----------------------R----------US--------SS------------------
S--------------------------------------------------------------------------------------------------------r------oooo----------------------------------
S--------------------------------------------------------------------o-----------------------------%%%%%%%%-----------------SSS-----------------------
S----------------------------------------------------------------y---------ggg-----SSSS-------------||||||--------------------------------------------
S------------------%----------SSSSSSSSSS---------------ooo-------##---#########-----------S---------||||||----T---------SSS-------SS------------------
S--------------------B--------SSSSSSSSSS-----K---B--------------###-----------#---------------------||||||----T-------------------K---#----B----------
S--------------------b-------BSSSSSSSSSS---------b-------------####-----------#-%%%----------%%%%---||||||----T-----------------------#----b-------F--
S------------%%%%----B-------bSSSSSSSSSS---------B------------#####-----------#-||------------||----||||||--ooT---y-------------------#----B-------#--
XXXXXXXXXXX---||----XXXXXXXXXXXXXXXXXXXXXXXXXXXXXX--XXXXXXXXXXXXXXX-----------X-||------------||----||||||--%%XXXXXXXXXXXXX------XXXXXXXXXXXXXXXXXXXXX
XXXXXXXXXXX---||----XXXXXXXXXXXXXXXXXXXXXXXXXXXXXX--XXXXXXXXXXXXXXX-----------X-||------------||----||||||---|XXXXXXXXXXXXX------XXXXXXXXXXXXXXXXXXXXX
