------------------------------------------------------------------------------------------------------------------------------------------------------
------------------------------------------------------------------------------------------------------------------------------------------------------
------------------------------------------------------------------------------------------------------------------------------------------------------
----------SSSSSSSSSSSSSSSSSSSS--oo------------------------------------------------------------------SSSSSSSSSS----------------------------------------
--------------------SSSSSSSSSS-------g-g--------------------------------------------------------------------------------------------------------------
--------------------SSSSSSSSSS-----%%%%%--------------------------------------------------------------------------------------------------------------
--------------------SSSSSSSSSS------||||------------------------------------SSSS-----1----------------------------------------------------------------
------------------------------------||||----------------------------------------------------------------------------------------oo--------------------
------------------------------------||||-----------------TT----------o---------------------------------------------------------------g#---------------
------------------------------%%%%%-||||-----------TT----TT------y-----------K------------------------------------------------------g##---------------
----------@QQQQ-------SSSSSS?--|||--||||-----------TT----XX------##--------SSSSS---QQQQ---------TT-----------T--!-----S------TT-----###---------------
----------------------SSSSS----|||--||||-----------TT-----------###---T-------------------------TT-----TT----T---------------TT----####---------------
-----------------g-#--SSSSS----|||--||||-----------TT----------####---T-------------------------TT-----TT----T---------------TT---#####------------F--
----------------g#-#-------ooo-|||--||||-------ggg-TT---------#####---T-------------yy------k---TT--g--TT----T-----------y---TT---#####------------#--
XXXXXXXXXXXXXXXXXXXX-XXXXXXXXX-|||--||||-XXXXXXXXXXXXXXXXXXXXXXXXXX---XXXXXXXXXXXXXXXXXXXXXXXXXXXXXXXXXXXXXXXXXXXXXXXXXXXXXXXXXXXXXXXXX--XXXXXXXXXXXXX
XXXXXXXXXXXXXXXXXXXX-XXXXXXXXX-|||--||||-XXXXXXXXXXXXXXXXXXXXXXXXXX---XXXXXXXXXXXXXXXXXXXXXXXXXXXXXXXXXXXXXXXXXXXXXXXXXXXXXXXXXXXXXXXXX--XXXXXXXXXXXXX
