------------------------------------------------------------------------------------------------------------------------------------------------------
------------------------------------------------------------------------------------------------------------------------------------------------------
------------------------------------------------------------------------------------------------------------------------------------------------------
S-----SSSS------------------------------------------------------------SSSSSSSSSS----------------------------------------------------------------------
S---------------------------------------------------------------------------SSSS----------------------------------------------------------------------
S-------------------------------------oo---------------------------------g--SSSS----------------------------------------------------------------------
S-------------------USS------------SSSS------------------Q-Q------------SS---------USS--------------------------------US--SSC----------------QQQQ-----
S-----------------------------------------------------------------------SS----------------------------------------------------------------------------
S--------------------------------------------------------------------o--SS-----------------------------------------------------------g#---------------
S----------------------------------------------------------------y------SC--g-g-------------------------------------E-----SSS-------g##--------y------
S------------------%----------%--------------------------Q-Q-----##-----SS--SSSS--#--------------tt----------------TT---------------###-----Q?SSQQQ---
S--------------------B------------------------------------------###---------------#-------T------tt---------g------TT--t-----------####---------------
S--------------------b-------B---------------------------------####---------------##------T------tt---------TT-----TT--t----------#####---------------
S------------%%%%----B-------b-----------------ggg------------#####---------------##--gg--T------tt---------TT--g--TT--t---------######---------------
XXXXXXXXXXX---||----XXXXXXXXXX--%%%%--%%-XXXXXXXXXXXXXXXXXXXXXXXXXX---XXXXXXXXXX--XXXXXXXXXXXXXXXXXX--XXXXXXXXXXXXXXXXXXX----XXXXXXXXXX--XXXXX--XXXXXX
XXXXXXXXXXX---||----XXXXXXXXXX---||----|-XXXXXXXXXXXXXXXXXXXXXXXXXX---XXXXXXXXXX--XXXXXXXXXXXXXXXXXX--XXXXXXXXXXXXXXXXXXX----XXXXXXXXXX--XXXXX--XXXXXX
