------------------------------------------------------------------------------------------------------------------------------------------------------
------------------------------------------------------------------------------------------------------------------------------------------------------
------------------------------------------------------------------------------------------------------------------------------------------------------
----------------------------------------SSSSSSSSSS------------------------------SSSSSSSSSS------------------------------SSSSSSSSSS--------------U-----
------------------------------------------------------------------------------------------------------------------------------------------------------
-------------------------------------------------------oooo-------------------------------------------------------------------------------------------
-----------------------------------------oooo----------%%%%-----------------SSSS----------------------------------------------------------------------
--------------------------------------------------------||----------------------------------------------------------------------------------------SS--
-----------------------------------------SSSS-U---------||--------------------------------------------------------------------------------------------
----------------------------------------oS--SoS---SSS---||------1------------K---------S------------------------------------------------------SS------
----------------------------TT--QQQQ----SS--SSS---------||-----------------SSSSSSU---------------tt-------------!-----S------------------------------#
-----------------K----------TT-------K-B--------------U-||------------T-------------TT---tT------tt---------g-------------SS---------TT-------------##
------------B---------------TT---------b----------------||------------T-------------TT---tT------tt---------TT------------SS---------TT------------###
-M----------b-----------ggg-TT---------b--kk------------||------------T------------kTT--ktT------tt---------TT------------SS---------TT-----------####
XXXXXXXXXXXXXXXXXXXXXXXXXXXXXXXXXXXXXXXXXXXXXXXXXX----%%%%%-XXXXXXXXX-XXXXXXXXXXXXXXXXXXXXXXXXXXXXXX--XXXXXXXXXXXXXXXXXX--XX--XXXXXXXXXXXXXXXXXXX-XXXX
XXXXXXXXXXXXXXXXXXXXXXXXXXXXXXXXXXXXXXXXXXXXXXXXXX-----|||--XXXXXXXXX-XXXXXXXXXXXXXXXXXXXXXXXXXXXXXX--XXXXXXXXXXXXXXXXXX--XX--XXXXXXXXXXXXXXXXXXX-XXXX
