------------------------------------------------------------------------------------------------------------------------------------------------------
------------------------------------------------------------------------------------------------------------------------------------------------------
------------------------------------------------------------------------------------------------------------------------------------------------------
------------------------------SSSSSSSSSS----------------------------------------ooo-------------------------------------------------------------------
------------------------------SSSSSSSSSS----------------------------------------%%%------------------------------------------------------------------o
------------------------------SSSSSSSSSS-----------------------------------------|--------------------------------------------------------------------
-----------------------------USSSSSSSSSS-----------------------------------------|----------------------SSQSSS----------SS--------!S------------------
---------------------------------------------------------------------------------|--------------------------------------------------------------SSS---
-----------------g-------------------------------------------------------------g-|----------------------------------------------------------oo--------
-----------------#---------------------------------------o-----------------------|---%%%%-----------------K----------------TT-------------------------
--------SUS-----##----------##SSSSSSSSSS------tt-----------------------------S@S-|----||----------------SSSSSS-------------TT-----S------#--SS--------
---------------###-----y-#####SSSSSSSSSS------tt--------------------------------%%%%%%||--------------------------------t--TT-----------##------------
--------------####--y-######--SSSSSSSSSS------tt---------------------------------||||-||---------B----------------------t--TT----------###------------
--M----------#####--######----SSSSSSSSSS-g----tt----k--------y-------------------||||-||---------b-------------k----kkk-t--TT---------####------------
XXXXXXXXXXXXXXXXXXXXXXXX------XXXXXXXXXXXXXXXXXXXX-XXXXXXXXXXXXXXXXXXX-XXXXXXXXX-||||-||%%XXXXXXXXXXXXXXXXXXXXXXXXXXXXXXXXXXXXXXXXXXXXXXXXXX----------
XXXXXXXXXXXXXXXXXXXXXXXX------XXXXXXXXXXXXXXXXXXXX-XXXXXXXXXXXXXXXXXXX-XXXXXXXXX-||||-||-|XXXXXXXXXXXXXXXXXXXXXXXXXXXXXXXXXXXXXXXXXXXXXXXXXX----------
