------------------------------------------------------------------------------------------------------------------------------------------------------
------------------------------------------------------------------------------------------------------------------------------------------------------
------------------------------------------------------------------------------------------------------------------------------------------------------
------------------------------SSSSSSSSSS---------------------------SSSSSSSSSSSSS--------------------SSSSSSSSSS----------SSS-----SS--------------------
-----------------------------------------g----------------------------------SSSS----------------------------------------------------------------------
----------------------ooor--------------%%-------------------------------g--SSSS------------oo--------------------------------------------------------
------------------Q--%%%%%--------------|-----------------------CSS-----SS-----------SUS--------------------------------US----------------------------
----------------------|||---------------|----oo-------------------------SS---------------------------------------------------------------------y------
----------------------|||--------------S|----------------B--SS--2-------SS-------------------------%------------------------SSS--------------#SS--o---
----------------------|||--------------S|----------------b-----2-2------SC--g-g-------------------------------------------------------------##--------
------------------?-%%%%%%%------------S|--------------SS#CS------2-----SS--SSSS----#####-S----------------TT---------r-SSS-----------------##--SC----
--------------TT----||||||-----#--------|-------------------------------------------#-------------------#--TT-----%%%%%%-------------TT-----##--------
--------------TT----||||||--o--#-#------|------------------K-----------------------K#--------%%%%------##--TT------|||||-------------TT-----##---SSS--
-M------------TT----||||||-%%%-#-#------|-------------------------------------------#---------||----kk-##--TT------|||||-------------TT-----##--------
XXXXXXXXXXXXXXXXXXXX||||||--|-XXXXXXXXXX|----%%%%-XXXXXXXXXX---XXXXXXXXXXXXXXXXXXXXXXXX-------||----XXXXX--XX--%%%-|||||XXX------XXXXXXXXXXXXX------XX
XXXXXXXXXXXXXXXXXXXX||||||--|-XXXXXXXXXX|-----||--XXXXXXXXXX---XXXXXXXXXXXXXXXXXXXXXXXX-------||----XXXXX--XX---|--|||||XXX------XXXXXXXXXXXXX------XX
