------------------------------------------------------------------------------------------------------------------------------------------------------
------------------------------------------------------------------------------------------------------------------------------------------------------
------------------------------------------------------------------------------------------------------------------------------------------------------
------------------------------------------------------------------------------------------SSSSSSSSSS--------------------------------------------------
------------------------------------------------------------------------------------------------------------------------------------------------------
--------------------------------------oo--------------------------------------------------------------------------------------------------------------
--------------------USS------------SSSS---------------------------SSoo---------------SUS---------------------R----------------------------------------
---------------------------------------------------------------------------------------------------------r------------------------oo------------------
----------------------------------------------------------------------------------------------------%%%%%%%------------------SSS----------------------
----------------------------------------------------------------------------------------------------||||||--------------------------------------------
---------Q------!-------------%--------------------------tt-%%%%%%------------------#####-----------||||||--------------r------------------Q----------
---------------------B------------------T-----TT---------tt--||||-------------------#---------------||||||--------------%%%%%%------------------------
---------------------b-------B----------T-----TT---------tt--||||------------------K#---------------||||||---------B----|||||----------------------F--
---------------------B-------b----------T-----TT-----g-g-tt--||||-------------------#-----------g-g-||||||--oo-----b----|||||----------------------#--
XXXXXXXXXXXXXXXXXXXXXXXXXXXXXX--%%%%--%%XXXX--XXXXXXXXXXXXXX-||||-----X----XXXXXXXXXXXX---XXXXXXXXXX||||||--%%XXXXXXXXXX|||||-----XXXXXXXXXXXXXXXXXXXX
XXXXXXXXXXXXXXXXXXXXXXXXXXXXXX---||----|XXXX--XXXXXXXXXXXXXX-||||-----X----XXXXXXXXXXXX---XXXXXXXXXX||||||---|XXXXXXXXXX|||||-----XXXXXXXXXXXXXXXXXXXX
