------------------------------------------------------------------------------------------------------------------------------------------------------
------------------------------------------------------------------------------------------------------------------------------------------------------
------------------------------------------------------------------------------------------------------------------------------------------------------
------------------------------SSSSSSSSSS---------------------------SSS--------------------------------------------------------------------------U-----
------------------------------SSSSSSSSSS----------?---------------------------------------------------------------------------------------------------
------------------------------SSSSSSSSSS%%----------------------------------------------oo------------------------------------------------------------
---------------------LSSS-----SSSSSSSSSS|-----------------------CSS-------SSCSS-oo--------SSS------%----SSQSSS?SSS----------------%-------------------
----------------------------------------|----oo---SS----------------------------------------------------------------------------------------------SS--
----------------------------------------|-------------------SS--2------------------------------------------------------------SSS--------SSS-----------
----------------------------------------|----------------------2-2---------------SSS----------------------K-----------------------------------SS------
--------SUQ----------2-----#--SSSSSSSSSS|-------------------------2-----QQQQ--QQ---------S--%%%---------SSSSSSSSSSS-----r---------%%%%%--------------#
---------------------------#--SSSSSSSSSS|--------------SSS-----------------------------------|--------------------------%%%%%%-----|||--------------##
---------------------------##-SSSSSSSSSS|----------------------------------------------------|--------------------------|||||------|||-------------###
--M----------------#--kk---##-SSSSSSSSSS|----------------------------------------------------|------------------K-------|||||------|||------------####
XXXXXXXXXXXXX--XXXXXXXXXXXXXXXXXXXXXXXXX|----%%%%--------------XXXXXXXXXXXXXXXXX-------------|------XXXXXXXXXXXXXXXXXXXX|||||-----%|||------XXXXX-XXXX
XXXXXXXXXXXXX--XXXXXXXXXXXXXXXXXXXXXXXXX|-----||---------------XXXXXXXXXXXXXXXXX-------------|------XXXXXXXXXXXXXXXXXXXX|||||------|||------XXXXX-XXXX
