------------------------------------------------------------------------------------------------------------------------------------------------------
------------------------------------------------------------------------------------------------------------------------------------------------------
------------------------------------------------------------------------------------------------------------------------------------------------------
--------------------------------oo----------------SSSSSSSSSS----------SSSSSSSSSS----------------------------------------------------------------------
---------------------------------------g--------------SS--SS----------------SSSS----------------------------------------------------------------------
-----------------------------------%%%%%--------------SS--SS-------------g--SSSS----------------------------------------------------------------------
------------------------------------||||------------SS------------------SS---------o--o----------------------------oo--------------------##-----------
------------------------------------||||------------SS------------------SS--------------------------oo--------------------------oo-------##-----------
-----------------g------------------||||------------SS------------------SS-------------------------------------------------------------####-----------
-----------------#------------%%%%%-||||------------SS----oo------------SC--g-g----SSSS------------------------------------------------####-----------
----------S-----##-------------|||--||||-TT---SU----SSSS--SS------------SS--SSSS-----------------tt----------T-%%%%--%%%-----TT------######---#LSS----
---------------###-------------|||--||||-TT-----------SS----------------------------------T------tt----------T--||----||-----TT------######---#-------
--------------####-------------|||--||||-TT-----------SS------------------------%%%-------T------tt----------T--||----||-----TT------######---#-------
-M-----------#####-------------|||--||||-TT------k----------gg-------g----------||--------T------tt-------y--To-||----||-y---TT------######-kk#-------
XXXXXXXXXXXXXXXXXXXXXXXXX--XXX-|||--||||XXXXXXXXXXXXXXXXXXXXXXXXXXXXXXXXXXXXXXXX||--------XXXXXXXXXXXXXXXXXXXX%-||----||XXXXXXXXXXXXXXXXXXXXXXXXXXX---
XXXXXXXXXXXXXXXXXXXXXXXXX--XXX-|||--||||XXXXXXXXXXXXXXXXXXXXXXXXXXXXXXXXXXXXXXXX||--------XXXXXXXXXXXXXXXXXXXX--||----||XXXXXXXXXXXXXXXXXXXXXXXXXXX---
