------------------------------------------------------------------------------------------------------------------------------------------------------
------------------------------------------------------------------------------------------------------------------------------------------------------
------------------------------------------------------------------------------------------------------------------------------------------------------
----------SSSSSSSSSS------------------------------------------------------------------------------------------------------------------------SSSSSSSSSS
------------------------------------------------------------------------------------------------------------------------------------------------------
--------------------------------------oo---------------oooo-------------------------------------------------------------------------------------------
----------------------!------------SSSS----------------%%%%---USSS-------------------SUS---------------------------oo----SSS----S!%-------------------
--------------------------------------------------SSSS--||--------------------------------------------------------------------------------------------
--------------------------------------------------------||------------------------------------------------------------------------------SSS-----------
--------------------------------------------------------||--------------------------------------------------------------------------------------------
----------@QQQQ-----S@S!S-----%----------TT---SU--------||---S-----TT---------------#####-------------%%%%%%---%%%%--%%%---------S%%%%%-------TT------
-----------------------------------------TT-----------U-||---------TT---------------#------------------||||-----||----||-----------|||--------TT------
-----------------g-#--------tt-----------TT-------------||---------TT--------------K#------------B-----||||-----||----||-----------|||--------TT------
-M--------------g#-#-g------tt-----------TT------k------||---ggg---TT---------------#------------b-----||||---o-||----||----gg-g-g-|||--------TT------
XXXXXXXXXXXXXXXXXXXXXXXXXXXXXX--%%%%--%%XXXXXXXXXX----%%%%%-XXXXXXXXXXX----XXXXXXXXXXXX---XXXXXXXXXX%%-||||-%%%-||----||XXXXXXXXXX%|||------XXXX--XXXX
XXXXXXXXXXXXXXXXXXXXXXXXXXXXXX---||----|XXXXXXXXXX-----|||--XXXXXXXXXXX----XXXXXXXXXXXX---XXXXXXXXXX|--||||--|--||----||XXXXXXXXXX-|||------XXXX--XXXX
