------------------------------------------------------------------------------------------------------------------------------------------------------
------------------------------------------------------------------------------------------------------------------------------------------------------
------------------------------------------------------------------------------------------------------------------------------------------------------
--------------------SSSSSSSSSS--------------------SSSSSSSSSS----------------------------------------------------------------------SSSSSSSSSS----------
--------------------SSSSSSSSSS------------------------SS--SS------------------------------------------------------------------------------------------
--------------------SSSSSSSSSS------------------------SS--SS----------------------------oo-------------------------k----------------------------------
--------------------SSSSSSSSSS----------------------SS------------------SSSSS---oo---------SSS!-----------2---S---SSSSSSSSS---------------------------
----------------------------------------------------SS------------------------------------------------------------------------------------------------
----------------------------------------------------SS------------------------------------------------------------------------------------------------
----------------------------------------------------SS----oo---------------------SSS----------------o-------------------------------------------------
----------------%%%%--SSSSSS?-----------------tt----SSSS--SS-----------------2-----------S----C-----------2---------------------------------#---------
-----------------||---SSSSS-----------tt------tt------SS-------------T-----TT-------------------------------------------------------------TT##--------
-----------------||---SSSSS-----------tt------tt------SS-----B-------Tt----TT--T------------------------------TT--------------TT---tt-----TT###------#
-M---------------||--------ooo--------tt-g----tt-------------b-------Tt----TT--T---------------g-g------y--y--TT--------------TT---tt----kTT####----##
XXXXXXXXXXX--%%%%||%-XXXXXXXXXXXXXXXXXXXXXXXXXXXXXXXXXXXXXXXXXXXXX--XXXXXXXXXXXX----------XXXXXXXXXXXXXXXXXXXXXXXXXXXX------XXXXXXXXXXXXXXXXXXXXXXXXXX
XXXXXXXXXXX---||-||--XXXXXXXXXXXXXXXXXXXXXXXXXXXXXXXXXXXXXXXXXXXXX--XXXXXXXXXXXX----------XXXXXXXXXXXXXXXXXXXXXXXXXXXX------XXXXXXXXXXXXXXXXXXXXXXXXXX
